quacrista	quacrista+A+SG
quacristas	quacrista+A+PL
quacristazinha	quacrista+A+DIM+F+SG
quacristazinhas	quacrista+A+DIM+F+PL
quacristazinho	quacrista+A+DIM+M+SG
quacristazinhos	quacrista+A+DIM+M+PL
quacristinha	quacrista+A+DIM+SG
quacristinhas	quacrista+A+DIM+PL
quadernada	quadernado+A+F+SG
quadernadas	quadernado+A+F+PL
quadernadazinha	quadernado+A+DIM+F+SG
quadernadazinhas	quadernado+A+DIM+F+PL
quadernadinha	quadernado+A+DIM+F+SG
quadernadinhas	quadernado+A+DIM+F+PL
quadernadinho	quadernado+A+DIM+M+SG
quadernadinhos	quadernado+A+DIM+M+PL
quadernado	quadernado+A+M+SG
quadernados	quadernado+A+M+PL
quadernadozinho	quadernado+A+DIM+M+SG
quadernadozinhos	quadernado+A+DIM+M+PL
quadrada	quadrado+A+F+SG
quadradas	quadrado+A+F+PL
quadradazinha	quadrado+A+DIM+F+SG
quadradazinhas	quadrado+A+DIM+F+PL
quadradazita	quadrado+A+DIM+F+SG
quadradazitas	quadrado+A+DIM+F+PL
quadradinha	quadrado+A+DIM+F+SG
quadradinhas	quadrado+A+DIM+F+PL
quadradinho	quadrado+A+DIM+M+SG
quadradinhos	quadrado+A+DIM+M+PL
quadradita	quadrado+A+DIM+F+SG
quadraditas	quadrado+A+DIM+F+PL
quadradito	quadrado+A+DIM+M+SG
quadraditos	quadrado+A+DIM+M+PL
quadrado	quadrado+A+M+SG
quadrados	quadrado+A+M+PL
quadradozinho	quadrado+A+DIM+M+SG
quadradozinhos	quadrado+A+DIM+M+PL
quadradozito	quadrado+A+DIM+M+SG
quadradozitos	quadrado+A+DIM+M+PL
quadradíssima	quadrado+A+SUPER+F+SG
quadradíssimas	quadrado+A+SUPER+F+PL
quadradíssimo	quadrado+A+SUPER+M+SG
quadradíssimos	quadrado+A+SUPER+M+PL
quadrador	quadrador+A+M+SG
quadradora	quadrador+A+F+SG
quadradoras	quadrador+A+F+PL
quadradorazinha	quadrador+A+DIM+F+SG
quadradorazinhas	quadrador+A+DIM+F+PL
quadradores	quadrador+A+M+PL
quadradorezinhos	quadrador+A+DIM+M+PL
quadradorinha	quadrador+A+DIM+F+SG
quadradorinhas	quadrador+A+DIM+F+PL
quadradorzinho	quadrador+A+DIM+M+SG
quadradorzinhos	quadrador+A+DIM+M+PL
quadragenariazinha	quadragenário+A+DIM+F+SG
quadragenariazinhas	quadragenário+A+DIM+F+PL
quadragenarinha	quadragenário+A+DIM+F+SG
quadragenarinhas	quadragenário+A+DIM+F+PL
quadragenarinho	quadragenário+A+DIM+M+SG
quadragenarinhos	quadragenário+A+DIM+M+PL
quadragenariozinho	quadragenário+A+DIM+M+SG
quadragenariozinhos	quadragenário+A+DIM+M+PL
quadragenária	quadragenário+A+F+SG
quadragenárias	quadragenário+A+F+PL
quadragenário	quadragenário+A+M+SG
quadragenários	quadragenário+A+M+PL
quadragesimais	quadragesimal+A+PL
quadragesimaizinhas	quadragesimal+A+DIM+F+PL
quadragesimaizinhos	quadragesimal+A+DIM+M+PL
quadragesimal	quadragesimal+A+SG
quadragesimalzinha	quadragesimal+A+DIM+F+SG
quadragesimalzinho	quadragesimal+A+DIM+M+SG
quadrangulada	quadrangulado+A+F+SG
quadranguladas	quadrangulado+A+F+PL
quadranguladazinha	quadrangulado+A+DIM+F+SG
quadranguladazinhas	quadrangulado+A+DIM+F+PL
quadranguladinha	quadrangulado+A+DIM+F+SG
quadranguladinhas	quadrangulado+A+DIM+F+PL
quadranguladinho	quadrangulado+A+DIM+M+SG
quadranguladinhos	quadrangulado+A+DIM+M+PL
quadrangulado	quadrangulado+A+M+SG
quadrangulados	quadrangulado+A+M+PL
quadranguladozinho	quadrangulado+A+DIM+M+SG
quadranguladozinhos	quadrangulado+A+DIM+M+PL
quadrangular	quadrangular+A+SG
quadrangulares	quadrangular+A+PL
quadrangularezinhas	quadrangular+A+DIM+F+PL
quadrangularezinhos	quadrangular+A+DIM+M+PL
quadrangularzinha	quadrangular+A+DIM+F+SG
quadrangularzinhas	quadrangular+A+DIM+F+PL
quadrangularzinho	quadrangular+A+DIM+M+SG
quadrangularzinhos	quadrangular+A+DIM+M+PL
quadrarona	quadrarão+A+F+SG
quadraronas	quadrarão+A+F+PL
quadraronazinha	quadrarão+A+DIM+F+SG
quadraronazinhas	quadrarão+A+DIM+F+PL
quadraroninha	quadrarão+A+DIM+F+SG
quadraroninhas	quadrarão+A+DIM+F+PL
quadrarão	quadrarão+A+M+SG
quadrarãozinho	quadrarão+A+DIM+M+SG
quadrarões	quadrarão+A+M+PL
quadrarõezinhos	quadrarão+A+DIM+M+PL
quadrialada	quadrialado+A+F+SG
quadrialadas	quadrialado+A+F+PL
quadrialadazinha	quadrialado+A+DIM+F+SG
quadrialadazinhas	quadrialado+A+DIM+F+PL
quadrialadinha	quadrialado+A+DIM+F+SG
quadrialadinhas	quadrialado+A+DIM+F+PL
quadrialadinho	quadrialado+A+DIM+M+SG
quadrialadinhos	quadrialado+A+DIM+M+PL
quadrialado	quadrialado+A+M+SG
quadrialados	quadrialado+A+M+PL
quadrialadozinho	quadrialado+A+DIM+M+SG
quadrialadozinhos	quadrialado+A+DIM+M+PL
quadricapsular	quadricapsular+A+SG
quadricapsulares	quadricapsular+A+PL
quadricapsularezinhas	quadricapsular+A+DIM+F+PL
quadricapsularezinhos	quadricapsular+A+DIM+M+PL
quadricapsularzinha	quadricapsular+A+DIM+F+SG
quadricapsularzinhas	quadricapsular+A+DIM+F+PL
quadricapsularzinho	quadricapsular+A+DIM+M+SG
quadricapsularzinhos	quadricapsular+A+DIM+M+PL
quadricentenariazinha	quadricentenário+A+DIM+F+SG
quadricentenariazinhas	quadricentenário+A+DIM+F+PL
quadricentenarinha	quadricentenário+A+DIM+F+SG
quadricentenarinhas	quadricentenário+A+DIM+F+PL
quadricentenarinho	quadricentenário+A+DIM+M+SG
quadricentenarinhos	quadricentenário+A+DIM+M+PL
quadricentenariozinho	quadricentenário+A+DIM+M+SG
quadricentenariozinhos	quadricentenário+A+DIM+M+PL
quadricentenária	quadricentenário+A+F+SG
quadricentenárias	quadricentenário+A+F+PL
quadricentenário	quadricentenário+A+M+SG
quadricentenários	quadricentenário+A+M+PL
quadricicla	quadriciclo+A+F+SG
quadriciclas	quadriciclo+A+F+PL
quadriciclazinha	quadriciclo+A+DIM+F+SG
quadriciclazinhas	quadriciclo+A+DIM+F+PL
quadriciclinha	quadriciclo+A+DIM+F+SG
quadriciclinhas	quadriciclo+A+DIM+F+PL
quadriciclinho	quadriciclo+A+DIM+M+SG
quadriciclinhos	quadriciclo+A+DIM+M+PL
quadriciclo	quadriciclo+A+M+SG
quadriciclos	quadriciclo+A+M+PL
quadriciclozinho	quadriciclo+A+DIM+M+SG
quadriciclozinhos	quadriciclo+A+DIM+M+PL
quadricolor	quadricolor+A+SG
quadricolores	quadricolor+A+PL
quadricolorezinhas	quadricolor+A+DIM+F+PL
quadricolorezinhos	quadricolor+A+DIM+M+PL
quadricolorzinha	quadricolor+A+DIM+F+SG
quadricolorzinhas	quadricolor+A+DIM+F+PL
quadricolorzinho	quadricolor+A+DIM+M+SG
quadricolorzinhos	quadricolor+A+DIM+M+PL
quadricotiledoneazinha	quadricotiledóneo+A+DIM+F+SG
quadricotiledoneazinhas	quadricotiledóneo+A+DIM+F+PL
quadricotiledoneinha	quadricotiledóneo+A+DIM+F+SG
quadricotiledoneinhas	quadricotiledóneo+A+DIM+F+PL
quadricotiledoneinho	quadricotiledóneo+A+DIM+M+SG
quadricotiledoneinhos	quadricotiledóneo+A+DIM+M+PL
quadricotiledoneozinho	quadricotiledóneo+A+DIM+M+SG
quadricotiledoneozinhos	quadricotiledóneo+A+DIM+M+PL
quadricotiledónea	quadricotiledóneo+A+F+SG
quadricotiledóneas	quadricotiledóneo+A+F+PL
quadricotiledóneo	quadricotiledóneo+A+M+SG
quadricotiledóneos	quadricotiledóneo+A+M+PL
quadricotiledoneazinha	quadricotiledôneo+A+DIM+F+SG
quadricotiledoneazinhas	quadricotiledôneo+A+DIM+F+PL
quadricotiledoneinha	quadricotiledôneo+A+DIM+F+SG
quadricotiledoneinhas	quadricotiledôneo+A+DIM+F+PL
quadricotiledoneinho	quadricotiledôneo+A+DIM+M+SG
quadricotiledoneinhos	quadricotiledôneo+A+DIM+M+PL
quadricotiledoneozinho	quadricotiledôneo+A+DIM+M+SG
quadricotiledoneozinhos	quadricotiledôneo+A+DIM+M+PL
quadricotiledônea	quadricotiledôneo+A+F+SG
quadricotiledôneas	quadricotiledôneo+A+F+PL
quadricotiledôneo	quadricotiledôneo+A+M+SG
quadricotiledôneos	quadricotiledôneo+A+M+PL
quadricromicazinha	quadricrómico+A+DIM+F+SG
quadricromicazinhas	quadricrómico+A+DIM+F+PL
quadricromicozinho	quadricrómico+A+DIM+M+SG
quadricromicozinhos	quadricrómico+A+DIM+M+PL
quadricromiquinha	quadricrómico+A+DIM+F+SG
quadricromiquinhas	quadricrómico+A+DIM+F+PL
quadricromiquinho	quadricrómico+A+DIM+M+SG
quadricromiquinhos	quadricrómico+A+DIM+M+PL
quadricrómica	quadricrómico+A+F+SG
quadricrómicas	quadricrómico+A+F+PL
quadricrómico	quadricrómico+A+M+SG
quadricrómicos	quadricrómico+A+M+PL
quadriculada	quadriculado+A+F+SG
quadriculadas	quadriculado+A+F+PL
quadriculadazinha	quadriculado+A+DIM+F+SG
quadriculadazinhas	quadriculado+A+DIM+F+PL
quadriculadinha	quadriculado+A+DIM+F+SG
quadriculadinhas	quadriculado+A+DIM+F+PL
quadriculadinho	quadriculado+A+DIM+M+SG
quadriculadinhos	quadriculado+A+DIM+M+PL
quadriculado	quadriculado+A+M+SG
quadriculados	quadriculado+A+M+PL
quadriculadozinho	quadriculado+A+DIM+M+SG
quadriculadozinhos	quadriculado+A+DIM+M+PL
quadricular	quadricular+A+SG
quadriculares	quadricular+A+PL
quadricularezinhas	quadricular+A+DIM+F+PL
quadricularezinhos	quadricular+A+DIM+M+PL
quadricularzinha	quadricular+A+DIM+F+SG
quadricularzinhas	quadricular+A+DIM+F+PL
quadricularzinho	quadricular+A+DIM+M+SG
quadricularzinhos	quadricular+A+DIM+M+PL
quadriculaveizinhas	quadriculável+A+DIM+F+PL
quadriculaveizinhos	quadriculável+A+DIM+M+PL
quadriculavelzinha	quadriculável+A+DIM+F+SG
quadriculavelzinho	quadriculável+A+DIM+M+SG
quadriculáveis	quadriculável+A+PL
quadriculável	quadriculável+A+SG
quadricorneazinha	quadricórneo+A+DIM+F+SG
quadricorneazinhas	quadricórneo+A+DIM+F+PL
quadricorneinha	quadricórneo+A+DIM+F+SG
quadricorneinhas	quadricórneo+A+DIM+F+PL
quadricorneinho	quadricórneo+A+DIM+M+SG
quadricorneinhos	quadricórneo+A+DIM+M+PL
quadricorneozinho	quadricórneo+A+DIM+M+SG
quadricorneozinhos	quadricórneo+A+DIM+M+PL
quadricórnea	quadricórneo+A+F+SG
quadricórneas	quadricórneo+A+F+PL
quadricórneo	quadricórneo+A+M+SG
quadricórneos	quadricórneo+A+M+PL
quadricuspidezinha	quadricúspide+A+DIM+F+SG
quadricuspidezinhas	quadricúspide+A+DIM+F+PL
quadricuspidezinho	quadricúspide+A+DIM+M+SG
quadricuspidezinhos	quadricúspide+A+DIM+M+PL
quadricuspidinha	quadricúspide+A+DIM+F+SG
quadricuspidinhas	quadricúspide+A+DIM+F+PL
quadricuspidinho	quadricúspide+A+DIM+M+SG
quadricuspidinhos	quadricúspide+A+DIM+M+PL
quadricúspide	quadricúspide+A+SG
quadricúspides	quadricúspide+A+PL
quadridentada	quadridentado+A+F+SG
quadridentadas	quadridentado+A+F+PL
quadridentadazinha	quadridentado+A+DIM+F+SG
quadridentadazinhas	quadridentado+A+DIM+F+PL
quadridentadinha	quadridentado+A+DIM+F+SG
quadridentadinhas	quadridentado+A+DIM+F+PL
quadridentadinho	quadridentado+A+DIM+M+SG
quadridentadinhos	quadridentado+A+DIM+M+PL
quadridentado	quadridentado+A+M+SG
quadridentados	quadridentado+A+M+PL
quadridentadozinho	quadridentado+A+DIM+M+SG
quadridentadozinhos	quadridentado+A+DIM+M+PL
quadridigitada	quadridigitado+A+F+SG
quadridigitadas	quadridigitado+A+F+PL
quadridigitadazinha	quadridigitado+A+DIM+F+SG
quadridigitadazinhas	quadridigitado+A+DIM+F+PL
quadridigitadinha	quadridigitado+A+DIM+F+SG
quadridigitadinhas	quadridigitado+A+DIM+F+PL
quadridigitadinho	quadridigitado+A+DIM+M+SG
quadridigitadinhos	quadridigitado+A+DIM+M+PL
quadridigitado	quadridigitado+A+M+SG
quadridigitados	quadridigitado+A+M+PL
quadridigitadozinho	quadridigitado+A+DIM+M+SG
quadridigitadozinhos	quadridigitado+A+DIM+M+PL
quadrienais	quadrienal+A+PL
quadrienaizinhas	quadrienal+A+DIM+F+PL
quadrienaizinhos	quadrienal+A+DIM+M+PL
quadrienal	quadrienal+A+SG
quadrienalzinha	quadrienal+A+DIM+F+SG
quadrienalzinho	quadrienal+A+DIM+M+SG
quadrifendida	quadrifendido+A+F+SG
quadrifendidas	quadrifendido+A+F+PL
quadrifendidazinha	quadrifendido+A+DIM+F+SG
quadrifendidazinhas	quadrifendido+A+DIM+F+PL
quadrifendidinha	quadrifendido+A+DIM+F+SG
quadrifendidinhas	quadrifendido+A+DIM+F+PL
quadrifendidinho	quadrifendido+A+DIM+M+SG
quadrifendidinhos	quadrifendido+A+DIM+M+PL
quadrifendido	quadrifendido+A+M+SG
quadrifendidos	quadrifendido+A+M+PL
quadrifendidozinho	quadrifendido+A+DIM+M+SG
quadrifendidozinhos	quadrifendido+A+DIM+M+PL
quadrifloreazinha	quadriflóreo+A+DIM+F+SG
quadrifloreazinhas	quadriflóreo+A+DIM+F+PL
quadrifloreinha	quadriflóreo+A+DIM+F+SG
quadrifloreinhas	quadriflóreo+A+DIM+F+PL
quadrifloreinho	quadriflóreo+A+DIM+M+SG
quadrifloreinhos	quadriflóreo+A+DIM+M+PL
quadrifloreozinho	quadriflóreo+A+DIM+M+SG
quadrifloreozinhos	quadriflóreo+A+DIM+M+PL
quadriflórea	quadriflóreo+A+F+SG
quadriflóreas	quadriflóreo+A+F+PL
quadriflóreo	quadriflóreo+A+M+SG
quadriflóreos	quadriflóreo+A+M+PL
quadrifoliada	quadrifoliado+A+F+SG
quadrifoliadas	quadrifoliado+A+F+PL
quadrifoliadazinha	quadrifoliado+A+DIM+F+SG
quadrifoliadazinhas	quadrifoliado+A+DIM+F+PL
quadrifoliadinha	quadrifoliado+A+DIM+F+SG
quadrifoliadinhas	quadrifoliado+A+DIM+F+PL
quadrifoliadinho	quadrifoliado+A+DIM+M+SG
quadrifoliadinhos	quadrifoliado+A+DIM+M+PL
quadrifoliado	quadrifoliado+A+M+SG
quadrifoliados	quadrifoliado+A+M+PL
quadrifoliadozinho	quadrifoliado+A+DIM+M+SG
quadrifoliadozinhos	quadrifoliado+A+DIM+M+PL
quadriforme	quadriforme+A+SG
quadriformes	quadriforme+A+PL
quadriformezinha	quadriforme+A+DIM+F+SG
quadriformezinhas	quadriforme+A+DIM+F+PL
quadriformezinho	quadriforme+A+DIM+M+SG
quadriformezinhos	quadriforme+A+DIM+M+PL
quadriforminha	quadriforme+A+DIM+F+SG
quadriforminhas	quadriforme+A+DIM+F+PL
quadriforminho	quadriforme+A+DIM+M+SG
quadriforminhos	quadriforme+A+DIM+M+PL
quadrifronte	quadrifronte+A+SG
quadrifrontes	quadrifronte+A+PL
quadrifrontezinha	quadrifronte+A+DIM+F+SG
quadrifrontezinhas	quadrifronte+A+DIM+F+PL
quadrifrontezinho	quadrifronte+A+DIM+M+SG
quadrifrontezinhos	quadrifronte+A+DIM+M+PL
quadrifrontinha	quadrifronte+A+DIM+F+SG
quadrifrontinhas	quadrifronte+A+DIM+F+PL
quadrifrontinho	quadrifronte+A+DIM+M+SG
quadrifrontinhos	quadrifronte+A+DIM+M+PL
quadrifurcada	quadrifurcado+A+F+SG
quadrifurcadas	quadrifurcado+A+F+PL
quadrifurcadazinha	quadrifurcado+A+DIM+F+SG
quadrifurcadazinhas	quadrifurcado+A+DIM+F+PL
quadrifurcadinha	quadrifurcado+A+DIM+F+SG
quadrifurcadinhas	quadrifurcado+A+DIM+F+PL
quadrifurcadinho	quadrifurcado+A+DIM+M+SG
quadrifurcadinhos	quadrifurcado+A+DIM+M+PL
quadrifurcado	quadrifurcado+A+M+SG
quadrifurcados	quadrifurcado+A+M+PL
quadrifurcadozinho	quadrifurcado+A+DIM+M+SG
quadrifurcadozinhos	quadrifurcado+A+DIM+M+PL
quadrifoliazinha	quadrifólio+A+DIM+F+SG
quadrifoliazinhas	quadrifólio+A+DIM+F+PL
quadrifolinha	quadrifólio+A+DIM+F+SG
quadrifolinhas	quadrifólio+A+DIM+F+PL
quadrifolinho	quadrifólio+A+DIM+M+SG
quadrifolinhos	quadrifólio+A+DIM+M+PL
quadrifoliozinho	quadrifólio+A+DIM+M+SG
quadrifoliozinhos	quadrifólio+A+DIM+M+PL
quadrifólia	quadrifólio+A+F+SG
quadrifólias	quadrifólio+A+F+PL
quadrifólio	quadrifólio+A+M+SG
quadrifólios	quadrifólio+A+M+PL
quadrigentenariazinha	quadrigentenário+A+DIM+F+SG
quadrigentenariazinhas	quadrigentenário+A+DIM+F+PL
quadrigentenarinha	quadrigentenário+A+DIM+F+SG
quadrigentenarinhas	quadrigentenário+A+DIM+F+PL
quadrigentenarinho	quadrigentenário+A+DIM+M+SG
quadrigentenarinhos	quadrigentenário+A+DIM+M+PL
quadrigentenariozinho	quadrigentenário+A+DIM+M+SG
quadrigentenariozinhos	quadrigentenário+A+DIM+M+PL
quadrigentenária	quadrigentenário+A+F+SG
quadrigentenárias	quadrigentenário+A+F+PL
quadrigentenário	quadrigentenário+A+M+SG
quadrigentenários	quadrigentenário+A+M+PL
quadrigemeazinha	quadrigémeo+A+DIM+F+SG
quadrigemeazinhas	quadrigémeo+A+DIM+F+PL
quadrigemeinha	quadrigémeo+A+DIM+F+SG
quadrigemeinhas	quadrigémeo+A+DIM+F+PL
quadrigemeinho	quadrigémeo+A+DIM+M+SG
quadrigemeinhos	quadrigémeo+A+DIM+M+PL
quadrigemeozinho	quadrigémeo+A+DIM+M+SG
quadrigemeozinhos	quadrigémeo+A+DIM+M+PL
quadrigémea	quadrigémeo+A+F+SG
quadrigémeas	quadrigémeo+A+F+PL
quadrigémeo	quadrigémeo+A+M+SG
quadrigémeos	quadrigémeo+A+M+PL
quadrigeminazinha	quadrigémino+A+DIM+F+SG
quadrigeminazinhas	quadrigémino+A+DIM+F+PL
quadrigemininha	quadrigémino+A+DIM+F+SG
quadrigemininhas	quadrigémino+A+DIM+F+PL
quadrigemininho	quadrigémino+A+DIM+M+SG
quadrigemininhos	quadrigémino+A+DIM+M+PL
quadrigeminozinho	quadrigémino+A+DIM+M+SG
quadrigeminozinhos	quadrigémino+A+DIM+M+PL
quadrigémina	quadrigémino+A+F+SG
quadrigéminas	quadrigémino+A+F+PL
quadrigémino	quadrigémino+A+M+SG
quadrigéminos	quadrigémino+A+M+PL
quadrigemeazinha	quadrigêmeo+A+DIM+F+SG
quadrigemeazinhas	quadrigêmeo+A+DIM+F+PL
quadrigemeinha	quadrigêmeo+A+DIM+F+SG
quadrigemeinhas	quadrigêmeo+A+DIM+F+PL
quadrigemeinho	quadrigêmeo+A+DIM+M+SG
quadrigemeinhos	quadrigêmeo+A+DIM+M+PL
quadrigemeozinho	quadrigêmeo+A+DIM+M+SG
quadrigemeozinhos	quadrigêmeo+A+DIM+M+PL
quadrigêmea	quadrigêmeo+A+F+SG
quadrigêmeas	quadrigêmeo+A+F+PL
quadrigêmeo	quadrigêmeo+A+M+SG
quadrigêmeos	quadrigêmeo+A+M+PL
quadrigeminazinha	quadrigêmino+A+DIM+F+SG
quadrigeminazinhas	quadrigêmino+A+DIM+F+PL
quadrigemininha	quadrigêmino+A+DIM+F+SG
quadrigemininhas	quadrigêmino+A+DIM+F+PL
quadrigemininho	quadrigêmino+A+DIM+M+SG
quadrigemininhos	quadrigêmino+A+DIM+M+PL
quadrigeminozinho	quadrigêmino+A+DIM+M+SG
quadrigeminozinhos	quadrigêmino+A+DIM+M+PL
quadrigêmina	quadrigêmino+A+F+SG
quadrigêminas	quadrigêmino+A+F+PL
quadrigêmino	quadrigêmino+A+M+SG
quadrigêminos	quadrigêmino+A+M+PL
quadrigumeazinha	quadrigúmeo+A+DIM+F+SG
quadrigumeazinhas	quadrigúmeo+A+DIM+F+PL
quadrigumeinha	quadrigúmeo+A+DIM+F+SG
quadrigumeinhas	quadrigúmeo+A+DIM+F+PL
quadrigumeinho	quadrigúmeo+A+DIM+M+SG
quadrigumeinhos	quadrigúmeo+A+DIM+M+PL
quadrigumeozinho	quadrigúmeo+A+DIM+M+SG
quadrigumeozinhos	quadrigúmeo+A+DIM+M+PL
quadrigúmea	quadrigúmeo+A+F+SG
quadrigúmeas	quadrigúmeo+A+F+PL
quadrigúmeo	quadrigúmeo+A+M+SG
quadrigúmeos	quadrigúmeo+A+M+PL
quadrilaterais	quadrilateral+A+PL
quadrilateraizinhas	quadrilateral+A+DIM+F+PL
quadrilateraizinhos	quadrilateral+A+DIM+M+PL
quadrilateral	quadrilateral+A+SG
quadrilateralzinha	quadrilateral+A+DIM+F+SG
quadrilateralzinho	quadrilateral+A+DIM+M+SG
quadrilobulada	quadrilobulado+A+F+SG
quadrilobuladas	quadrilobulado+A+F+PL
quadrilobuladazinha	quadrilobulado+A+DIM+F+SG
quadrilobuladazinhas	quadrilobulado+A+DIM+F+PL
quadrilobuladinha	quadrilobulado+A+DIM+F+SG
quadrilobuladinhas	quadrilobulado+A+DIM+F+PL
quadrilobuladinho	quadrilobulado+A+DIM+M+SG
quadrilobuladinhos	quadrilobulado+A+DIM+M+PL
quadrilobulado	quadrilobulado+A+M+SG
quadrilobulados	quadrilobulado+A+M+PL
quadrilobuladozinho	quadrilobulado+A+DIM+M+SG
quadrilobuladozinhos	quadrilobulado+A+DIM+M+PL
quadriloculada	quadriloculado+A+F+SG
quadriloculadas	quadriloculado+A+F+PL
quadriloculadazinha	quadriloculado+A+DIM+F+SG
quadriloculadazinhas	quadriloculado+A+DIM+F+PL
quadriloculadinha	quadriloculado+A+DIM+F+SG
quadriloculadinhas	quadriloculado+A+DIM+F+PL
quadriloculadinho	quadriloculado+A+DIM+M+SG
quadriloculadinhos	quadriloculado+A+DIM+M+PL
quadriloculado	quadriloculado+A+M+SG
quadriloculados	quadriloculado+A+M+PL
quadriloculadozinho	quadriloculado+A+DIM+M+SG
quadriloculadozinhos	quadriloculado+A+DIM+M+PL
quadrilocular	quadrilocular+A+SG
quadriloculares	quadrilocular+A+PL
quadrilocularezinhas	quadrilocular+A+DIM+F+PL
quadrilocularezinhos	quadrilocular+A+DIM+M+PL
quadrilocularzinha	quadrilocular+A+DIM+F+SG
quadrilocularzinhas	quadrilocular+A+DIM+F+PL
quadrilocularzinho	quadrilocular+A+DIM+M+SG
quadrilocularzinhos	quadrilocular+A+DIM+M+PL
quadrilonga	quadrilongo+A+F+SG
quadrilongas	quadrilongo+A+F+PL
quadrilongazinha	quadrilongo+A+DIM+F+SG
quadrilongazinhas	quadrilongo+A+DIM+F+PL
quadrilongo	quadrilongo+A+M+SG
quadrilongos	quadrilongo+A+M+PL
quadrilongozinho	quadrilongo+A+DIM+M+SG
quadrilongozinhos	quadrilongo+A+DIM+M+PL
quadrilonguinha	quadrilongo+A+DIM+F+SG
quadrilonguinhas	quadrilongo+A+DIM+F+PL
quadrilonguinho	quadrilongo+A+DIM+M+SG
quadrilonguinhos	quadrilongo+A+DIM+M+PL
quadrilunulada	quadrilunulado+A+F+SG
quadrilunuladas	quadrilunulado+A+F+PL
quadrilunuladazinha	quadrilunulado+A+DIM+F+SG
quadrilunuladazinhas	quadrilunulado+A+DIM+F+PL
quadrilunuladinha	quadrilunulado+A+DIM+F+SG
quadrilunuladinhas	quadrilunulado+A+DIM+F+PL
quadrilunuladinho	quadrilunulado+A+DIM+M+SG
quadrilunuladinhos	quadrilunulado+A+DIM+M+PL
quadrilunulado	quadrilunulado+A+M+SG
quadrilunulados	quadrilunulado+A+M+PL
quadrilunuladozinho	quadrilunulado+A+DIM+M+SG
quadrilunuladozinhos	quadrilunulado+A+DIM+M+PL
quadrilaterazinha	quadrilátero+A+DIM+F+SG
quadrilaterazinhas	quadrilátero+A+DIM+F+PL
quadrilaterinha	quadrilátero+A+DIM+F+SG
quadrilaterinhas	quadrilátero+A+DIM+F+PL
quadrilaterinho	quadrilátero+A+DIM+M+SG
quadrilaterinhos	quadrilátero+A+DIM+M+PL
quadrilaterozinho	quadrilátero+A+DIM+M+SG
quadrilaterozinhos	quadrilátero+A+DIM+M+PL
quadrilátera	quadrilátero+A+F+SG
quadriláteras	quadrilátero+A+F+PL
quadrilátero	quadrilátero+A+M+SG
quadriláteros	quadrilátero+A+M+PL
quadrimaculada	quadrimaculado+A+F+SG
quadrimaculadas	quadrimaculado+A+F+PL
quadrimaculadazinha	quadrimaculado+A+DIM+F+SG
quadrimaculadazinhas	quadrimaculado+A+DIM+F+PL
quadrimaculadinha	quadrimaculado+A+DIM+F+SG
quadrimaculadinhas	quadrimaculado+A+DIM+F+PL
quadrimaculadinho	quadrimaculado+A+DIM+M+SG
quadrimaculadinhos	quadrimaculado+A+DIM+M+PL
quadrimaculado	quadrimaculado+A+M+SG
quadrimaculados	quadrimaculado+A+M+PL
quadrimaculadozinho	quadrimaculado+A+DIM+M+SG
quadrimaculadozinhos	quadrimaculado+A+DIM+M+PL
quadrimembre	quadrimembre+A+SG
quadrimembres	quadrimembre+A+PL
quadrimembrezinha	quadrimembre+A+DIM+F+SG
quadrimembrezinhas	quadrimembre+A+DIM+F+PL
quadrimembrezinho	quadrimembre+A+DIM+M+SG
quadrimembrezinhos	quadrimembre+A+DIM+M+PL
quadrimembrinha	quadrimembre+A+DIM+F+SG
quadrimembrinhas	quadrimembre+A+DIM+F+PL
quadrimembrinho	quadrimembre+A+DIM+M+SG
quadrimembrinhos	quadrimembre+A+DIM+M+PL
quadrimestrais	quadrimestral+A+PL
quadrimestraizinhas	quadrimestral+A+DIM+F+PL
quadrimestraizinhos	quadrimestral+A+DIM+M+PL
quadrimestral	quadrimestral+A+SG
quadrimestralzinha	quadrimestral+A+DIM+F+SG
quadrimestralzinho	quadrimestral+A+DIM+M+SG
quadrimosqueada	quadrimosqueado+A+F+SG
quadrimosqueadas	quadrimosqueado+A+F+PL
quadrimosqueadazinha	quadrimosqueado+A+DIM+F+SG
quadrimosqueadazinhas	quadrimosqueado+A+DIM+F+PL
quadrimosqueadinha	quadrimosqueado+A+DIM+F+SG
quadrimosqueadinhas	quadrimosqueado+A+DIM+F+PL
quadrimosqueadinho	quadrimosqueado+A+DIM+M+SG
quadrimosqueadinhos	quadrimosqueado+A+DIM+M+PL
quadrimosqueado	quadrimosqueado+A+M+SG
quadrimosqueados	quadrimosqueado+A+M+PL
quadrimosqueadozinho	quadrimosqueado+A+DIM+M+SG
quadrimosqueadozinhos	quadrimosqueado+A+DIM+M+PL
quadrimotor	quadrimotor+A+M+SG
quadrimotora	quadrimotor+A+F+SG
quadrimotoras	quadrimotor+A+F+PL
quadrimotorazinha	quadrimotor+A+DIM+F+SG
quadrimotorazinhas	quadrimotor+A+DIM+F+PL
quadrimotores	quadrimotor+A+M+PL
quadrimotorezinhos	quadrimotor+A+DIM+M+PL
quadrimotorinha	quadrimotor+A+DIM+F+SG
quadrimotorinhas	quadrimotor+A+DIM+F+PL
quadrimotorzinho	quadrimotor+A+DIM+M+SG
quadrimotorzinhos	quadrimotor+A+DIM+M+PL
quadrinizaveizinhas	quadrinizável+A+DIM+F+PL
quadrinizaveizinhos	quadrinizável+A+DIM+M+PL
quadrinizavelzinha	quadrinizável+A+DIM+F+SG
quadrinizavelzinho	quadrinizável+A+DIM+M+SG
quadrinizáveis	quadrinizável+A+PL
quadrinizável	quadrinizável+A+SG
quadripartida	quadripartido+A+F+SG
quadripartidas	quadripartido+A+F+PL
quadripartidazinha	quadripartido+A+DIM+F+SG
quadripartidazinhas	quadripartido+A+DIM+F+PL
quadripartidinha	quadripartido+A+DIM+F+SG
quadripartidinhas	quadripartido+A+DIM+F+PL
quadripartidinho	quadripartido+A+DIM+M+SG
quadripartidinhos	quadripartido+A+DIM+M+PL
quadripartido	quadripartido+A+M+SG
quadripartidos	quadripartido+A+M+PL
quadripartidozinho	quadripartido+A+DIM+M+SG
quadripartidozinhos	quadripartido+A+DIM+M+PL
quadripenada	quadripenado+A+F+SG
quadripenadas	quadripenado+A+F+PL
quadripenadazinha	quadripenado+A+DIM+F+SG
quadripenadazinhas	quadripenado+A+DIM+F+PL
quadripenadinha	quadripenado+A+DIM+F+SG
quadripenadinhas	quadripenado+A+DIM+F+PL
quadripenadinho	quadripenado+A+DIM+M+SG
quadripenadinhos	quadripenado+A+DIM+M+PL
quadripenado	quadripenado+A+M+SG
quadripenados	quadripenado+A+M+PL
quadripenadozinho	quadripenado+A+DIM+M+SG
quadripenadozinhos	quadripenado+A+DIM+M+PL
quadripene	quadripene+A+SG
quadripenes	quadripene+A+PL
quadripenezinha	quadripene+A+DIM+F+SG
quadripenezinhas	quadripene+A+DIM+F+PL
quadripenezinho	quadripene+A+DIM+M+SG
quadripenezinhos	quadripene+A+DIM+M+PL
quadripeninha	quadripene+A+DIM+F+SG
quadripeninhas	quadripene+A+DIM+F+PL
quadripeninho	quadripene+A+DIM+M+SG
quadripeninhos	quadripene+A+DIM+M+PL
quadriplicada	quadriplicado+A+F+SG
quadriplicadas	quadriplicado+A+F+PL
quadriplicadazinha	quadriplicado+A+DIM+F+SG
quadriplicadazinhas	quadriplicado+A+DIM+F+PL
quadriplicadinha	quadriplicado+A+DIM+F+SG
quadriplicadinhas	quadriplicado+A+DIM+F+PL
quadriplicadinho	quadriplicado+A+DIM+M+SG
quadriplicadinhos	quadriplicado+A+DIM+M+PL
quadriplicado	quadriplicado+A+M+SG
quadriplicados	quadriplicado+A+M+PL
quadriplicadozinho	quadriplicado+A+DIM+M+SG
quadriplicadozinhos	quadriplicado+A+DIM+M+PL
quadriplicaveizinhas	quadriplicável+A+DIM+F+PL
quadriplicaveizinhos	quadriplicável+A+DIM+M+PL
quadriplicavelzinha	quadriplicável+A+DIM+F+SG
quadriplicavelzinho	quadriplicável+A+DIM+M+SG
quadriplicáveis	quadriplicável+A+PL
quadriplicável	quadriplicável+A+SG
quadriplegicazinha	quadriplégico+A+DIM+F+SG
quadriplegicazinhas	quadriplégico+A+DIM+F+PL
quadriplegicozinho	quadriplégico+A+DIM+M+SG
quadriplegicozinhos	quadriplégico+A+DIM+M+PL
quadriplegiquinha	quadriplégico+A+DIM+F+SG
quadriplegiquinhas	quadriplégico+A+DIM+F+PL
quadriplegiquinho	quadriplégico+A+DIM+M+SG
quadriplegiquinhos	quadriplégico+A+DIM+M+PL
quadriplégica	quadriplégico+A+F+SG
quadriplégicas	quadriplégico+A+F+PL
quadriplégico	quadriplégico+A+M+SG
quadriplégicos	quadriplégico+A+M+PL
quadripetalazinha	quadripétalo+A+DIM+F+SG
quadripetalazinhas	quadripétalo+A+DIM+F+PL
quadripetalinha	quadripétalo+A+DIM+F+SG
quadripetalinhas	quadripétalo+A+DIM+F+PL
quadripetalinho	quadripétalo+A+DIM+M+SG
quadripetalinhos	quadripétalo+A+DIM+M+PL
quadripetalozinho	quadripétalo+A+DIM+M+SG
quadripetalozinhos	quadripétalo+A+DIM+M+PL
quadripétala	quadripétalo+A+F+SG
quadripétalas	quadripétalo+A+F+PL
quadripétalo	quadripétalo+A+M+SG
quadripétalos	quadripétalo+A+M+PL
quadrirreator	quadrirreator+A+M+SG
quadrirreatora	quadrirreator+A+F+SG
quadrirreatoras	quadrirreator+A+F+PL
quadrirreatorazinha	quadrirreator+A+DIM+F+SG
quadrirreatorazinhas	quadrirreator+A+DIM+F+PL
quadrirreatores	quadrirreator+A+M+PL
quadrirreatorezinhos	quadrirreator+A+DIM+M+PL
quadrirreatorinha	quadrirreator+A+DIM+F+SG
quadrirreatorinhas	quadrirreator+A+DIM+F+PL
quadrirreatorzinho	quadrirreator+A+DIM+M+SG
quadrirreatorzinhos	quadrirreator+A+DIM+M+PL
quadrissecular	quadrissecular+A+SG
quadrisseculares	quadrissecular+A+PL
quadrissecularezinhas	quadrissecular+A+DIM+F+PL
quadrissecularezinhos	quadrissecular+A+DIM+M+PL
quadrissecularzinha	quadrissecular+A+DIM+F+SG
quadrissecularzinhas	quadrissecular+A+DIM+F+PL
quadrissecularzinho	quadrissecular+A+DIM+M+SG
quadrissecularzinhos	quadrissecular+A+DIM+M+PL
quadrissemanais	quadrissemanal+A+PL
quadrissemanaizinhas	quadrissemanal+A+DIM+F+PL
quadrissemanaizinhos	quadrissemanal+A+DIM+M+PL
quadrissemanal	quadrissemanal+A+SG
quadrissemanalzinha	quadrissemanal+A+DIM+F+SG
quadrissemanalzinho	quadrissemanal+A+DIM+M+SG
quadrissilabicazinha	quadrissilábico+A+DIM+F+SG
quadrissilabicazinhas	quadrissilábico+A+DIM+F+PL
quadrissilabicozinho	quadrissilábico+A+DIM+M+SG
quadrissilabicozinhos	quadrissilábico+A+DIM+M+PL
quadrissilabiquinha	quadrissilábico+A+DIM+F+SG
quadrissilabiquinhas	quadrissilábico+A+DIM+F+PL
quadrissilabiquinho	quadrissilábico+A+DIM+M+SG
quadrissilabiquinhos	quadrissilábico+A+DIM+M+PL
quadrissilábica	quadrissilábico+A+F+SG
quadrissilábicas	quadrissilábico+A+F+PL
quadrissilábico	quadrissilábico+A+M+SG
quadrissilábicos	quadrissilábico+A+M+PL
quadrissilabazinha	quadrissílabo+A+DIM+F+SG
quadrissilabazinhas	quadrissílabo+A+DIM+F+PL
quadrissilabinha	quadrissílabo+A+DIM+F+SG
quadrissilabinhas	quadrissílabo+A+DIM+F+PL
quadrissilabinho	quadrissílabo+A+DIM+M+SG
quadrissilabinhos	quadrissílabo+A+DIM+M+PL
quadrissilabozinho	quadrissílabo+A+DIM+M+SG
quadrissilabozinhos	quadrissílabo+A+DIM+M+PL
quadrissílaba	quadrissílabo+A+F+SG
quadrissílabas	quadrissílabo+A+F+PL
quadrissílabo	quadrissílabo+A+M+SG
quadrissílabos	quadrissílabo+A+M+PL
quadrivalente	quadrivalente+A+SG
quadrivalentes	quadrivalente+A+PL
quadrivalentezinha	quadrivalente+A+DIM+F+SG
quadrivalentezinhas	quadrivalente+A+DIM+F+PL
quadrivalentezinho	quadrivalente+A+DIM+M+SG
quadrivalentezinhos	quadrivalente+A+DIM+M+PL
quadrivalentinha	quadrivalente+A+DIM+F+SG
quadrivalentinhas	quadrivalente+A+DIM+F+PL
quadrivalentinho	quadrivalente+A+DIM+M+SG
quadrivalentinhos	quadrivalente+A+DIM+M+PL
quadrivalve	quadrivalve+A+SG
quadrivalves	quadrivalve+A+PL
quadrivalvezinha	quadrivalve+A+DIM+F+SG
quadrivalvezinhas	quadrivalve+A+DIM+F+PL
quadrivalvezinho	quadrivalve+A+DIM+M+SG
quadrivalvezinhos	quadrivalve+A+DIM+M+PL
quadrivalvinha	quadrivalve+A+DIM+F+SG
quadrivalvinhas	quadrivalve+A+DIM+F+PL
quadrivalvinho	quadrivalve+A+DIM+M+SG
quadrivalvinhos	quadrivalve+A+DIM+M+PL
quadrivalvulada	quadrivalvulado+A+F+SG
quadrivalvuladas	quadrivalvulado+A+F+PL
quadrivalvuladazinha	quadrivalvulado+A+DIM+F+SG
quadrivalvuladazinhas	quadrivalvulado+A+DIM+F+PL
quadrivalvuladinha	quadrivalvulado+A+DIM+F+SG
quadrivalvuladinhas	quadrivalvulado+A+DIM+F+PL
quadrivalvuladinho	quadrivalvulado+A+DIM+M+SG
quadrivalvuladinhos	quadrivalvulado+A+DIM+M+PL
quadrivalvulado	quadrivalvulado+A+M+SG
quadrivalvulados	quadrivalvulado+A+M+PL
quadrivalvuladozinho	quadrivalvulado+A+DIM+M+SG
quadrivalvuladozinhos	quadrivalvulado+A+DIM+M+PL
quadrivalvular	quadrivalvular+A+SG
quadrivalvulares	quadrivalvular+A+PL
quadrivalvularezinhas	quadrivalvular+A+DIM+F+PL
quadrivalvularezinhos	quadrivalvular+A+DIM+M+PL
quadrivalvularzinha	quadrivalvular+A+DIM+F+SG
quadrivalvularzinhas	quadrivalvular+A+DIM+F+PL
quadrivalvularzinho	quadrivalvular+A+DIM+M+SG
quadrivalvularzinhos	quadrivalvular+A+DIM+M+PL
quadrupedante	quadrupedante+A+SG
quadrupedantes	quadrupedante+A+PL
quadrupedantezinha	quadrupedante+A+DIM+F+SG
quadrupedantezinhas	quadrupedante+A+DIM+F+PL
quadrupedantezinho	quadrupedante+A+DIM+M+SG
quadrupedantezinhos	quadrupedante+A+DIM+M+PL
quadrupedantinha	quadrupedante+A+DIM+F+SG
quadrupedantinhas	quadrupedante+A+DIM+F+PL
quadrupedantinho	quadrupedante+A+DIM+M+SG
quadrupedantinhos	quadrupedante+A+DIM+M+PL
quadrupedaveizinhas	quadrupedável+A+DIM+F+PL
quadrupedaveizinhos	quadrupedável+A+DIM+M+PL
quadrupedavelzinha	quadrupedável+A+DIM+F+SG
quadrupedavelzinho	quadrupedável+A+DIM+M+SG
quadrupedáveis	quadrupedável+A+PL
quadrupedável	quadrupedável+A+SG
quadruplicada	quadruplicado+A+F+SG
quadruplicadas	quadruplicado+A+F+PL
quadruplicadazinha	quadruplicado+A+DIM+F+SG
quadruplicadazinhas	quadruplicado+A+DIM+F+PL
quadruplicadinha	quadruplicado+A+DIM+F+SG
quadruplicadinhas	quadruplicado+A+DIM+F+PL
quadruplicadinho	quadruplicado+A+DIM+M+SG
quadruplicadinhos	quadruplicado+A+DIM+M+PL
quadruplicado	quadruplicado+A+M+SG
quadruplicados	quadruplicado+A+M+PL
quadruplicadozinho	quadruplicado+A+DIM+M+SG
quadruplicadozinhos	quadruplicado+A+DIM+M+PL
quadruplicaveizinhas	quadruplicável+A+DIM+F+PL
quadruplicaveizinhos	quadruplicável+A+DIM+M+PL
quadruplicavelzinha	quadruplicável+A+DIM+F+SG
quadruplicavelzinho	quadruplicável+A+DIM+M+SG
quadruplicáveis	quadruplicável+A+PL
quadruplicável	quadruplicável+A+SG
quadruplaveizinhas	quadruplável+A+DIM+F+PL
quadruplaveizinhos	quadruplável+A+DIM+M+PL
quadruplavelzinha	quadruplável+A+DIM+F+SG
quadruplavelzinho	quadruplável+A+DIM+M+SG
quadrupláveis	quadruplável+A+PL
quadruplável	quadruplável+A+SG
quadraticazinha	quadrático+A+DIM+F+SG
quadraticazinhas	quadrático+A+DIM+F+PL
quadraticozinho	quadrático+A+DIM+M+SG
quadraticozinhos	quadrático+A+DIM+M+PL
quadratiquinha	quadrático+A+DIM+F+SG
quadratiquinhas	quadrático+A+DIM+F+PL
quadratiquinho	quadrático+A+DIM+M+SG
quadratiquinhos	quadrático+A+DIM+M+PL
quadrática	quadrático+A+F+SG
quadráticas	quadrático+A+F+PL
quadrático	quadrático+A+M+SG
quadráticos	quadrático+A+M+PL
quadraveizinhas	quadrável+A+DIM+F+PL
quadraveizinhos	quadrável+A+DIM+M+PL
quadravelzinha	quadrável+A+DIM+F+SG
quadravelzinho	quadrável+A+DIM+M+SG
quadráveis	quadrável+A+PL
quadrável	quadrável+A+SG
quadricepsinha	quadríceps+A+DIM+F+SG
quadricepsinhas	quadríceps+A+DIM+F+PL
quadricepsinho	quadríceps+A+DIM+M+SG
quadricepsinhos	quadríceps+A+DIM+M+PL
quadríceps	quadríceps+A
quadrificazinha	quadrífico+A+DIM+F+SG
quadrificazinhas	quadrífico+A+DIM+F+PL
quadrificozinho	quadrífico+A+DIM+M+SG
quadrificozinhos	quadrífico+A+DIM+M+PL
quadrifiquinha	quadrífico+A+DIM+F+SG
quadrifiquinhas	quadrífico+A+DIM+F+PL
quadrifiquinho	quadrífico+A+DIM+M+SG
quadrifiquinhos	quadrífico+A+DIM+M+PL
quadrífica	quadrífico+A+F+SG
quadríficas	quadrífico+A+F+PL
quadrífico	quadrífico+A+M+SG
quadríficos	quadrífico+A+M+PL
quadrijugazinha	quadríjugo+A+DIM+F+SG
quadrijugazinhas	quadríjugo+A+DIM+F+PL
quadrijugozinho	quadríjugo+A+DIM+M+SG
quadrijugozinhos	quadríjugo+A+DIM+M+PL
quadrijuguinha	quadríjugo+A+DIM+F+SG
quadrijuguinhas	quadríjugo+A+DIM+F+PL
quadrijuguinho	quadríjugo+A+DIM+M+SG
quadrijuguinhos	quadríjugo+A+DIM+M+PL
quadríjuga	quadríjugo+A+F+SG
quadríjugas	quadríjugo+A+F+PL
quadríjugo	quadríjugo+A+M+SG
quadríjugos	quadríjugo+A+M+PL
quadrimanazinha	quadrímano+A+DIM+F+SG
quadrimanazinhas	quadrímano+A+DIM+F+PL
quadrimaninha	quadrímano+A+DIM+F+SG
quadrimaninhas	quadrímano+A+DIM+F+PL
quadrimaninho	quadrímano+A+DIM+M+SG
quadrimaninhos	quadrímano+A+DIM+M+PL
quadrimanozinho	quadrímano+A+DIM+M+SG
quadrimanozinhos	quadrímano+A+DIM+M+PL
quadrímana	quadrímano+A+F+SG
quadrímanas	quadrímano+A+F+PL
quadrímano	quadrímano+A+M+SG
quadrímanos	quadrímano+A+M+PL
quadrumanazinha	quadrúmano+A+DIM+F+SG
quadrumanazinhas	quadrúmano+A+DIM+F+PL
quadrumaninha	quadrúmano+A+DIM+F+SG
quadrumaninhas	quadrúmano+A+DIM+F+PL
quadrumaninho	quadrúmano+A+DIM+M+SG
quadrumaninhos	quadrúmano+A+DIM+M+PL
quadrumanozinho	quadrúmano+A+DIM+M+SG
quadrumanozinhos	quadrúmano+A+DIM+M+PL
quadrúmana	quadrúmano+A+F+SG
quadrúmanas	quadrúmano+A+F+PL
quadrúmano	quadrúmano+A+M+SG
quadrúmanos	quadrúmano+A+M+PL
quadrupedezinha	quadrúpede+A+DIM+F+SG
quadrupedezinhas	quadrúpede+A+DIM+F+PL
quadrupedezinho	quadrúpede+A+DIM+M+SG
quadrupedezinhos	quadrúpede+A+DIM+M+PL
quadrupedinha	quadrúpede+A+DIM+F+SG
quadrupedinhas	quadrúpede+A+DIM+F+PL
quadrupedinho	quadrúpede+A+DIM+M+SG
quadrupedinhos	quadrúpede+A+DIM+M+PL
quadrúpede	quadrúpede+A+SG
quadrúpedes	quadrúpede+A+PL
qualificada	qualificado+A+F+SG
qualificadas	qualificado+A+F+PL
qualificadazinha	qualificado+A+DIM+F+SG
qualificadazinhas	qualificado+A+DIM+F+PL
qualificadinha	qualificado+A+DIM+F+SG
qualificadinhas	qualificado+A+DIM+F+PL
qualificadinho	qualificado+A+DIM+M+SG
qualificadinhos	qualificado+A+DIM+M+PL
qualificado	qualificado+A+M+SG
qualificados	qualificado+A+M+PL
qualificadozinho	qualificado+A+DIM+M+SG
qualificadozinhos	qualificado+A+DIM+M+PL
qualificadíssima	qualificado+A+SUPER+F+SG
qualificadíssimas	qualificado+A+SUPER+F+PL
qualificadíssimo	qualificado+A+SUPER+M+SG
qualificadíssimos	qualificado+A+SUPER+M+PL
qualificador	qualificador+A+M+SG
qualificadora	qualificador+A+F+SG
qualificadoras	qualificador+A+F+PL
qualificadorazinha	qualificador+A+DIM+F+SG
qualificadorazinhas	qualificador+A+DIM+F+PL
qualificadores	qualificador+A+M+PL
qualificadorezinhos	qualificador+A+DIM+M+PL
qualificadorinha	qualificador+A+DIM+F+SG
qualificadorinhas	qualificador+A+DIM+F+PL
qualificadorzinho	qualificador+A+DIM+M+SG
qualificadorzinhos	qualificador+A+DIM+M+PL
qualificativa	qualificativo+A+F+SG
qualificativas	qualificativo+A+F+PL
qualificativazinha	qualificativo+A+DIM+F+SG
qualificativazinhas	qualificativo+A+DIM+F+PL
qualificativinha	qualificativo+A+DIM+F+SG
qualificativinhas	qualificativo+A+DIM+F+PL
qualificativinho	qualificativo+A+DIM+M+SG
qualificativinhos	qualificativo+A+DIM+M+PL
qualificativo	qualificativo+A+M+SG
qualificativos	qualificativo+A+M+PL
qualificativozinho	qualificativo+A+DIM+M+SG
qualificativozinhos	qualificativo+A+DIM+M+PL
qualificaveizinhas	qualificável+A+DIM+F+PL
qualificaveizinhos	qualificável+A+DIM+M+PL
qualificavelzinha	qualificável+A+DIM+F+SG
qualificavelzinho	qualificável+A+DIM+M+SG
qualificáveis	qualificável+A+PL
qualificável	qualificável+A+SG
qualitativa	qualitativo+A+F+SG
qualitativas	qualitativo+A+F+PL
qualitativazinha	qualitativo+A+DIM+F+SG
qualitativazinhas	qualitativo+A+DIM+F+PL
qualitativinha	qualitativo+A+DIM+F+SG
qualitativinhas	qualitativo+A+DIM+F+PL
qualitativinho	qualitativo+A+DIM+M+SG
qualitativinhos	qualitativo+A+DIM+M+PL
qualitativo	qualitativo+A+M+SG
qualitativos	qualitativo+A+M+PL
qualitativozinho	qualitativo+A+DIM+M+SG
qualitativozinhos	qualitativo+A+DIM+M+PL
quaisquer	qualquer+A+PL
quaisquerzinhas	qualquer+A+DIM+F+PL
quaisquerzinhos	qualquer+A+DIM+M+PL
qualquer	qualquer+A+SG
qualquerzinha	qualquer+A+DIM+F+SG
qualquerzinho	qualquer+A+DIM+M+SG
quanti	quanti+A
quantizinha	quanti+A+DIM+F+SG
quantizinhas	quanti+A+DIM+F+PL
quantizinho	quanti+A+DIM+M+SG
quantizinhos	quanti+A+DIM+M+PL
quantificada	quantificado+A+F+SG
quantificadas	quantificado+A+F+PL
quantificadazinha	quantificado+A+DIM+F+SG
quantificadazinhas	quantificado+A+DIM+F+PL
quantificadinha	quantificado+A+DIM+F+SG
quantificadinhas	quantificado+A+DIM+F+PL
quantificadinho	quantificado+A+DIM+M+SG
quantificadinhos	quantificado+A+DIM+M+PL
quantificado	quantificado+A+M+SG
quantificados	quantificado+A+M+PL
quantificadozinho	quantificado+A+DIM+M+SG
quantificadozinhos	quantificado+A+DIM+M+PL
quantificador	quantificador+A+M+SG
quantificadora	quantificador+A+F+SG
quantificadoras	quantificador+A+F+PL
quantificadorazinha	quantificador+A+DIM+F+SG
quantificadorazinhas	quantificador+A+DIM+F+PL
quantificadores	quantificador+A+M+PL
quantificadorezinhos	quantificador+A+DIM+M+PL
quantificadorinha	quantificador+A+DIM+F+SG
quantificadorinhas	quantificador+A+DIM+F+PL
quantificadorzinho	quantificador+A+DIM+M+SG
quantificadorzinhos	quantificador+A+DIM+M+PL
quantificaveizinhas	quantificável+A+DIM+F+PL
quantificaveizinhos	quantificável+A+DIM+M+PL
quantificavelzinha	quantificável+A+DIM+F+SG
quantificavelzinho	quantificável+A+DIM+M+SG
quantificáveis	quantificável+A+PL
quantificável	quantificável+A+SG
quantiosa	quantioso+A+F+SG
quantiosas	quantioso+A+F+PL
quantiosazinha	quantioso+A+DIM+F+SG
quantiosazinhas	quantioso+A+DIM+F+PL
quantiosinha	quantioso+A+DIM+F+SG
quantiosinhas	quantioso+A+DIM+F+PL
quantiosinho	quantioso+A+DIM+M+SG
quantiosinhos	quantioso+A+DIM+M+PL
quantioso	quantioso+A+M+SG
quantiosos	quantioso+A+M+PL
quantiosozinho	quantioso+A+DIM+M+SG
quantiosozinhos	quantioso+A+DIM+M+PL
quantitativa	quantitativo+A+F+SG
quantitativas	quantitativo+A+F+PL
quantitativazinha	quantitativo+A+DIM+F+SG
quantitativazinhas	quantitativo+A+DIM+F+PL
quantitativinha	quantitativo+A+DIM+F+SG
quantitativinhas	quantitativo+A+DIM+F+PL
quantitativinho	quantitativo+A+DIM+M+SG
quantitativinhos	quantitativo+A+DIM+M+PL
quantitativo	quantitativo+A+M+SG
quantitativos	quantitativo+A+M+PL
quantitativozinho	quantitativo+A+DIM+M+SG
quantitativozinhos	quantitativo+A+DIM+M+PL
quantizada	quantizado+A+F+SG
quantizadas	quantizado+A+F+PL
quantizadazinha	quantizado+A+DIM+F+SG
quantizadazinhas	quantizado+A+DIM+F+PL
quantizadinha	quantizado+A+DIM+F+SG
quantizadinhas	quantizado+A+DIM+F+PL
quantizadinho	quantizado+A+DIM+M+SG
quantizadinhos	quantizado+A+DIM+M+PL
quantizado	quantizado+A+M+SG
quantizados	quantizado+A+M+PL
quantizadozinho	quantizado+A+DIM+M+SG
quantizadozinhos	quantizado+A+DIM+M+PL
quantizaveizinhas	quantizável+A+DIM+F+PL
quantizaveizinhos	quantizável+A+DIM+M+PL
quantizavelzinha	quantizável+A+DIM+F+SG
quantizavelzinho	quantizável+A+DIM+M+SG
quantizáveis	quantizável+A+PL
quantizável	quantizável+A+SG
quantiaveizinhas	quantiável+A+DIM+F+PL
quantiaveizinhos	quantiável+A+DIM+M+PL
quantiavelzinha	quantiável+A+DIM+F+SG
quantiavelzinho	quantiável+A+DIM+M+SG
quantiáveis	quantiável+A+PL
quantiável	quantiável+A+SG
quarciferazinha	quarcífero+A+DIM+F+SG
quarciferazinhas	quarcífero+A+DIM+F+PL
quarciferinha	quarcífero+A+DIM+F+SG
quarciferinhas	quarcífero+A+DIM+F+PL
quarciferinho	quarcífero+A+DIM+M+SG
quarciferinhos	quarcífero+A+DIM+M+PL
quarciferozinho	quarcífero+A+DIM+M+SG
quarciferozinhos	quarcífero+A+DIM+M+PL
quarcífera	quarcífero+A+F+SG
quarcíferas	quarcífero+A+F+PL
quarcífero	quarcífero+A+M+SG
quarcíferos	quarcífero+A+M+PL
quarentenariazinha	quarentenário+A+DIM+F+SG
quarentenariazinhas	quarentenário+A+DIM+F+PL
quarentenarinha	quarentenário+A+DIM+F+SG
quarentenarinhas	quarentenário+A+DIM+F+PL
quarentenarinho	quarentenário+A+DIM+M+SG
quarentenarinhos	quarentenário+A+DIM+M+PL
quarentenariozinho	quarentenário+A+DIM+M+SG
quarentenariozinhos	quarentenário+A+DIM+M+PL
quarentenária	quarentenário+A+F+SG
quarentenárias	quarentenário+A+F+PL
quarentenário	quarentenário+A+M+SG
quarentenários	quarentenário+A+M+PL
quarentenaveizinhas	quarentenável+A+DIM+F+PL
quarentenaveizinhos	quarentenável+A+DIM+M+PL
quarentenavelzinha	quarentenável+A+DIM+F+SG
quarentenavelzinho	quarentenável+A+DIM+M+SG
quarentenáveis	quarentenável+A+PL
quarentenável	quarentenável+A+SG
quarentaveizinhas	quarentável+A+DIM+F+PL
quarentaveizinhos	quarentável+A+DIM+M+PL
quarentavelzinha	quarentável+A+DIM+F+SG
quarentavelzinho	quarentável+A+DIM+M+SG
quarentáveis	quarentável+A+PL
quarentável	quarentável+A+SG
quarentona	quarentão+A+F+SG
quarentonas	quarentão+A+F+PL
quarentonazinha	quarentão+A+DIM+F+SG
quarentonazinhas	quarentão+A+DIM+F+PL
quarentoninha	quarentão+A+DIM+F+SG
quarentoninhas	quarentão+A+DIM+F+PL
quarentão	quarentão+A+M+SG
quarentãozinho	quarentão+A+DIM+M+SG
quarentões	quarentão+A+M+PL
quarentõezinhos	quarentão+A+DIM+M+PL
quaresmais	quaresmal+A+PL
quaresmaizinhas	quaresmal+A+DIM+F+PL
quaresmaizinhos	quaresmal+A+DIM+M+PL
quaresmal	quaresmal+A+SG
quaresmalzinha	quaresmal+A+DIM+F+SG
quaresmalzinho	quaresmal+A+DIM+M+SG
quaresmaveizinhas	quaresmável+A+DIM+F+PL
quaresmaveizinhos	quaresmável+A+DIM+M+PL
quaresmavelzinha	quaresmável+A+DIM+F+SG
quaresmavelzinho	quaresmável+A+DIM+M+SG
quaresmáveis	quaresmável+A+PL
quaresmável	quaresmável+A+SG
quartada	quartado+A+F+SG
quartadas	quartado+A+F+PL
quartadazinha	quartado+A+DIM+F+SG
quartadazinhas	quartado+A+DIM+F+PL
quartadinha	quartado+A+DIM+F+SG
quartadinhas	quartado+A+DIM+F+PL
quartadinho	quartado+A+DIM+M+SG
quartadinhos	quartado+A+DIM+M+PL
quartado	quartado+A+M+SG
quartados	quartado+A+M+PL
quartadozinho	quartado+A+DIM+M+SG
quartadozinhos	quartado+A+DIM+M+PL
quartaluda	quartaludo+A+F+SG
quartaludas	quartaludo+A+F+PL
quartaludazinha	quartaludo+A+DIM+F+SG
quartaludazinhas	quartaludo+A+DIM+F+PL
quartaludinha	quartaludo+A+DIM+F+SG
quartaludinhas	quartaludo+A+DIM+F+PL
quartaludinho	quartaludo+A+DIM+M+SG
quartaludinhos	quartaludo+A+DIM+M+PL
quartaludo	quartaludo+A+M+SG
quartaludos	quartaludo+A+M+PL
quartaludozinho	quartaludo+A+DIM+M+SG
quartaludozinhos	quartaludo+A+DIM+M+PL
quartanista	quartanista+A+SG
quartanistas	quartanista+A+PL
quartanistazinha	quartanista+A+DIM+F+SG
quartanistazinhas	quartanista+A+DIM+F+PL
quartanistazinho	quartanista+A+DIM+M+SG
quartanistazinhos	quartanista+A+DIM+M+PL
quartanistinha	quartanista+A+DIM+SG
quartanistinhas	quartanista+A+DIM+PL
quartanariazinha	quartanário+A+DIM+F+SG
quartanariazinhas	quartanário+A+DIM+F+PL
quartanarinha	quartanário+A+DIM+F+SG
quartanarinhas	quartanário+A+DIM+F+PL
quartanarinho	quartanário+A+DIM+M+SG
quartanarinhos	quartanário+A+DIM+M+PL
quartanariozinho	quartanário+A+DIM+M+SG
quartanariozinhos	quartanário+A+DIM+M+PL
quartanária	quartanário+A+F+SG
quartanárias	quartanário+A+F+PL
quartanário	quartanário+A+M+SG
quartanários	quartanário+A+M+PL
quartapisaveizinhas	quartapisável+A+DIM+F+PL
quartapisaveizinhos	quartapisável+A+DIM+M+PL
quartapisavelzinha	quartapisável+A+DIM+F+SG
quartapisavelzinho	quartapisável+A+DIM+M+SG
quartapisáveis	quartapisável+A+PL
quartapisável	quartapisável+A+SG
quarteada	quarteado+A+F+SG
quarteadas	quarteado+A+F+PL
quarteadazinha	quarteado+A+DIM+F+SG
quarteadazinhas	quarteado+A+DIM+F+PL
quarteadinha	quarteado+A+DIM+F+SG
quarteadinhas	quarteado+A+DIM+F+PL
quarteadinho	quarteado+A+DIM+M+SG
quarteadinhos	quarteado+A+DIM+M+PL
quarteado	quarteado+A+M+SG
quarteados	quarteado+A+M+PL
quarteadozinho	quarteado+A+DIM+M+SG
quarteadozinhos	quarteado+A+DIM+M+PL
quartejaveizinhas	quartejável+A+DIM+F+PL
quartejaveizinhos	quartejável+A+DIM+M+PL
quartejavelzinha	quartejável+A+DIM+F+SG
quartejavelzinho	quartejável+A+DIM+M+SG
quartejáveis	quartejável+A+PL
quartejável	quartejável+A+SG
quarteaveizinhas	quarteável+A+DIM+F+PL
quarteaveizinhos	quarteável+A+DIM+M+PL
quarteavelzinha	quarteável+A+DIM+F+SG
quarteavelzinho	quarteável+A+DIM+M+SG
quarteáveis	quarteável+A+PL
quarteável	quarteável+A+SG
quartilhaveizinhas	quartilhável+A+DIM+F+PL
quartilhaveizinhos	quartilhável+A+DIM+M+PL
quartilhavelzinha	quartilhável+A+DIM+F+SG
quartilhavelzinho	quartilhável+A+DIM+M+SG
quartilháveis	quartilhável+A+PL
quartilhável	quartilhável+A+SG
quarto-finalista	quarto-finalista+A+SG
quarto-finalistas	quarto-finalista+A+PL
quarto-finalistazinha	quarto-finalista+A+DIM+F+SG
quarto-finalistazinhas	quarto-finalista+A+DIM+F+PL
quarto-finalistazinho	quarto-finalista+A+DIM+M+SG
quarto-finalistazinhos	quarto-finalista+A+DIM+M+PL
quarto-finalistinha	quarto-finalista+A+DIM+SG
quarto-finalistinhas	quarto-finalista+A+DIM+PL
quartzosa	quartzoso+A+F+SG
quartzosas	quartzoso+A+F+PL
quartzosazinha	quartzoso+A+DIM+F+SG
quartzosazinhas	quartzoso+A+DIM+F+PL
quartzosinha	quartzoso+A+DIM+F+SG
quartzosinhas	quartzoso+A+DIM+F+PL
quartzosinho	quartzoso+A+DIM+M+SG
quartzosinhos	quartzoso+A+DIM+M+PL
quartzoso	quartzoso+A+M+SG
quartzosos	quartzoso+A+M+PL
quartzosozinho	quartzoso+A+DIM+M+SG
quartzosozinhos	quartzoso+A+DIM+M+PL
quartziferazinha	quartzífero+A+DIM+F+SG
quartziferazinhas	quartzífero+A+DIM+F+PL
quartziferinha	quartzífero+A+DIM+F+SG
quartziferinhas	quartzífero+A+DIM+F+PL
quartziferinho	quartzífero+A+DIM+M+SG
quartziferinhos	quartzífero+A+DIM+M+PL
quartziferozinho	quartzífero+A+DIM+M+SG
quartziferozinhos	quartzífero+A+DIM+M+PL
quartzífera	quartzífero+A+F+SG
quartzíferas	quartzífero+A+F+PL
quartzífero	quartzífero+A+M+SG
quartzíferos	quartzífero+A+M+PL
quartaveizinhas	quartável+A+DIM+F+PL
quartaveizinhos	quartável+A+DIM+M+PL
quartavelzinha	quartável+A+DIM+F+SG
quartavelzinho	quartável+A+DIM+M+SG
quartáveis	quartável+A+PL
quartável	quartável+A+SG
quartã	quartã+A+F+SG
quartãs	quartã+A+F+PL
quartãzinha	quartã+A+DIM+F+SG
quartãzinhas	quartã+A+DIM+F+PL
quaraveizinhas	quarável+A+DIM+F+PL
quaraveizinhos	quarável+A+DIM+M+PL
quaravelzinha	quarável+A+DIM+F+SG
quaravelzinho	quarável+A+DIM+M+SG
quaráveis	quarável+A+PL
quarável	quarável+A+SG
quase-estelar	quase-estelar+A+SG
quase-estelares	quase-estelar+A+PL
quase-estelarezinhas	quase-estelar+A+DIM+F+PL
quase-estelarezinhos	quase-estelar+A+DIM+M+PL
quase-estelarzinha	quase-estelar+A+DIM+F+SG
quase-estelarzinhas	quase-estelar+A+DIM+F+PL
quase-estelarzinho	quase-estelar+A+DIM+M+SG
quase-estelarzinhos	quase-estelar+A+DIM+M+PL
quaternada	quaternado+A+F+SG
quaternadas	quaternado+A+F+PL
quaternadazinha	quaternado+A+DIM+F+SG
quaternadazinhas	quaternado+A+DIM+F+PL
quaternadinha	quaternado+A+DIM+F+SG
quaternadinhas	quaternado+A+DIM+F+PL
quaternadinho	quaternado+A+DIM+M+SG
quaternadinhos	quaternado+A+DIM+M+PL
quaternado	quaternado+A+M+SG
quaternados	quaternado+A+M+PL
quaternadozinho	quaternado+A+DIM+M+SG
quaternadozinhos	quaternado+A+DIM+M+PL
quaterna	quaterno+A+F+SG
quaternas	quaterno+A+F+PL
quaternazinha	quaterno+A+DIM+F+SG
quaternazinhas	quaterno+A+DIM+F+PL
quaterninha	quaterno+A+DIM+F+SG
quaterninhas	quaterno+A+DIM+F+PL
quaterninho	quaterno+A+DIM+M+SG
quaterninhos	quaterno+A+DIM+M+PL
quaterno	quaterno+A+M+SG
quaternos	quaterno+A+M+PL
quaternozinho	quaterno+A+DIM+M+SG
quaternozinhos	quaterno+A+DIM+M+PL
quaternariazinha	quaternário+A+DIM+F+SG
quaternariazinhas	quaternário+A+DIM+F+PL
quaternarinha	quaternário+A+DIM+F+SG
quaternarinhas	quaternário+A+DIM+F+PL
quaternarinho	quaternário+A+DIM+M+SG
quaternarinhos	quaternário+A+DIM+M+PL
quaternariozinho	quaternário+A+DIM+M+SG
quaternariozinhos	quaternário+A+DIM+M+PL
quaternária	quaternário+A+F+SG
quaternárias	quaternário+A+F+PL
quaternário	quaternário+A+M+SG
quaternários	quaternário+A+M+PL
quatriduana	quatriduano+A+F+SG
quatriduanas	quatriduano+A+F+PL
quatriduanazinha	quatriduano+A+DIM+F+SG
quatriduanazinhas	quatriduano+A+DIM+F+PL
quatriduaninha	quatriduano+A+DIM+F+SG
quatriduaninhas	quatriduano+A+DIM+F+PL
quatriduaninho	quatriduano+A+DIM+M+SG
quatriduaninhos	quatriduano+A+DIM+M+PL
quatriduano	quatriduano+A+M+SG
quatriduanos	quatriduano+A+M+PL
quatriduanozinho	quatriduano+A+DIM+M+SG
quatriduanozinhos	quatriduano+A+DIM+M+PL
quatrienais	quatrienal+A+PL
quatrienaizinhas	quatrienal+A+DIM+F+PL
quatrienaizinhos	quatrienal+A+DIM+M+PL
quatrienal	quatrienal+A+SG
quatrienalzinha	quatrienal+A+DIM+F+SG
quatrienalzinho	quatrienal+A+DIM+M+SG
quatrocentista	quatrocentista+A+SG
quatrocentistas	quatrocentista+A+PL
quatrocentistazinha	quatrocentista+A+DIM+F+SG
quatrocentistazinhas	quatrocentista+A+DIM+F+PL
quatrocentistazinho	quatrocentista+A+DIM+M+SG
quatrocentistazinhos	quatrocentista+A+DIM+M+PL
quatrocentistinha	quatrocentista+A+DIM+SG
quatrocentistinhas	quatrocentista+A+DIM+PL
quatrolha	quatrolho+A+F+SG
quatrolhas	quatrolho+A+F+PL
quatrolhazinha	quatrolho+A+DIM+F+SG
quatrolhazinhas	quatrolho+A+DIM+F+PL
quatrolhinha	quatrolho+A+DIM+F+SG
quatrolhinhas	quatrolho+A+DIM+F+PL
quatrolhinho	quatrolho+A+DIM+M+SG
quatrolhinhos	quatrolho+A+DIM+M+PL
quatrolho	quatrolho+A+M+SG
quatrolhos	quatrolho+A+M+PL
quatrolhozinho	quatrolho+A+DIM+M+SG
quatrolhozinhos	quatrolho+A+DIM+M+PL
queba	queba+A+SG
quebas	queba+A+PL
quebazinha	queba+A+DIM+F+SG
quebazinhas	queba+A+DIM+F+PL
quebazinho	queba+A+DIM+M+SG
quebazinhos	queba+A+DIM+M+PL
quebinha	queba+A+DIM+SG
quebinhas	queba+A+DIM+PL
quebequense	quebequense+A+SG
quebequenses	quebequense+A+PL
quebequensezinha	quebequense+A+DIM+F+SG
quebequensezinhas	quebequense+A+DIM+F+PL
quebequensezinho	quebequense+A+DIM+M+SG
quebequensezinhos	quebequense+A+DIM+M+PL
quebequensinha	quebequense+A+DIM+F+SG
quebequensinhas	quebequense+A+DIM+F+PL
quebequensinho	quebequense+A+DIM+M+SG
quebequensinhos	quebequense+A+DIM+M+PL
quebra	quebra+A+SG
quebras	quebra+A+PL
quebrazinha	quebra+A+DIM+F+SG
quebrazinhas	quebra+A+DIM+F+PL
quebrazinho	quebra+A+DIM+M+SG
quebrazinhos	quebra+A+DIM+M+PL
quebrinha	quebra+A+DIM+SG
quebrinhas	quebra+A+DIM+PL
quebra-queixinho	quebra-queixo+A+DIM+SG
quebra-queixinhos	quebra-queixo+A+DIM+PL
quebra-queixo	quebra-queixo+A+SG
quebra-queixos	quebra-queixo+A+PL
quebra-queixozinha	quebra-queixo+A+DIM+F+SG
quebra-queixozinhas	quebra-queixo+A+DIM+F+PL
quebra-queixozinho	quebra-queixo+A+DIM+M+SG
quebra-queixozinhos	quebra-queixo+A+DIM+M+PL
quebradicinha	quebradiço+A+DIM+F+SG
quebradicinhas	quebradiço+A+DIM+F+PL
quebradicinho	quebradiço+A+DIM+M+SG
quebradicinhos	quebradiço+A+DIM+M+PL
quebradiça	quebradiço+A+F+SG
quebradiças	quebradiço+A+F+PL
quebradiçazinha	quebradiço+A+DIM+F+SG
quebradiçazinhas	quebradiço+A+DIM+F+PL
quebradiço	quebradiço+A+M+SG
quebradiços	quebradiço+A+M+PL
quebradiçozinho	quebradiço+A+DIM+M+SG
quebradiçozinhos	quebradiço+A+DIM+M+PL
quebrada	quebrado+A+F+SG
quebradas	quebrado+A+F+PL
quebradazinha	quebrado+A+DIM+F+SG
quebradazinhas	quebrado+A+DIM+F+PL
quebradazita	quebrado+A+DIM+F+SG
quebradazitas	quebrado+A+DIM+F+PL
quebradinha	quebrado+A+DIM+F+SG
quebradinhas	quebrado+A+DIM+F+PL
quebradinho	quebrado+A+DIM+M+SG
quebradinhos	quebrado+A+DIM+M+PL
quebradita	quebrado+A+DIM+F+SG
quebraditas	quebrado+A+DIM+F+PL
quebradito	quebrado+A+DIM+M+SG
quebraditos	quebrado+A+DIM+M+PL
quebrado	quebrado+A+M+SG
quebrados	quebrado+A+M+PL
quebradozinho	quebrado+A+DIM+M+SG
quebradozinhos	quebrado+A+DIM+M+PL
quebradozito	quebrado+A+DIM+M+SG
quebradozitos	quebrado+A+DIM+M+PL
quebradíssima	quebrado+A+SUPER+F+SG
quebradíssimas	quebrado+A+SUPER+F+PL
quebradíssimo	quebrado+A+SUPER+M+SG
quebradíssimos	quebrado+A+SUPER+M+PL
quebrador	quebrador+A+M+SG
quebradora	quebrador+A+F+SG
quebradoras	quebrador+A+F+PL
quebradorazinha	quebrador+A+DIM+F+SG
quebradorazinhas	quebrador+A+DIM+F+PL
quebradores	quebrador+A+M+PL
quebradorezinhos	quebrador+A+DIM+M+PL
quebradorinha	quebrador+A+DIM+F+SG
quebradorinhas	quebrador+A+DIM+F+PL
quebradorzinho	quebrador+A+DIM+M+SG
quebradorzinhos	quebrador+A+DIM+M+PL
quebrantada	quebrantado+A+F+SG
quebrantadas	quebrantado+A+F+PL
quebrantadazinha	quebrantado+A+DIM+F+SG
quebrantadazinhas	quebrantado+A+DIM+F+PL
quebrantadazita	quebrantado+A+DIM+F+SG
quebrantadazitas	quebrantado+A+DIM+F+PL
quebrantadinha	quebrantado+A+DIM+F+SG
quebrantadinhas	quebrantado+A+DIM+F+PL
quebrantadinho	quebrantado+A+DIM+M+SG
quebrantadinhos	quebrantado+A+DIM+M+PL
quebrantadita	quebrantado+A+DIM+F+SG
quebrantaditas	quebrantado+A+DIM+F+PL
quebrantadito	quebrantado+A+DIM+M+SG
quebrantaditos	quebrantado+A+DIM+M+PL
quebrantado	quebrantado+A+M+SG
quebrantados	quebrantado+A+M+PL
quebrantadozinho	quebrantado+A+DIM+M+SG
quebrantadozinhos	quebrantado+A+DIM+M+PL
quebrantadozito	quebrantado+A+DIM+M+SG
quebrantadozitos	quebrantado+A+DIM+M+PL
quebrantadíssima	quebrantado+A+SUPER+F+SG
quebrantadíssimas	quebrantado+A+SUPER+F+PL
quebrantadíssimo	quebrantado+A+SUPER+M+SG
quebrantadíssimos	quebrantado+A+SUPER+M+PL
quebrantador	quebrantador+A+M+SG
quebrantadora	quebrantador+A+F+SG
quebrantadoras	quebrantador+A+F+PL
quebrantadorazinha	quebrantador+A+DIM+F+SG
quebrantadorazinhas	quebrantador+A+DIM+F+PL
quebrantadores	quebrantador+A+M+PL
quebrantadorezinhos	quebrantador+A+DIM+M+PL
quebrantadorinha	quebrantador+A+DIM+F+SG
quebrantadorinhas	quebrantador+A+DIM+F+PL
quebrantadorzinho	quebrantador+A+DIM+M+SG
quebrantadorzinhos	quebrantador+A+DIM+M+PL
quebrantaveizinhas	quebrantável+A+DIM+F+PL
quebrantaveizinhos	quebrantável+A+DIM+M+PL
quebrantavelzinha	quebrantável+A+DIM+F+SG
quebrantavelzinho	quebrantável+A+DIM+M+SG
quebrantáveis	quebrantável+A+PL
quebrantável	quebrantável+A+SG
quebraveizinhas	quebrável+A+DIM+F+PL
quebraveizinhos	quebrável+A+DIM+M+PL
quebravelzinha	quebrável+A+DIM+F+SG
quebravelzinho	quebrável+A+DIM+M+SG
quebráveis	quebrável+A+PL
quebrável	quebrável+A+SG
queda	quedo+A+F+SG
quedas	quedo+A+F+PL
quedazinha	quedo+A+DIM+F+SG
quedazinhas	quedo+A+DIM+F+PL
quedinha	quedo+A+DIM+F+SG
quedinhas	quedo+A+DIM+F+PL
quedinho	quedo+A+DIM+M+SG
quedinhos	quedo+A+DIM+M+PL
quedo	quedo+A+M+SG
quedos	quedo+A+M+PL
quedozinho	quedo+A+DIM+M+SG
quedozinhos	quedo+A+DIM+M+PL
quedaveizinhas	quedável+A+DIM+F+PL
quedaveizinhos	quedável+A+DIM+M+PL
quedavelzinha	quedável+A+DIM+F+SG
quedavelzinho	quedável+A+DIM+M+SG
quedáveis	quedável+A+PL
quedável	quedável+A+SG
queijadeira	queijadeiro+A+F+SG
queijadeiras	queijadeiro+A+F+PL
queijadeirazinha	queijadeiro+A+DIM+F+SG
queijadeirazinhas	queijadeiro+A+DIM+F+PL
queijadeirinha	queijadeiro+A+DIM+F+SG
queijadeirinhas	queijadeiro+A+DIM+F+PL
queijadeirinho	queijadeiro+A+DIM+M+SG
queijadeirinhos	queijadeiro+A+DIM+M+PL
queijadeiro	queijadeiro+A+M+SG
queijadeiros	queijadeiro+A+M+PL
queijadeirozinho	queijadeiro+A+DIM+M+SG
queijadeirozinhos	queijadeiro+A+DIM+M+PL
queijaveizinhas	queijável+A+DIM+F+PL
queijaveizinhos	queijável+A+DIM+M+PL
queijavelzinha	queijável+A+DIM+F+SG
queijavelzinho	queijável+A+DIM+M+SG
queijáveis	queijável+A+PL
queijável	queijável+A+SG
queimada	queimado+A+F+SG
queimadas	queimado+A+F+PL
queimadazinha	queimado+A+DIM+F+SG
queimadazinhas	queimado+A+DIM+F+PL
queimadazita	queimado+A+DIM+F+SG
queimadazitas	queimado+A+DIM+F+PL
queimadinha	queimado+A+DIM+F+SG
queimadinhas	queimado+A+DIM+F+PL
queimadinho	queimado+A+DIM+M+SG
queimadinhos	queimado+A+DIM+M+PL
queimadita	queimado+A+DIM+F+SG
queimaditas	queimado+A+DIM+F+PL
queimadito	queimado+A+DIM+M+SG
queimaditos	queimado+A+DIM+M+PL
queimado	queimado+A+M+SG
queimados	queimado+A+M+PL
queimadozinho	queimado+A+DIM+M+SG
queimadozinhos	queimado+A+DIM+M+PL
queimadozito	queimado+A+DIM+M+SG
queimadozitos	queimado+A+DIM+M+PL
queimadíssima	queimado+A+SUPER+F+SG
queimadíssimas	queimado+A+SUPER+F+PL
queimadíssimo	queimado+A+SUPER+M+SG
queimadíssimos	queimado+A+SUPER+M+PL
queimador	queimador+A+M+SG
queimadora	queimador+A+F+SG
queimadoras	queimador+A+F+PL
queimadorazinha	queimador+A+DIM+F+SG
queimadorazinhas	queimador+A+DIM+F+PL
queimadores	queimador+A+M+PL
queimadorezinhos	queimador+A+DIM+M+PL
queimadorinha	queimador+A+DIM+F+SG
queimadorinhas	queimador+A+DIM+F+PL
queimadorzinho	queimador+A+DIM+M+SG
queimadorzinhos	queimador+A+DIM+M+PL
queimadote	queimadote+A+SG
queimadotes	queimadote+A+PL
queimadotezinha	queimadote+A+DIM+F+SG
queimadotezinhas	queimadote+A+DIM+F+PL
queimadotezinho	queimadote+A+DIM+M+SG
queimadotezinhos	queimadote+A+DIM+M+PL
queimadotinha	queimadote+A+DIM+F+SG
queimadotinhas	queimadote+A+DIM+F+PL
queimadotinho	queimadote+A+DIM+M+SG
queimadotinhos	queimadote+A+DIM+M+PL
queimante	queimante+A+SG
queimantes	queimante+A+PL
queimantezinha	queimante+A+DIM+F+SG
queimantezinhas	queimante+A+DIM+F+PL
queimantezinho	queimante+A+DIM+M+SG
queimantezinhos	queimante+A+DIM+M+PL
queimantinha	queimante+A+DIM+F+SG
queimantinhas	queimante+A+DIM+F+PL
queimantinho	queimante+A+DIM+M+SG
queimantinhos	queimante+A+DIM+M+PL
queimosa	queimoso+A+F+SG
queimosas	queimoso+A+F+PL
queimosazinha	queimoso+A+DIM+F+SG
queimosazinhas	queimoso+A+DIM+F+PL
queimosinha	queimoso+A+DIM+F+SG
queimosinhas	queimoso+A+DIM+F+PL
queimosinho	queimoso+A+DIM+M+SG
queimosinhos	queimoso+A+DIM+M+PL
queimoso	queimoso+A+M+SG
queimosos	queimoso+A+M+PL
queimosozinho	queimoso+A+DIM+M+SG
queimosozinhos	queimoso+A+DIM+M+PL
queimaveizinhas	queimável+A+DIM+F+PL
queimaveizinhos	queimável+A+DIM+M+PL
queimavelzinha	queimável+A+DIM+F+SG
queimavelzinho	queimável+A+DIM+M+SG
queimáveis	queimável+A+PL
queimável	queimável+A+SG
queimão	queimão+A+M+SG
queimãozinho	queimão+A+DIM+M+SG
queimões	queimão+A+M+PL
queimõezinhos	queimão+A+DIM+M+PL
queira	queiro+A+F+SG
queiras	queiro+A+F+PL
queirazinha	queiro+A+DIM+F+SG
queirazinhas	queiro+A+DIM+F+PL
queirinha	queiro+A+DIM+F+SG
queirinhas	queiro+A+DIM+F+PL
queirinho	queiro+A+DIM+M+SG
queirinhos	queiro+A+DIM+M+PL
queiro	queiro+A+M+SG
queiros	queiro+A+M+PL
queirozinho	queiro+A+DIM+M+SG
queirozinhos	queiro+A+DIM+M+PL
queirosiana	queirosiano+A+F+SG
queirosianas	queirosiano+A+F+PL
queirosianazinha	queirosiano+A+DIM+F+SG
queirosianazinhas	queirosiano+A+DIM+F+PL
queirosianinha	queirosiano+A+DIM+F+SG
queirosianinhas	queirosiano+A+DIM+F+PL
queirosianinho	queirosiano+A+DIM+M+SG
queirosianinhos	queirosiano+A+DIM+M+PL
queirosiano	queirosiano+A+M+SG
queirosianos	queirosiano+A+M+PL
queirosianozinho	queirosiano+A+DIM+M+SG
queirosianozinhos	queirosiano+A+DIM+M+PL
queirostrobaceazinha	queirostrobáceo+A+DIM+F+SG
queirostrobaceazinhas	queirostrobáceo+A+DIM+F+PL
queirostrobaceinha	queirostrobáceo+A+DIM+F+SG
queirostrobaceinhas	queirostrobáceo+A+DIM+F+PL
queirostrobaceinho	queirostrobáceo+A+DIM+M+SG
queirostrobaceinhos	queirostrobáceo+A+DIM+M+PL
queirostrobaceozinho	queirostrobáceo+A+DIM+M+SG
queirostrobaceozinhos	queirostrobáceo+A+DIM+M+PL
queirostrobácea	queirostrobáceo+A+F+SG
queirostrobáceas	queirostrobáceo+A+F+PL
queirostrobáceo	queirostrobáceo+A+M+SG
queirostrobáceos	queirostrobáceo+A+M+PL
queixais	queixal+A+PL
queixaizinhas	queixal+A+DIM+F+PL
queixaizinhos	queixal+A+DIM+M+PL
queixal	queixal+A+SG
queixalzinha	queixal+A+DIM+F+SG
queixalzinho	queixal+A+DIM+M+SG
queixeira	queixeiro+A+F+SG
queixeiras	queixeiro+A+F+PL
queixeirazinha	queixeiro+A+DIM+F+SG
queixeirazinhas	queixeiro+A+DIM+F+PL
queixeirinha	queixeiro+A+DIM+F+SG
queixeirinhas	queixeiro+A+DIM+F+PL
queixeirinho	queixeiro+A+DIM+M+SG
queixeirinhos	queixeiro+A+DIM+M+PL
queixeiro	queixeiro+A+M+SG
queixeiros	queixeiro+A+M+PL
queixeirozinho	queixeiro+A+DIM+M+SG
queixeirozinhos	queixeiro+A+DIM+M+PL
queixinhas	queixinhas+A
queixinhasinha	queixinhas+A+DIM+F+SG
queixinhasinhas	queixinhas+A+DIM+F+PL
queixinhasinho	queixinhas+A+DIM+M+SG
queixinhasinhos	queixinhas+A+DIM+M+PL
queixosa	queixoso+A+F+SG
queixosas	queixoso+A+F+PL
queixosazinha	queixoso+A+DIM+F+SG
queixosazinhas	queixoso+A+DIM+F+PL
queixosinha	queixoso+A+DIM+F+SG
queixosinhas	queixoso+A+DIM+F+PL
queixosinho	queixoso+A+DIM+M+SG
queixosinhos	queixoso+A+DIM+M+PL
queixoso	queixoso+A+M+SG
queixosos	queixoso+A+M+PL
queixosozinho	queixoso+A+DIM+M+SG
queixosozinhos	queixoso+A+DIM+M+PL
queixuda	queixudo+A+F+SG
queixudas	queixudo+A+F+PL
queixudazinha	queixudo+A+DIM+F+SG
queixudazinhas	queixudo+A+DIM+F+PL
queixudinha	queixudo+A+DIM+F+SG
queixudinhas	queixudo+A+DIM+F+PL
queixudinho	queixudo+A+DIM+M+SG
queixudinhos	queixudo+A+DIM+M+PL
queixudo	queixudo+A+M+SG
queixudos	queixudo+A+M+PL
queixudozinho	queixudo+A+DIM+M+SG
queixudozinhos	queixudo+A+DIM+M+PL
queixumeira	queixumeiro+A+F+SG
queixumeiras	queixumeiro+A+F+PL
queixumeirazinha	queixumeiro+A+DIM+F+SG
queixumeirazinhas	queixumeiro+A+DIM+F+PL
queixumeirinha	queixumeiro+A+DIM+F+SG
queixumeirinhas	queixumeiro+A+DIM+F+PL
queixumeirinho	queixumeiro+A+DIM+M+SG
queixumeirinhos	queixumeiro+A+DIM+M+PL
queixumeiro	queixumeiro+A+M+SG
queixumeiros	queixumeiro+A+M+PL
queixumeirozinho	queixumeiro+A+DIM+M+SG
queixumeirozinhos	queixumeiro+A+DIM+M+PL
queixaveizinhas	queixável+A+DIM+F+PL
queixaveizinhos	queixável+A+DIM+M+PL
queixavelzinha	queixável+A+DIM+F+SG
queixavelzinho	queixável+A+DIM+M+SG
queixáveis	queixável+A+PL
queixável	queixável+A+SG
quejanda	quejando+A+F+SG
quejandas	quejando+A+F+PL
quejandazinha	quejando+A+DIM+F+SG
quejandazinhas	quejando+A+DIM+F+PL
quejandinha	quejando+A+DIM+F+SG
quejandinhas	quejando+A+DIM+F+PL
quejandinho	quejando+A+DIM+M+SG
quejandinhos	quejando+A+DIM+M+PL
quejando	quejando+A+M+SG
quejandos	quejando+A+M+PL
quejandozinho	quejando+A+DIM+M+SG
quejandozinhos	quejando+A+DIM+M+PL
quelicerada	quelicerado+A+F+SG
queliceradas	quelicerado+A+F+PL
queliceradazinha	quelicerado+A+DIM+F+SG
queliceradazinhas	quelicerado+A+DIM+F+PL
queliceradinha	quelicerado+A+DIM+F+SG
queliceradinhas	quelicerado+A+DIM+F+PL
queliceradinho	quelicerado+A+DIM+M+SG
queliceradinhos	quelicerado+A+DIM+M+PL
quelicerado	quelicerado+A+M+SG
quelicerados	quelicerado+A+M+PL
queliceradozinho	quelicerado+A+DIM+M+SG
queliceradozinhos	quelicerado+A+DIM+M+PL
quelidonicazinha	quelidónico+A+DIM+F+SG
quelidonicazinhas	quelidónico+A+DIM+F+PL
quelidonicozinho	quelidónico+A+DIM+M+SG
quelidonicozinhos	quelidónico+A+DIM+M+PL
quelidoniquinha	quelidónico+A+DIM+F+SG
quelidoniquinhas	quelidónico+A+DIM+F+PL
quelidoniquinho	quelidónico+A+DIM+M+SG
quelidoniquinhos	quelidónico+A+DIM+M+PL
quelidónica	quelidónico+A+F+SG
quelidónicas	quelidónico+A+F+PL
quelidónico	quelidónico+A+M+SG
quelidónicos	quelidónico+A+M+PL
quelidonicazinha	quelidônico+A+DIM+F+SG
quelidonicazinhas	quelidônico+A+DIM+F+PL
quelidonicozinho	quelidônico+A+DIM+M+SG
quelidonicozinhos	quelidônico+A+DIM+M+PL
quelidoniquinha	quelidônico+A+DIM+F+SG
quelidoniquinhas	quelidônico+A+DIM+F+PL
quelidoniquinho	quelidônico+A+DIM+M+SG
quelidoniquinhos	quelidônico+A+DIM+M+PL
quelidônica	quelidônico+A+F+SG
quelidônicas	quelidônico+A+F+PL
quelidônico	quelidônico+A+M+SG
quelidônicos	quelidônico+A+M+PL
quelimane	quelimane+A+SG
quelimanes	quelimane+A+PL
quelimanezinha	quelimane+A+DIM+F+SG
quelimanezinhas	quelimane+A+DIM+F+PL
quelimanezinho	quelimane+A+DIM+M+SG
quelimanezinhos	quelimane+A+DIM+M+PL
quelimaninha	quelimane+A+DIM+F+SG
quelimaninhas	quelimane+A+DIM+F+PL
quelimaninho	quelimane+A+DIM+M+SG
quelimaninhos	quelimane+A+DIM+M+PL
quelonofagazinha	quelonófago+A+DIM+F+SG
quelonofagazinhas	quelonófago+A+DIM+F+PL
quelonofagozinho	quelonófago+A+DIM+M+SG
quelonofagozinhos	quelonófago+A+DIM+M+PL
quelonofaguinha	quelonófago+A+DIM+F+SG
quelonofaguinhas	quelonófago+A+DIM+F+PL
quelonofaguinho	quelonófago+A+DIM+M+SG
quelonofaguinhos	quelonófago+A+DIM+M+PL
quelonófaga	quelonófago+A+F+SG
quelonófagas	quelonófago+A+F+PL
quelonófago	quelonófago+A+M+SG
quelonófagos	quelonófago+A+M+PL
queloniazinha	quelônio+A+DIM+F+SG
queloniazinhas	quelônio+A+DIM+F+PL
queloninha	quelônio+A+DIM+F+SG
queloninhas	quelônio+A+DIM+F+PL
queloninho	quelônio+A+DIM+M+SG
queloninhos	quelônio+A+DIM+M+PL
queloniozinho	quelônio+A+DIM+M+SG
queloniozinhos	quelônio+A+DIM+M+PL
quelônia	quelônio+A+F+SG
quelônias	quelônio+A+F+PL
quelônio	quelônio+A+M+SG
quelônios	quelônio+A+M+PL
queniana	queniano+A+F+SG
quenianas	queniano+A+F+PL
quenianazinha	queniano+A+DIM+F+SG
quenianazinhas	queniano+A+DIM+F+PL
quenianinha	queniano+A+DIM+F+SG
quenianinhas	queniano+A+DIM+F+PL
quenianinho	queniano+A+DIM+M+SG
quenianinhos	queniano+A+DIM+M+PL
queniano	queniano+A+M+SG
quenianos	queniano+A+M+PL
quenianozinho	queniano+A+DIM+M+SG
quenianozinhos	queniano+A+DIM+M+PL
quenopodiaceazinha	quenopodiáceo+A+DIM+F+SG
quenopodiaceazinhas	quenopodiáceo+A+DIM+F+PL
quenopodiaceinha	quenopodiáceo+A+DIM+F+SG
quenopodiaceinhas	quenopodiáceo+A+DIM+F+PL
quenopodiaceinho	quenopodiáceo+A+DIM+M+SG
quenopodiaceinhos	quenopodiáceo+A+DIM+M+PL
quenopodiaceozinho	quenopodiáceo+A+DIM+M+SG
quenopodiaceozinhos	quenopodiáceo+A+DIM+M+PL
quenopodiácea	quenopodiáceo+A+F+SG
quenopodiáceas	quenopodiáceo+A+F+PL
quenopodiáceo	quenopodiáceo+A+M+SG
quenopodiáceos	quenopodiáceo+A+M+PL
quente	quente+A+SG
quentes	quente+A+PL
quentezinha	quente+A+DIM+F+SG
quentezinhas	quente+A+DIM+F+PL
quentezinho	quente+A+DIM+M+SG
quentezinhos	quente+A+DIM+M+PL
quentezita	quente+A+DIM+F+SG
quentezitas	quente+A+DIM+F+PL
quentezito	quente+A+DIM+M+SG
quentezitos	quente+A+DIM+M+PL
quentinha	quente+A+DIM+F+SG
quentinhas	quente+A+DIM+F+PL
quentinho	quente+A+DIM+M+SG
quentinhos	quente+A+DIM+M+PL
quentita	quente+A+DIM+F+SG
quentitas	quente+A+DIM+F+PL
quentito	quente+A+DIM+M+SG
quentitos	quente+A+DIM+M+PL
quentíssima	quente+A+SUPER+F+SG
quentíssimas	quente+A+SUPER+F+PL
quentíssimo	quente+A+SUPER+M+SG
quentíssimos	quente+A+SUPER+M+PL
quentaveizinhas	quentável+A+DIM+F+PL
quentaveizinhos	quentável+A+DIM+M+PL
quentavelzinha	quentável+A+DIM+F+SG
quentavelzinho	quentável+A+DIM+M+SG
quentáveis	quentável+A+PL
quentável	quentável+A+SG
queque	queque+A+SG
queques	queque+A+PL
quequezinha	queque+A+DIM+F+SG
quequezinhas	queque+A+DIM+F+PL
quequezinho	queque+A+DIM+M+SG
quequezinhos	queque+A+DIM+M+PL
quequezita	queque+A+DIM+F+SG
quequezitas	queque+A+DIM+F+PL
quequezito	queque+A+DIM+M+SG
quequezitos	queque+A+DIM+M+PL
quequinha	queque+A+DIM+F+SG
quequinhas	queque+A+DIM+F+PL
quequinho	queque+A+DIM+M+SG
quequinhos	queque+A+DIM+M+PL
quequita	queque+A+DIM+F+SG
quequitas	queque+A+DIM+F+PL
quequito	queque+A+DIM+M+SG
quequitos	queque+A+DIM+M+PL
quequíssima	queque+A+SUPER+F+SG
quequíssimas	queque+A+SUPER+F+PL
quequíssimo	queque+A+SUPER+M+SG
quequíssimos	queque+A+SUPER+M+PL
quera	quera+A+SG
queras	quera+A+PL
querazinha	quera+A+DIM+F+SG
querazinhas	quera+A+DIM+F+PL
querazinho	quera+A+DIM+M+SG
querazinhos	quera+A+DIM+M+PL
querinha	quera+A+DIM+SG
querinhas	quera+A+DIM+PL
quercista	quercista+A+SG
quercistas	quercista+A+PL
quercistazinha	quercista+A+DIM+F+SG
quercistazinhas	quercista+A+DIM+F+PL
quercistazinho	quercista+A+DIM+M+SG
quercistazinhos	quercista+A+DIM+M+PL
quercistinha	quercista+A+DIM+SG
quercistinhas	quercista+A+DIM+PL
quercineazinha	quercíneo+A+DIM+F+SG
quercineazinhas	quercíneo+A+DIM+F+PL
quercineinha	quercíneo+A+DIM+F+SG
quercineinhas	quercíneo+A+DIM+F+PL
quercineinho	quercíneo+A+DIM+M+SG
quercineinhos	quercíneo+A+DIM+M+PL
quercineozinho	quercíneo+A+DIM+M+SG
quercineozinhos	quercíneo+A+DIM+M+PL
quercínea	quercíneo+A+F+SG
quercíneas	quercíneo+A+F+PL
quercíneo	quercíneo+A+M+SG
quercíneos	quercíneo+A+M+PL
querelador	querelador+A+M+SG
quereladora	querelador+A+F+SG
quereladoras	querelador+A+F+PL
quereladorazinha	querelador+A+DIM+F+SG
quereladorazinhas	querelador+A+DIM+F+PL
quereladores	querelador+A+M+PL
quereladorezinhos	querelador+A+DIM+M+PL
quereladorinha	querelador+A+DIM+F+SG
quereladorinhas	querelador+A+DIM+F+PL
quereladorzinho	querelador+A+DIM+M+SG
quereladorzinhos	querelador+A+DIM+M+PL
querelante	querelante+A+SG
querelantes	querelante+A+PL
querelantezinha	querelante+A+DIM+F+SG
querelantezinhas	querelante+A+DIM+F+PL
querelantezinho	querelante+A+DIM+M+SG
querelantezinhos	querelante+A+DIM+M+PL
querelantinha	querelante+A+DIM+F+SG
querelantinhas	querelante+A+DIM+F+PL
querelantinho	querelante+A+DIM+M+SG
querelantinhos	querelante+A+DIM+M+PL
querelosa	quereloso+A+F+SG
querelosas	quereloso+A+F+PL
querelosazinha	quereloso+A+DIM+F+SG
querelosazinhas	quereloso+A+DIM+F+PL
querelosinha	quereloso+A+DIM+F+SG
querelosinhas	quereloso+A+DIM+F+PL
querelosinho	quereloso+A+DIM+M+SG
querelosinhos	quereloso+A+DIM+M+PL
quereloso	quereloso+A+M+SG
querelosos	quereloso+A+M+PL
querelosozinho	quereloso+A+DIM+M+SG
querelosozinhos	quereloso+A+DIM+M+PL
querelaveizinhas	querelável+A+DIM+F+PL
querelaveizinhos	querelável+A+DIM+M+PL
querelavelzinha	querelável+A+DIM+F+SG
querelavelzinho	querelável+A+DIM+M+SG
quereláveis	querelável+A+PL
querelável	querelável+A+SG
queremista	queremista+A+SG
queremistas	queremista+A+PL
queremistazinha	queremista+A+DIM+F+SG
queremistazinhas	queremista+A+DIM+F+PL
queremistazinho	queremista+A+DIM+M+SG
queremistazinhos	queremista+A+DIM+M+PL
queremistinha	queremista+A+DIM+SG
queremistinhas	queremista+A+DIM+PL
querenciaveizinhas	querenciável+A+DIM+F+PL
querenciaveizinhos	querenciável+A+DIM+M+PL
querenciavelzinha	querenciável+A+DIM+F+SG
querenciavelzinho	querenciável+A+DIM+M+SG
querenciáveis	querenciável+A+PL
querenciável	querenciável+A+SG
querente	querente+A+SG
querentes	querente+A+PL
querentezinha	querente+A+DIM+F+SG
querentezinhas	querente+A+DIM+F+PL
querentezinho	querente+A+DIM+M+SG
querentezinhos	querente+A+DIM+M+PL
querentinha	querente+A+DIM+F+SG
querentinhas	querente+A+DIM+F+PL
querentinho	querente+A+DIM+M+SG
querentinhos	querente+A+DIM+M+PL
querenaveizinhas	querenável+A+DIM+F+PL
querenaveizinhos	querenável+A+DIM+M+PL
querenavelzinha	querenável+A+DIM+F+SG
querenavelzinho	querenável+A+DIM+M+SG
querenáveis	querenável+A+PL
querenável	querenável+A+SG
querençosa	querençoso+A+F+SG
querençosas	querençoso+A+F+PL
querençosazinha	querençoso+A+DIM+F+SG
querençosazinhas	querençoso+A+DIM+F+PL
querençosinha	querençoso+A+DIM+F+SG
querençosinhas	querençoso+A+DIM+F+PL
querençosinho	querençoso+A+DIM+M+SG
querençosinhos	querençoso+A+DIM+M+PL
querençoso	querençoso+A+M+SG
querençosos	querençoso+A+M+PL
querençosozinho	querençoso+A+DIM+M+SG
querençosozinhos	querençoso+A+DIM+M+PL
querida	querido+A+F+SG
queridas	querido+A+F+PL
queridazinha	querido+A+DIM+F+SG
queridazinhas	querido+A+DIM+F+PL
queridazita	querido+A+DIM+F+SG
queridazitas	querido+A+DIM+F+PL
queridinha	querido+A+DIM+F+SG
queridinhas	querido+A+DIM+F+PL
queridinho	querido+A+DIM+M+SG
queridinhos	querido+A+DIM+M+PL
queridita	querido+A+DIM+F+SG
queriditas	querido+A+DIM+F+PL
queridito	querido+A+DIM+M+SG
queriditos	querido+A+DIM+M+PL
querido	querido+A+M+SG
queridos	querido+A+M+PL
queridozinho	querido+A+DIM+M+SG
queridozinhos	querido+A+DIM+M+PL
queridozito	querido+A+DIM+M+SG
queridozitos	querido+A+DIM+M+PL
queridíssima	querido+A+SUPER+F+SG
queridíssimas	querido+A+SUPER+F+PL
queridíssimo	querido+A+SUPER+M+SG
queridíssimos	querido+A+SUPER+M+PL
querosenaveizinhas	querosenável+A+DIM+F+PL
querosenaveizinhos	querosenável+A+DIM+M+PL
querosenavelzinha	querosenável+A+DIM+F+SG
querosenavelzinho	querosenável+A+DIM+M+SG
querosenáveis	querosenável+A+PL
querosenável	querosenável+A+SG
querquerna	querquerno+A+F+SG
querquernas	querquerno+A+F+PL
querquernazinha	querquerno+A+DIM+F+SG
querquernazinhas	querquerno+A+DIM+F+PL
querquerninha	querquerno+A+DIM+F+SG
querquerninhas	querquerno+A+DIM+F+PL
querquerninho	querquerno+A+DIM+M+SG
querquerninhos	querquerno+A+DIM+M+PL
querquerno	querquerno+A+M+SG
querquernos	querquerno+A+M+PL
querquernozinho	querquerno+A+DIM+M+SG
querquernozinhos	querquerno+A+DIM+M+PL
querquetulana	querquetulano+A+F+SG
querquetulanas	querquetulano+A+F+PL
querquetulanazinha	querquetulano+A+DIM+F+SG
querquetulanazinhas	querquetulano+A+DIM+F+PL
querquetulaninha	querquetulano+A+DIM+F+SG
querquetulaninhas	querquetulano+A+DIM+F+PL
querquetulaninho	querquetulano+A+DIM+M+SG
querquetulaninhos	querquetulano+A+DIM+M+PL
querquetulano	querquetulano+A+M+SG
querquetulanos	querquetulano+A+M+PL
querquetulanozinho	querquetulano+A+DIM+M+SG
querquetulanozinhos	querquetulano+A+DIM+M+PL
querubinicazinha	querubínico+A+DIM+F+SG
querubinicazinhas	querubínico+A+DIM+F+PL
querubinicozinho	querubínico+A+DIM+M+SG
querubinicozinhos	querubínico+A+DIM+M+PL
querubiniquinha	querubínico+A+DIM+F+SG
querubiniquinhas	querubínico+A+DIM+F+PL
querubiniquinho	querubínico+A+DIM+M+SG
querubiniquinhos	querubínico+A+DIM+M+PL
querubínica	querubínico+A+F+SG
querubínicas	querubínico+A+F+PL
querubínico	querubínico+A+M+SG
querubínicos	querubínico+A+M+PL
questionada	questionado+A+F+SG
questionadas	questionado+A+F+PL
questionadazinha	questionado+A+DIM+F+SG
questionadazinhas	questionado+A+DIM+F+PL
questionadinha	questionado+A+DIM+F+SG
questionadinhas	questionado+A+DIM+F+PL
questionadinho	questionado+A+DIM+M+SG
questionadinhos	questionado+A+DIM+M+PL
questionado	questionado+A+M+SG
questionados	questionado+A+M+PL
questionadozinho	questionado+A+DIM+M+SG
questionadozinhos	questionado+A+DIM+M+PL
questionador	questionador+A+M+SG
questionadora	questionador+A+F+SG
questionadoras	questionador+A+F+PL
questionadorazinha	questionador+A+DIM+F+SG
questionadorazinhas	questionador+A+DIM+F+PL
questionadores	questionador+A+M+PL
questionadorezinhos	questionador+A+DIM+M+PL
questionadorinha	questionador+A+DIM+F+SG
questionadorinhas	questionador+A+DIM+F+PL
questionadorzinho	questionador+A+DIM+M+SG
questionadorzinhos	questionador+A+DIM+M+PL
questionaveizinhas	questionável+A+DIM+F+PL
questionaveizinhos	questionável+A+DIM+M+PL
questionavelzinha	questionável+A+DIM+F+SG
questionavelzinho	questionável+A+DIM+M+SG
questionáveis	questionável+A+PL
questionável	questionável+A+SG
questuosa	questuoso+A+F+SG
questuosas	questuoso+A+F+PL
questuosazinha	questuoso+A+DIM+F+SG
questuosazinhas	questuoso+A+DIM+F+PL
questuosinha	questuoso+A+DIM+F+SG
questuosinhas	questuoso+A+DIM+F+PL
questuosinho	questuoso+A+DIM+M+SG
questuosinhos	questuoso+A+DIM+M+PL
questuoso	questuoso+A+M+SG
questuosos	questuoso+A+M+PL
questuosozinho	questuoso+A+DIM+M+SG
questuosozinhos	questuoso+A+DIM+M+PL
questuariazinha	questuário+A+DIM+F+SG
questuariazinhas	questuário+A+DIM+F+PL
questuarinha	questuário+A+DIM+F+SG
questuarinhas	questuário+A+DIM+F+PL
questuarinho	questuário+A+DIM+M+SG
questuarinhos	questuário+A+DIM+M+PL
questuariozinho	questuário+A+DIM+M+SG
questuariozinhos	questuário+A+DIM+M+PL
questuária	questuário+A+F+SG
questuárias	questuário+A+F+PL
questuário	questuário+A+M+SG
questuários	questuário+A+M+PL
questoriazinha	questório+A+DIM+F+SG
questoriazinhas	questório+A+DIM+F+PL
questorinha	questório+A+DIM+F+SG
questorinhas	questório+A+DIM+F+PL
questorinho	questório+A+DIM+M+SG
questorinhos	questório+A+DIM+M+PL
questoriozinho	questório+A+DIM+M+SG
questoriozinhos	questório+A+DIM+M+PL
questória	questório+A+F+SG
questórias	questório+A+F+PL
questório	questório+A+M+SG
questórios	questório+A+M+PL
quesiveizinhas	quesível+A+DIM+F+PL
quesiveizinhos	quesível+A+DIM+M+PL
quesivelzinha	quesível+A+DIM+F+SG
quesivelzinho	quesível+A+DIM+M+SG
quesíveis	quesível+A+PL
quesível	quesível+A+SG
quetigerazinha	quetígero+A+DIM+F+SG
quetigerazinhas	quetígero+A+DIM+F+PL
quetigerinha	quetígero+A+DIM+F+SG
quetigerinhas	quetígero+A+DIM+F+PL
quetigerinho	quetígero+A+DIM+M+SG
quetigerinhos	quetígero+A+DIM+M+PL
quetigerozinho	quetígero+A+DIM+M+SG
quetigerozinhos	quetígero+A+DIM+M+PL
quetígera	quetígero+A+F+SG
quetígeras	quetígero+A+F+PL
quetígero	quetígero+A+M+SG
quetígeros	quetígero+A+M+PL
quezilenta	quezilento+A+F+SG
quezilentas	quezilento+A+F+PL
quezilentazinha	quezilento+A+DIM+F+SG
quezilentazinhas	quezilento+A+DIM+F+PL
quezilentinha	quezilento+A+DIM+F+SG
quezilentinhas	quezilento+A+DIM+F+PL
quezilentinho	quezilento+A+DIM+M+SG
quezilentinhos	quezilento+A+DIM+M+PL
quezilento	quezilento+A+M+SG
quezilentos	quezilento+A+M+PL
quezilentozinho	quezilento+A+DIM+M+SG
quezilentozinhos	quezilento+A+DIM+M+PL
quezilaveizinhas	quezilável+A+DIM+F+PL
quezilaveizinhos	quezilável+A+DIM+M+PL
quezilavelzinha	quezilável+A+DIM+F+SG
quezilavelzinho	quezilável+A+DIM+M+SG
queziláveis	quezilável+A+PL
quezilável	quezilável+A+SG
quiba	quiba+A+SG
quibas	quiba+A+PL
quibazinha	quiba+A+DIM+F+SG
quibazinhas	quiba+A+DIM+F+PL
quibazinho	quiba+A+DIM+M+SG
quibazinhos	quiba+A+DIM+M+PL
quibinha	quiba+A+DIM+SG
quibinhas	quiba+A+DIM+PL
quibandaveizinhas	quibandável+A+DIM+F+PL
quibandaveizinhos	quibandável+A+DIM+M+PL
quibandavelzinha	quibandável+A+DIM+F+SG
quibandavelzinho	quibandável+A+DIM+M+SG
quibandáveis	quibandável+A+PL
quibandável	quibandável+A+SG
quibebe	quibebe+A+SG
quibebes	quibebe+A+PL
quibebezinha	quibebe+A+DIM+F+SG
quibebezinhas	quibebe+A+DIM+F+PL
quibebezinho	quibebe+A+DIM+M+SG
quibebezinhos	quibebe+A+DIM+M+PL
quibebinha	quibebe+A+DIM+F+SG
quibebinhas	quibebe+A+DIM+F+PL
quibebinho	quibebe+A+DIM+M+SG
quibebinhos	quibebe+A+DIM+M+PL
quicaveizinhas	quicável+A+DIM+F+PL
quicaveizinhos	quicável+A+DIM+M+PL
quicavelzinha	quicável+A+DIM+F+SG
quicavelzinho	quicável+A+DIM+M+SG
quicáveis	quicável+A+PL
quicável	quicável+A+SG
quididativa	quididativo+A+F+SG
quididativas	quididativo+A+F+PL
quididativazinha	quididativo+A+DIM+F+SG
quididativazinhas	quididativo+A+DIM+F+PL
quididativinha	quididativo+A+DIM+F+SG
quididativinhas	quididativo+A+DIM+F+PL
quididativinho	quididativo+A+DIM+M+SG
quididativinhos	quididativo+A+DIM+M+PL
quididativo	quididativo+A+M+SG
quididativos	quididativo+A+M+PL
quididativozinho	quididativo+A+DIM+M+SG
quididativozinhos	quididativo+A+DIM+M+PL
quiescente	quiescente+A+SG
quiescentes	quiescente+A+PL
quiescentezinha	quiescente+A+DIM+F+SG
quiescentezinhas	quiescente+A+DIM+F+PL
quiescentezinho	quiescente+A+DIM+M+SG
quiescentezinhos	quiescente+A+DIM+M+PL
quiescentinha	quiescente+A+DIM+F+SG
quiescentinhas	quiescente+A+DIM+F+PL
quiescentinho	quiescente+A+DIM+M+SG
quiescentinhos	quiescente+A+DIM+M+PL
quietarrona	quietarrão+A+F+SG
quietarronas	quietarrão+A+F+PL
quietarronazinha	quietarrão+A+DIM+F+SG
quietarronazinhas	quietarrão+A+DIM+F+PL
quietarroninha	quietarrão+A+DIM+F+SG
quietarroninhas	quietarrão+A+DIM+F+PL
quietarrão	quietarrão+A+M+SG
quietarrãozinho	quietarrão+A+DIM+M+SG
quietarrões	quietarrão+A+M+PL
quietarrõezinhos	quietarrão+A+DIM+M+PL
quieta	quieto+A+F+SG
quietas	quieto+A+F+PL
quietazinha	quieto+A+DIM+F+SG
quietazinhas	quieto+A+DIM+F+PL
quietazita	quieto+A+DIM+F+SG
quietazitas	quieto+A+DIM+F+PL
quietinha	quieto+A+DIM+F+SG
quietinhas	quieto+A+DIM+F+PL
quietinho	quieto+A+DIM+M+SG
quietinhos	quieto+A+DIM+M+PL
quietita	quieto+A+DIM+F+SG
quietitas	quieto+A+DIM+F+PL
quietito	quieto+A+DIM+M+SG
quietitos	quieto+A+DIM+M+PL
quieto	quieto+A+M+SG
quietos	quieto+A+M+PL
quietozinho	quieto+A+DIM+M+SG
quietozinhos	quieto+A+DIM+M+PL
quietozito	quieto+A+DIM+M+SG
quietozitos	quieto+A+DIM+M+PL
quietíssima	quieto+A+SUPER+F+SG
quietíssimas	quieto+A+SUPER+F+PL
quietíssimo	quieto+A+SUPER+M+SG
quietíssimos	quieto+A+SUPER+M+PL
quietaveizinhas	quietável+A+DIM+F+PL
quietaveizinhos	quietável+A+DIM+M+PL
quietavelzinha	quietável+A+DIM+F+SG
quietavelzinho	quietável+A+DIM+M+SG
quietáveis	quietável+A+PL
quietável	quietável+A+SG
quiinaceazinha	quiináceo+A+DIM+F+SG
quiinaceazinhas	quiináceo+A+DIM+F+PL
quiinaceinha	quiináceo+A+DIM+F+SG
quiinaceinhas	quiináceo+A+DIM+F+PL
quiinaceinho	quiináceo+A+DIM+M+SG
quiinaceinhos	quiináceo+A+DIM+M+PL
quiinaceozinho	quiináceo+A+DIM+M+SG
quiinaceozinhos	quiináceo+A+DIM+M+PL
quiinácea	quiináceo+A+F+SG
quiináceas	quiináceo+A+F+PL
quiináceo	quiináceo+A+M+SG
quiináceos	quiináceo+A+M+PL
quilataveizinhas	quilatável+A+DIM+F+PL
quilataveizinhos	quilatável+A+DIM+M+PL
quilatavelzinha	quilatável+A+DIM+F+SG
quilatavelzinho	quilatável+A+DIM+M+SG
quilatáveis	quilatável+A+PL
quilatável	quilatável+A+SG
quilhaveizinhas	quilhável+A+DIM+F+PL
quilhaveizinhos	quilhável+A+DIM+M+PL
quilhavelzinha	quilhável+A+DIM+F+SG
quilhavelzinho	quilhável+A+DIM+M+SG
quilháveis	quilhável+A+PL
quilhável	quilhável+A+SG
quilificativa	quilificativo+A+F+SG
quilificativas	quilificativo+A+F+PL
quilificativazinha	quilificativo+A+DIM+F+SG
quilificativazinhas	quilificativo+A+DIM+F+PL
quilificativinha	quilificativo+A+DIM+F+SG
quilificativinhas	quilificativo+A+DIM+F+PL
quilificativinho	quilificativo+A+DIM+M+SG
quilificativinhos	quilificativo+A+DIM+M+PL
quilificativo	quilificativo+A+M+SG
quilificativos	quilificativo+A+M+PL
quilificativozinho	quilificativo+A+DIM+M+SG
quilificativozinhos	quilificativo+A+DIM+M+PL
quilificaveizinhas	quilificável+A+DIM+F+PL
quilificaveizinhos	quilificável+A+DIM+M+PL
quilificavelzinha	quilificável+A+DIM+F+SG
quilificavelzinho	quilificável+A+DIM+M+SG
quilificáveis	quilificável+A+PL
quilificável	quilificável+A+SG
quilometraveizinhas	quilometrável+A+DIM+F+PL
quilometraveizinhos	quilometrável+A+DIM+M+PL
quilometravelzinha	quilometrável+A+DIM+F+SG
quilometravelzinho	quilometrável+A+DIM+M+SG
quilometráveis	quilometrável+A+PL
quilometrável	quilometrável+A+SG
quilometricazinha	quilométrico+A+DIM+F+SG
quilometricazinhas	quilométrico+A+DIM+F+PL
quilometricozinho	quilométrico+A+DIM+M+SG
quilometricozinhos	quilométrico+A+DIM+M+PL
quilometriquinha	quilométrico+A+DIM+F+SG
quilometriquinhas	quilométrico+A+DIM+F+PL
quilometriquinho	quilométrico+A+DIM+M+SG
quilometriquinhos	quilométrico+A+DIM+M+PL
quilométrica	quilométrico+A+F+SG
quilométricas	quilométrico+A+F+PL
quilométrico	quilométrico+A+M+SG
quilométricos	quilométrico+A+M+PL
quiloplasticazinha	quiloplástico+A+DIM+F+SG
quiloplasticazinhas	quiloplástico+A+DIM+F+PL
quiloplasticozinho	quiloplástico+A+DIM+M+SG
quiloplasticozinhos	quiloplástico+A+DIM+M+PL
quiloplastiquinha	quiloplástico+A+DIM+F+SG
quiloplastiquinhas	quiloplástico+A+DIM+F+PL
quiloplastiquinho	quiloplástico+A+DIM+M+SG
quiloplastiquinhos	quiloplástico+A+DIM+M+PL
quiloplástica	quiloplástico+A+F+SG
quiloplásticas	quiloplástico+A+F+PL
quiloplástico	quiloplástico+A+M+SG
quiloplásticos	quiloplástico+A+M+PL
quilotaveizinhas	quilotável+A+DIM+F+PL
quilotaveizinhos	quilotável+A+DIM+M+PL
quilotavelzinha	quilotável+A+DIM+F+SG
quilotavelzinho	quilotável+A+DIM+M+SG
quilotáveis	quilotável+A+PL
quilotável	quilotável+A+SG
quiliferazinha	quilífero+A+DIM+F+SG
quiliferazinhas	quilífero+A+DIM+F+PL
quiliferinha	quilífero+A+DIM+F+SG
quiliferinhas	quilífero+A+DIM+F+PL
quiliferinho	quilífero+A+DIM+M+SG
quiliferinhos	quilífero+A+DIM+M+PL
quiliferozinho	quilífero+A+DIM+M+SG
quiliferozinhos	quilífero+A+DIM+M+PL
quilífera	quilífero+A+F+SG
quilíferas	quilífero+A+F+PL
quilífero	quilífero+A+M+SG
quilíferos	quilífero+A+M+PL
quilognatazinha	quilógnato+A+DIM+F+SG
quilognatazinhas	quilógnato+A+DIM+F+PL
quilognatinha	quilógnato+A+DIM+F+SG
quilognatinhas	quilógnato+A+DIM+F+PL
quilognatinho	quilógnato+A+DIM+M+SG
quilognatinhos	quilógnato+A+DIM+M+PL
quilognatozinho	quilógnato+A+DIM+M+SG
quilognatozinhos	quilógnato+A+DIM+M+PL
quilógnata	quilógnato+A+F+SG
quilógnatas	quilógnato+A+F+PL
quilógnato	quilógnato+A+M+SG
quilógnatos	quilógnato+A+M+PL
quilopodezinha	quilópode+A+DIM+F+SG
quilopodezinhas	quilópode+A+DIM+F+PL
quilopodezinho	quilópode+A+DIM+M+SG
quilopodezinhos	quilópode+A+DIM+M+PL
quilopodinha	quilópode+A+DIM+F+SG
quilopodinhas	quilópode+A+DIM+F+PL
quilopodinho	quilópode+A+DIM+M+SG
quilopodinhos	quilópode+A+DIM+M+PL
quilópode	quilópode+A+SG
quilópodes	quilópode+A+PL
quimbunda	quimbundo+A+F+SG
quimbundas	quimbundo+A+F+PL
quimbundazinha	quimbundo+A+DIM+F+SG
quimbundazinhas	quimbundo+A+DIM+F+PL
quimbundinha	quimbundo+A+DIM+F+SG
quimbundinhas	quimbundo+A+DIM+F+PL
quimbundinho	quimbundo+A+DIM+M+SG
quimbundinhos	quimbundo+A+DIM+M+PL
quimbundo	quimbundo+A+M+SG
quimbundos	quimbundo+A+M+PL
quimbundozinho	quimbundo+A+DIM+M+SG
quimbundozinhos	quimbundo+A+DIM+M+PL
quimerizaveizinhas	quimerizável+A+DIM+F+PL
quimerizaveizinhos	quimerizável+A+DIM+M+PL
quimerizavelzinha	quimerizável+A+DIM+F+SG
quimerizavelzinho	quimerizável+A+DIM+M+SG
quimerizáveis	quimerizável+A+PL
quimerizável	quimerizável+A+SG
quimificaveizinhas	quimificável+A+DIM+F+PL
quimificaveizinhos	quimificável+A+DIM+M+PL
quimificavelzinha	quimificável+A+DIM+F+SG
quimificavelzinho	quimificável+A+DIM+M+SG
quimificáveis	quimificável+A+PL
quimificável	quimificável+A+SG
quimiorreceptiva	quimiorreceptivo+A+F+SG
quimiorreceptivas	quimiorreceptivo+A+F+PL
quimiorreceptivazinha	quimiorreceptivo+A+DIM+F+SG
quimiorreceptivazinhas	quimiorreceptivo+A+DIM+F+PL
quimiorreceptivinha	quimiorreceptivo+A+DIM+F+SG
quimiorreceptivinhas	quimiorreceptivo+A+DIM+F+PL
quimiorreceptivinho	quimiorreceptivo+A+DIM+M+SG
quimiorreceptivinhos	quimiorreceptivo+A+DIM+M+PL
quimiorreceptivo	quimiorreceptivo+A+M+SG
quimiorreceptivos	quimiorreceptivo+A+M+PL
quimiorreceptivozinho	quimiorreceptivo+A+DIM+M+SG
quimiorreceptivozinhos	quimiorreceptivo+A+DIM+M+PL
quimiorreceptor	quimiorreceptor+A+M+SG
quimiorreceptora	quimiorreceptor+A+F+SG
quimiorreceptoras	quimiorreceptor+A+F+PL
quimiorreceptorazinha	quimiorreceptor+A+DIM+F+SG
quimiorreceptorazinhas	quimiorreceptor+A+DIM+F+PL
quimiorreceptores	quimiorreceptor+A+M+PL
quimiorreceptorezinhos	quimiorreceptor+A+DIM+M+PL
quimiorreceptorinha	quimiorreceptor+A+DIM+F+SG
quimiorreceptorinhas	quimiorreceptor+A+DIM+F+PL
quimiorreceptorzinho	quimiorreceptor+A+DIM+M+SG
quimiorreceptorzinhos	quimiorreceptor+A+DIM+M+PL
quimiorrecetiva	quimiorrecetivo+A+F+SG
quimiorrecetivas	quimiorrecetivo+A+F+PL
quimiorrecetivazinha	quimiorrecetivo+A+DIM+F+SG
quimiorrecetivazinhas	quimiorrecetivo+A+DIM+F+PL
quimiorrecetivinha	quimiorrecetivo+A+DIM+F+SG
quimiorrecetivinhas	quimiorrecetivo+A+DIM+F+PL
quimiorrecetivinho	quimiorrecetivo+A+DIM+M+SG
quimiorrecetivinhos	quimiorrecetivo+A+DIM+M+PL
quimiorrecetivo	quimiorrecetivo+A+M+SG
quimiorrecetivos	quimiorrecetivo+A+M+PL
quimiorrecetivozinho	quimiorrecetivo+A+DIM+M+SG
quimiorrecetivozinhos	quimiorrecetivo+A+DIM+M+PL
quimiossintetizante	quimiossintetizante+A+SG
quimiossintetizantes	quimiossintetizante+A+PL
quimiossintetizantezinha	quimiossintetizante+A+DIM+F+SG
quimiossintetizantezinhas	quimiossintetizante+A+DIM+F+PL
quimiossintetizantezinho	quimiossintetizante+A+DIM+M+SG
quimiossintetizantezinhos	quimiossintetizante+A+DIM+M+PL
quimiossintetizantinha	quimiossintetizante+A+DIM+F+SG
quimiossintetizantinhas	quimiossintetizante+A+DIM+F+PL
quimiossintetizantinho	quimiossintetizante+A+DIM+M+SG
quimiossintetizantinhos	quimiossintetizante+A+DIM+M+PL
quimioterapicazinha	quimioterápico+A+DIM+F+SG
quimioterapicazinhas	quimioterápico+A+DIM+F+PL
quimioterapicozinho	quimioterápico+A+DIM+M+SG
quimioterapicozinhos	quimioterápico+A+DIM+M+PL
quimioterapiquinha	quimioterápico+A+DIM+F+SG
quimioterapiquinhas	quimioterápico+A+DIM+F+PL
quimioterapiquinho	quimioterápico+A+DIM+M+SG
quimioterapiquinhos	quimioterápico+A+DIM+M+PL
quimioterápica	quimioterápico+A+F+SG
quimioterápicas	quimioterápico+A+F+PL
quimioterápico	quimioterápico+A+M+SG
quimioterápicos	quimioterápico+A+M+PL
quimiotacticazinha	quimiotáctico+A+DIM+F+SG
quimiotacticazinhas	quimiotáctico+A+DIM+F+PL
quimiotacticozinho	quimiotáctico+A+DIM+M+SG
quimiotacticozinhos	quimiotáctico+A+DIM+M+PL
quimiotactiquinha	quimiotáctico+A+DIM+F+SG
quimiotactiquinhas	quimiotáctico+A+DIM+F+PL
quimiotactiquinho	quimiotáctico+A+DIM+M+SG
quimiotactiquinhos	quimiotáctico+A+DIM+M+PL
quimiotáctica	quimiotáctico+A+F+SG
quimiotácticas	quimiotáctico+A+F+PL
quimiotáctico	quimiotáctico+A+M+SG
quimiotácticos	quimiotáctico+A+M+PL
quimiotaticazinha	quimiotático+A+DIM+F+SG
quimiotaticazinhas	quimiotático+A+DIM+F+PL
quimiotaticozinho	quimiotático+A+DIM+M+SG
quimiotaticozinhos	quimiotático+A+DIM+M+PL
quimiotatiquinha	quimiotático+A+DIM+F+SG
quimiotatiquinhas	quimiotático+A+DIM+F+PL
quimiotatiquinho	quimiotático+A+DIM+M+SG
quimiotatiquinhos	quimiotático+A+DIM+M+PL
quimiotática	quimiotático+A+F+SG
quimiotáticas	quimiotático+A+F+PL
quimiotático	quimiotático+A+M+SG
quimiotáticos	quimiotático+A+M+PL
quimiotaxicazinha	quimiotáxico+A+DIM+F+SG
quimiotaxicazinhas	quimiotáxico+A+DIM+F+PL
quimiotaxicozinho	quimiotáxico+A+DIM+M+SG
quimiotaxicozinhos	quimiotáxico+A+DIM+M+PL
quimiotaxiquinha	quimiotáxico+A+DIM+F+SG
quimiotaxiquinhas	quimiotáxico+A+DIM+F+PL
quimiotaxiquinho	quimiotáxico+A+DIM+M+SG
quimiotaxiquinhos	quimiotáxico+A+DIM+M+PL
quimiotáxica	quimiotáxico+A+F+SG
quimiotáxicas	quimiotáxico+A+F+PL
quimiotáxico	quimiotáxico+A+M+SG
quimiotáxicos	quimiotáxico+A+M+PL
quimanticazinha	quimântico+A+DIM+F+SG
quimanticazinhas	quimântico+A+DIM+F+PL
quimanticozinho	quimântico+A+DIM+M+SG
quimanticozinhos	quimântico+A+DIM+M+PL
quimantiquinha	quimântico+A+DIM+F+SG
quimantiquinhas	quimântico+A+DIM+F+PL
quimantiquinho	quimântico+A+DIM+M+SG
quimantiquinhos	quimântico+A+DIM+M+PL
quimântica	quimântico+A+F+SG
quimânticas	quimântico+A+F+PL
quimântico	quimântico+A+M+SG
quimânticos	quimântico+A+M+PL
quimericazinha	quimérico+A+DIM+F+SG
quimericazinhas	quimérico+A+DIM+F+PL
quimericozinho	quimérico+A+DIM+M+SG
quimericozinhos	quimérico+A+DIM+M+PL
quimeriquinha	quimérico+A+DIM+F+SG
quimeriquinhas	quimérico+A+DIM+F+PL
quimeriquinho	quimérico+A+DIM+M+SG
quimeriquinhos	quimérico+A+DIM+M+PL
quimérica	quimérico+A+F+SG
quiméricas	quimérico+A+F+PL
quimérico	quimérico+A+M+SG
quiméricos	quimérico+A+M+PL
quinada	quinado+A+F+SG
quinadas	quinado+A+F+PL
quinadazinha	quinado+A+DIM+F+SG
quinadazinhas	quinado+A+DIM+F+PL
quinadazita	quinado+A+DIM+F+SG
quinadazitas	quinado+A+DIM+F+PL
quinadinha	quinado+A+DIM+F+SG
quinadinhas	quinado+A+DIM+F+PL
quinadinho	quinado+A+DIM+M+SG
quinadinhos	quinado+A+DIM+M+PL
quinadita	quinado+A+DIM+F+SG
quinaditas	quinado+A+DIM+F+PL
quinadito	quinado+A+DIM+M+SG
quinaditos	quinado+A+DIM+M+PL
quinado	quinado+A+M+SG
quinados	quinado+A+M+PL
quinadozinho	quinado+A+DIM+M+SG
quinadozinhos	quinado+A+DIM+M+PL
quinadozito	quinado+A+DIM+M+SG
quinadozitos	quinado+A+DIM+M+PL
quinadíssima	quinado+A+SUPER+F+SG
quinadíssimas	quinado+A+SUPER+F+PL
quinadíssimo	quinado+A+SUPER+M+SG
quinadíssimos	quinado+A+SUPER+M+PL
quinante	quinante+A+SG
quinantes	quinante+A+PL
quinantezinha	quinante+A+DIM+F+SG
quinantezinhas	quinante+A+DIM+F+PL
quinantezinho	quinante+A+DIM+M+SG
quinantezinhos	quinante+A+DIM+M+PL
quinantinha	quinante+A+DIM+F+SG
quinantinhas	quinante+A+DIM+F+PL
quinantinho	quinante+A+DIM+M+SG
quinantinhos	quinante+A+DIM+M+PL
quinchaveizinhas	quinchável+A+DIM+F+PL
quinchaveizinhos	quinchável+A+DIM+M+PL
quinchavelzinha	quinchável+A+DIM+F+SG
quinchavelzinho	quinchável+A+DIM+M+SG
quincháveis	quinchável+A+PL
quinchável	quinchável+A+SG
quincunciais	quincuncial+A+PL
quincunciaizinhas	quincuncial+A+DIM+F+PL
quincunciaizinhos	quincuncial+A+DIM+M+PL
quincuncial	quincuncial+A+SG
quincuncialzinha	quincuncial+A+DIM+F+SG
quincuncialzinho	quincuncial+A+DIM+M+SG
quindecenvirais	quindecenviral+A+PL
quindecenviraizinhas	quindecenviral+A+DIM+F+PL
quindecenviraizinhos	quindecenviral+A+DIM+M+PL
quindecenviral	quindecenviral+A+SG
quindecenviralzinha	quindecenviral+A+DIM+F+SG
quindecenviralzinho	quindecenviral+A+DIM+M+SG
quinestesicazinha	quinestésico+A+DIM+F+SG
quinestesicazinhas	quinestésico+A+DIM+F+PL
quinestesicozinho	quinestésico+A+DIM+M+SG
quinestesicozinhos	quinestésico+A+DIM+M+PL
quinestesiquinha	quinestésico+A+DIM+F+SG
quinestesiquinhas	quinestésico+A+DIM+F+PL
quinestesiquinho	quinestésico+A+DIM+M+SG
quinestesiquinhos	quinestésico+A+DIM+M+PL
quinestésica	quinestésico+A+F+SG
quinestésicas	quinestésico+A+F+PL
quinestésico	quinestésico+A+M+SG
quinestésicos	quinestésico+A+M+PL
quingentesimazinha	quingentésimo+A+DIM+F+SG
quingentesimazinhas	quingentésimo+A+DIM+F+PL
quingentesiminha	quingentésimo+A+DIM+F+SG
quingentesiminhas	quingentésimo+A+DIM+F+PL
quingentesiminho	quingentésimo+A+DIM+M+SG
quingentesiminhos	quingentésimo+A+DIM+M+PL
quingentesimozinho	quingentésimo+A+DIM+M+SG
quingentesimozinhos	quingentésimo+A+DIM+M+PL
quingentésima	quingentésimo+A+F+SG
quingentésimas	quingentésimo+A+F+PL
quingentésimo	quingentésimo+A+M+SG
quingentésimos	quingentésimo+A+M+PL
quinhentista	quinhentista+A+SG
quinhentistas	quinhentista+A+PL
quinhentistazinha	quinhentista+A+DIM+F+SG
quinhentistazinhas	quinhentista+A+DIM+F+PL
quinhentistazinho	quinhentista+A+DIM+M+SG
quinhentistazinhos	quinhentista+A+DIM+M+PL
quinhentistinha	quinhentista+A+DIM+SG
quinhentistinhas	quinhentista+A+DIM+PL
quinhoaveizinhas	quinhoável+A+DIM+F+PL
quinhoaveizinhos	quinhoável+A+DIM+M+PL
quinhoavelzinha	quinhoável+A+DIM+F+SG
quinhoavelzinho	quinhoável+A+DIM+M+SG
quinhoáveis	quinhoável+A+PL
quinhoável	quinhoável+A+SG
quinoide	quinoide+A+SG
quinoides	quinoide+A+PL
quinoidezinha	quinoide+A+DIM+F+SG
quinoidezinhas	quinoide+A+DIM+F+PL
quinoidezinho	quinoide+A+DIM+M+SG
quinoidezinhos	quinoide+A+DIM+M+PL
quinoidinha	quinoide+A+DIM+F+SG
quinoidinhas	quinoide+A+DIM+F+PL
quinoidinho	quinoide+A+DIM+M+SG
quinoidinhos	quinoide+A+DIM+M+PL
quinoleica	quinoleico+A+F+SG
quinoleicas	quinoleico+A+F+PL
quinoleicazinha	quinoleico+A+DIM+F+SG
quinoleicazinhas	quinoleico+A+DIM+F+PL
quinoleico	quinoleico+A+M+SG
quinoleicos	quinoleico+A+M+PL
quinoleicozinho	quinoleico+A+DIM+M+SG
quinoleicozinhos	quinoleico+A+DIM+M+PL
quinoleiquinha	quinoleico+A+DIM+F+SG
quinoleiquinhas	quinoleico+A+DIM+F+PL
quinoleiquinho	quinoleico+A+DIM+M+SG
quinoleiquinhos	quinoleico+A+DIM+M+PL
quinquagenariazinha	quinquagenário+A+DIM+F+SG
quinquagenariazinhas	quinquagenário+A+DIM+F+PL
quinquagenarinha	quinquagenário+A+DIM+F+SG
quinquagenarinhas	quinquagenário+A+DIM+F+PL
quinquagenarinho	quinquagenário+A+DIM+M+SG
quinquagenarinhos	quinquagenário+A+DIM+M+PL
quinquagenariozinho	quinquagenário+A+DIM+M+SG
quinquagenariozinhos	quinquagenário+A+DIM+M+PL
quinquagenária	quinquagenário+A+F+SG
quinquagenárias	quinquagenário+A+F+PL
quinquagenário	quinquagenário+A+M+SG
quinquagenários	quinquagenário+A+M+PL
quinquagesimais	quinquagesimal+A+PL
quinquagesimaizinhas	quinquagesimal+A+DIM+F+PL
quinquagesimaizinhos	quinquagesimal+A+DIM+M+PL
quinquagesimal	quinquagesimal+A+SG
quinquagesimalzinha	quinquagesimal+A+DIM+F+SG
quinquagesimalzinho	quinquagesimal+A+DIM+M+SG
quinquagesimazinha	quinquagésimo+A+DIM+F+SG
quinquagesimazinhas	quinquagésimo+A+DIM+F+PL
quinquagesiminha	quinquagésimo+A+DIM+F+SG
quinquagesiminhas	quinquagésimo+A+DIM+F+PL
quinquagesiminho	quinquagésimo+A+DIM+M+SG
quinquagesiminhos	quinquagésimo+A+DIM+M+PL
quinquagesimozinho	quinquagésimo+A+DIM+M+SG
quinquagesimozinhos	quinquagésimo+A+DIM+M+PL
quinquagésima	quinquagésimo+A+F+SG
quinquagésimas	quinquagésimo+A+F+PL
quinquagésimo	quinquagésimo+A+M+SG
quinquagésimos	quinquagésimo+A+M+PL
quinqueangular	quinqueangular+A+SG
quinqueangulares	quinqueangular+A+PL
quinqueangularezinhas	quinqueangular+A+DIM+F+PL
quinqueangularezinhos	quinqueangular+A+DIM+M+PL
quinqueangularzinha	quinqueangular+A+DIM+F+SG
quinqueangularzinhas	quinqueangular+A+DIM+F+PL
quinqueangularzinho	quinqueangular+A+DIM+M+SG
quinqueangularzinhos	quinqueangular+A+DIM+M+PL
quinquecapsular	quinquecapsular+A+SG
quinquecapsulares	quinquecapsular+A+PL
quinquecapsularezinhas	quinquecapsular+A+DIM+F+PL
quinquecapsularezinhos	quinquecapsular+A+DIM+M+PL
quinquecapsularzinha	quinquecapsular+A+DIM+F+SG
quinquecapsularzinhas	quinquecapsular+A+DIM+F+PL
quinquecapsularzinho	quinquecapsular+A+DIM+M+SG
quinquecapsularzinhos	quinquecapsular+A+DIM+M+PL
quinquecelular	quinquecelular+A+SG
quinquecelulares	quinquecelular+A+PL
quinquecelularezinhas	quinquecelular+A+DIM+F+PL
quinquecelularezinhos	quinquecelular+A+DIM+M+PL
quinquecelularzinha	quinquecelular+A+DIM+F+SG
quinquecelularzinhas	quinquecelular+A+DIM+F+PL
quinquecelularzinho	quinquecelular+A+DIM+M+SG
quinquecelularzinhos	quinquecelular+A+DIM+M+PL
quinquedentada	quinquedentado+A+F+SG
quinquedentadas	quinquedentado+A+F+PL
quinquedentadazinha	quinquedentado+A+DIM+F+SG
quinquedentadazinhas	quinquedentado+A+DIM+F+PL
quinquedentadinha	quinquedentado+A+DIM+F+SG
quinquedentadinhas	quinquedentado+A+DIM+F+PL
quinquedentadinho	quinquedentado+A+DIM+M+SG
quinquedentadinhos	quinquedentado+A+DIM+M+PL
quinquedentado	quinquedentado+A+M+SG
quinquedentados	quinquedentado+A+M+PL
quinquedentadozinho	quinquedentado+A+DIM+M+SG
quinquedentadozinhos	quinquedentado+A+DIM+M+PL
quinquedigitada	quinquedigitado+A+F+SG
quinquedigitadas	quinquedigitado+A+F+PL
quinquedigitadazinha	quinquedigitado+A+DIM+F+SG
quinquedigitadazinhas	quinquedigitado+A+DIM+F+PL
quinquedigitadinha	quinquedigitado+A+DIM+F+SG
quinquedigitadinhas	quinquedigitado+A+DIM+F+PL
quinquedigitadinho	quinquedigitado+A+DIM+M+SG
quinquedigitadinhos	quinquedigitado+A+DIM+M+PL
quinquedigitado	quinquedigitado+A+M+SG
quinquedigitados	quinquedigitado+A+M+PL
quinquedigitadozinho	quinquedigitado+A+DIM+M+SG
quinquedigitadozinhos	quinquedigitado+A+DIM+M+PL
quinquefida	quinquefido+A+F+SG
quinquefidas	quinquefido+A+F+PL
quinquefidazinha	quinquefido+A+DIM+F+SG
quinquefidazinhas	quinquefido+A+DIM+F+PL
quinquefidinha	quinquefido+A+DIM+F+SG
quinquefidinhas	quinquefido+A+DIM+F+PL
quinquefidinho	quinquefido+A+DIM+M+SG
quinquefidinhos	quinquefido+A+DIM+M+PL
quinquefido	quinquefido+A+M+SG
quinquefidos	quinquefido+A+M+PL
quinquefidozinho	quinquefido+A+DIM+M+SG
quinquefidozinhos	quinquefido+A+DIM+M+PL
quinquefoliada	quinquefoliado+A+F+SG
quinquefoliadas	quinquefoliado+A+F+PL
quinquefoliadazinha	quinquefoliado+A+DIM+F+SG
quinquefoliadazinhas	quinquefoliado+A+DIM+F+PL
quinquefoliadinha	quinquefoliado+A+DIM+F+SG
quinquefoliadinhas	quinquefoliado+A+DIM+F+PL
quinquefoliadinho	quinquefoliado+A+DIM+M+SG
quinquefoliadinhos	quinquefoliado+A+DIM+M+PL
quinquefoliado	quinquefoliado+A+M+SG
quinquefoliados	quinquefoliado+A+M+PL
quinquefoliadozinho	quinquefoliado+A+DIM+M+SG
quinquefoliadozinhos	quinquefoliado+A+DIM+M+PL
quinquefoliazinha	quinquefólio+A+DIM+F+SG
quinquefoliazinhas	quinquefólio+A+DIM+F+PL
quinquefolinha	quinquefólio+A+DIM+F+SG
quinquefolinhas	quinquefólio+A+DIM+F+PL
quinquefolinho	quinquefólio+A+DIM+M+SG
quinquefolinhos	quinquefólio+A+DIM+M+PL
quinquefoliozinho	quinquefólio+A+DIM+M+SG
quinquefoliozinhos	quinquefólio+A+DIM+M+PL
quinquefólia	quinquefólio+A+F+SG
quinquefólias	quinquefólio+A+F+PL
quinquefólio	quinquefólio+A+M+SG
quinquefólios	quinquefólio+A+M+PL
quinquegenciana	quinquegenciano+A+F+SG
quinquegencianas	quinquegenciano+A+F+PL
quinquegencianazinha	quinquegenciano+A+DIM+F+SG
quinquegencianazinhas	quinquegenciano+A+DIM+F+PL
quinquegencianinha	quinquegenciano+A+DIM+F+SG
quinquegencianinhas	quinquegenciano+A+DIM+F+PL
quinquegencianinho	quinquegenciano+A+DIM+M+SG
quinquegencianinhos	quinquegenciano+A+DIM+M+PL
quinquegenciano	quinquegenciano+A+M+SG
quinquegencianos	quinquegenciano+A+M+PL
quinquegencianozinho	quinquegenciano+A+DIM+M+SG
quinquegencianozinhos	quinquegenciano+A+DIM+M+PL
quinquelobada	quinquelobado+A+F+SG
quinquelobadas	quinquelobado+A+F+PL
quinquelobadazinha	quinquelobado+A+DIM+F+SG
quinquelobadazinhas	quinquelobado+A+DIM+F+PL
quinquelobadinha	quinquelobado+A+DIM+F+SG
quinquelobadinhas	quinquelobado+A+DIM+F+PL
quinquelobadinho	quinquelobado+A+DIM+M+SG
quinquelobadinhos	quinquelobado+A+DIM+M+PL
quinquelobado	quinquelobado+A+M+SG
quinquelobados	quinquelobado+A+M+PL
quinquelobadozinho	quinquelobado+A+DIM+M+SG
quinquelobadozinhos	quinquelobado+A+DIM+M+PL
quinquelocular	quinquelocular+A+SG
quinqueloculares	quinquelocular+A+PL
quinquelocularezinhas	quinquelocular+A+DIM+F+PL
quinquelocularezinhos	quinquelocular+A+DIM+M+PL
quinquelocularzinha	quinquelocular+A+DIM+F+SG
quinquelocularzinhas	quinquelocular+A+DIM+F+PL
quinquelocularzinho	quinquelocular+A+DIM+M+SG
quinquelocularzinhos	quinquelocular+A+DIM+M+PL
quinquelinguezinha	quinquelíngue+A+DIM+F+SG
quinquelinguezinhas	quinquelíngue+A+DIM+F+PL
quinquelinguezinho	quinquelíngue+A+DIM+M+SG
quinquelinguezinhos	quinquelíngue+A+DIM+M+PL
quinquelinguinha	quinquelíngue+A+DIM+F+SG
quinquelinguinhas	quinquelíngue+A+DIM+F+PL
quinquelinguinho	quinquelíngue+A+DIM+M+SG
quinquelinguinhos	quinquelíngue+A+DIM+M+PL
quinquelíngue	quinquelíngue+A+SG
quinquelíngues	quinquelíngue+A+PL
quinquelingüezinha	quinquelíngüe+A+DIM+F+SG
quinquelingüezinhas	quinquelíngüe+A+DIM+F+PL
quinquelingüezinho	quinquelíngüe+A+DIM+M+SG
quinquelingüezinhos	quinquelíngüe+A+DIM+M+PL
quinquelingüinha	quinquelíngüe+A+DIM+F+SG
quinquelingüinhas	quinquelíngüe+A+DIM+F+PL
quinquelingüinho	quinquelíngüe+A+DIM+M+SG
quinquelingüinhos	quinquelíngüe+A+DIM+M+PL
quinquelíngüe	quinquelíngüe+A+SG
quinquelíngües	quinquelíngüe+A+PL
quinquenais	quinquenal+A+PL
quinquenaizinhas	quinquenal+A+DIM+F+PL
quinquenaizinhos	quinquenal+A+DIM+M+PL
quinquenal	quinquenal+A+SG
quinquenalzinha	quinquenal+A+DIM+F+SG
quinquenalzinho	quinquenal+A+DIM+M+SG
quinquenervada	quinquenervado+A+F+SG
quinquenervadas	quinquenervado+A+F+PL
quinquenervadazinha	quinquenervado+A+DIM+F+SG
quinquenervadazinhas	quinquenervado+A+DIM+F+PL
quinquenervadinha	quinquenervado+A+DIM+F+SG
quinquenervadinhas	quinquenervado+A+DIM+F+PL
quinquenervadinho	quinquenervado+A+DIM+M+SG
quinquenervadinhos	quinquenervado+A+DIM+M+PL
quinquenervado	quinquenervado+A+M+SG
quinquenervados	quinquenervado+A+M+PL
quinquenervadozinho	quinquenervado+A+DIM+M+SG
quinquenervadozinhos	quinquenervado+A+DIM+M+PL
quinquenariazinha	quinquenário+A+DIM+F+SG
quinquenariazinhas	quinquenário+A+DIM+F+PL
quinquenarinha	quinquenário+A+DIM+F+SG
quinquenarinhas	quinquenário+A+DIM+F+PL
quinquenarinho	quinquenário+A+DIM+M+SG
quinquenarinhos	quinquenário+A+DIM+M+PL
quinquenariozinho	quinquenário+A+DIM+M+SG
quinquenariozinhos	quinquenário+A+DIM+M+PL
quinquenária	quinquenário+A+F+SG
quinquenárias	quinquenário+A+F+PL
quinquenário	quinquenário+A+M+SG
quinquenários	quinquenário+A+M+PL
quinqueovulada	quinqueovulado+A+F+SG
quinqueovuladas	quinqueovulado+A+F+PL
quinqueovuladazinha	quinqueovulado+A+DIM+F+SG
quinqueovuladazinhas	quinqueovulado+A+DIM+F+PL
quinqueovuladinha	quinqueovulado+A+DIM+F+SG
quinqueovuladinhas	quinqueovulado+A+DIM+F+PL
quinqueovuladinho	quinqueovulado+A+DIM+M+SG
quinqueovuladinhos	quinqueovulado+A+DIM+M+PL
quinqueovulado	quinqueovulado+A+M+SG
quinqueovulados	quinqueovulado+A+M+PL
quinqueovuladozinho	quinqueovulado+A+DIM+M+SG
quinqueovuladozinhos	quinqueovulado+A+DIM+M+PL
quinquevalente	quinquevalente+A+SG
quinquevalentes	quinquevalente+A+PL
quinquevalentezinha	quinquevalente+A+DIM+F+SG
quinquevalentezinhas	quinquevalente+A+DIM+F+PL
quinquevalentezinho	quinquevalente+A+DIM+M+SG
quinquevalentezinhos	quinquevalente+A+DIM+M+PL
quinquevalentinha	quinquevalente+A+DIM+F+SG
quinquevalentinhas	quinquevalente+A+DIM+F+PL
quinquevalentinho	quinquevalente+A+DIM+M+SG
quinquevalentinhos	quinquevalente+A+DIM+M+PL
quinquevalvar	quinquevalvar+A+SG
quinquevalvares	quinquevalvar+A+PL
quinquevalvarezinhas	quinquevalvar+A+DIM+F+PL
quinquevalvarezinhos	quinquevalvar+A+DIM+M+PL
quinquevalvarzinha	quinquevalvar+A+DIM+F+SG
quinquevalvarzinhas	quinquevalvar+A+DIM+F+PL
quinquevalvarzinho	quinquevalvar+A+DIM+M+SG
quinquevalvarzinhos	quinquevalvar+A+DIM+M+PL
quinquevalve	quinquevalve+A+SG
quinquevalves	quinquevalve+A+PL
quinquevalvezinha	quinquevalve+A+DIM+F+SG
quinquevalvezinhas	quinquevalve+A+DIM+F+PL
quinquevalvezinho	quinquevalve+A+DIM+M+SG
quinquevalvezinhos	quinquevalve+A+DIM+M+PL
quinquevalvinha	quinquevalve+A+DIM+F+SG
quinquevalvinhas	quinquevalve+A+DIM+F+PL
quinquevalvinho	quinquevalve+A+DIM+M+SG
quinquevalvinhos	quinquevalve+A+DIM+M+PL
quinquevalvular	quinquevalvular+A+SG
quinquevalvulares	quinquevalvular+A+PL
quinquevalvularezinhas	quinquevalvular+A+DIM+F+PL
quinquevalvularezinhos	quinquevalvular+A+DIM+M+PL
quinquevalvularzinha	quinquevalvular+A+DIM+F+SG
quinquevalvularzinhas	quinquevalvular+A+DIM+F+PL
quinquevalvularzinho	quinquevalvular+A+DIM+M+SG
quinquevalvularzinhos	quinquevalvular+A+DIM+M+PL
quinquevirais	quinqueviral+A+PL
quinqueviraizinhas	quinqueviral+A+DIM+F+PL
quinqueviraizinhos	quinqueviral+A+DIM+M+PL
quinqueviral	quinqueviral+A+SG
quinqueviralzinha	quinqueviral+A+DIM+F+SG
quinqueviralzinho	quinqueviral+A+DIM+M+SG
quintador	quintador+A+M+SG
quintadora	quintador+A+F+SG
quintadoras	quintador+A+F+PL
quintadorazinha	quintador+A+DIM+F+SG
quintadorazinhas	quintador+A+DIM+F+PL
quintadores	quintador+A+M+PL
quintadorezinhos	quintador+A+DIM+M+PL
quintadorinha	quintador+A+DIM+F+SG
quintadorinhas	quintador+A+DIM+F+PL
quintadorzinho	quintador+A+DIM+M+SG
quintadorzinhos	quintador+A+DIM+M+PL
quintana	quintano+A+F+SG
quintanas	quintano+A+F+PL
quintanazinha	quintano+A+DIM+F+SG
quintanazinhas	quintano+A+DIM+F+PL
quintaninha	quintano+A+DIM+F+SG
quintaninhas	quintano+A+DIM+F+PL
quintaninho	quintano+A+DIM+M+SG
quintaninhos	quintano+A+DIM+M+PL
quintano	quintano+A+M+SG
quintanos	quintano+A+M+PL
quintanozinho	quintano+A+DIM+M+SG
quintanozinhos	quintano+A+DIM+M+PL
quintessenciaveizinhas	quintessenciável+A+DIM+F+PL
quintessenciaveizinhos	quintessenciável+A+DIM+M+PL
quintessenciavelzinha	quintessenciável+A+DIM+F+SG
quintessenciavelzinho	quintessenciável+A+DIM+M+SG
quintessenciáveis	quintessenciável+A+PL
quintessenciável	quintessenciável+A+SG
quintiliana	quintiliano+A+F+SG
quintilianas	quintiliano+A+F+PL
quintilianazinha	quintiliano+A+DIM+F+SG
quintilianazinhas	quintiliano+A+DIM+F+PL
quintilianinha	quintiliano+A+DIM+F+SG
quintilianinhas	quintiliano+A+DIM+F+PL
quintilianinho	quintiliano+A+DIM+M+SG
quintilianinhos	quintiliano+A+DIM+M+PL
quintiliano	quintiliano+A+M+SG
quintilianos	quintiliano+A+M+PL
quintilianozinho	quintiliano+A+DIM+M+SG
quintilianozinhos	quintiliano+A+DIM+M+PL
quintimetatarsicazinha	quintimetatársico+A+DIM+F+SG
quintimetatarsicazinhas	quintimetatársico+A+DIM+F+PL
quintimetatarsicozinho	quintimetatársico+A+DIM+M+SG
quintimetatarsicozinhos	quintimetatársico+A+DIM+M+PL
quintimetatarsiquinha	quintimetatársico+A+DIM+F+SG
quintimetatarsiquinhas	quintimetatársico+A+DIM+F+PL
quintimetatarsiquinho	quintimetatársico+A+DIM+M+SG
quintimetatarsiquinhos	quintimetatársico+A+DIM+M+PL
quintimetatársica	quintimetatársico+A+F+SG
quintimetatársicas	quintimetatársico+A+F+PL
quintimetatársico	quintimetatársico+A+M+SG
quintimetatársicos	quintimetatársico+A+M+PL
quintinizaveizinhas	quintinizável+A+DIM+F+PL
quintinizaveizinhos	quintinizável+A+DIM+M+PL
quintinizavelzinha	quintinizável+A+DIM+F+SG
quintinizavelzinho	quintinizável+A+DIM+M+SG
quintinizáveis	quintinizável+A+PL
quintinizável	quintinizável+A+SG
quintissecular	quintissecular+A+SG
quintisseculares	quintissecular+A+PL
quintissecularezinhas	quintissecular+A+DIM+F+PL
quintissecularezinhos	quintissecular+A+DIM+M+PL
quintissecularzinha	quintissecular+A+DIM+F+SG
quintissecularzinhas	quintissecular+A+DIM+F+PL
quintissecularzinho	quintissecular+A+DIM+M+SG
quintissecularzinhos	quintissecular+A+DIM+M+PL
quintuplicada	quintuplicado+A+F+SG
quintuplicadas	quintuplicado+A+F+PL
quintuplicadazinha	quintuplicado+A+DIM+F+SG
quintuplicadazinhas	quintuplicado+A+DIM+F+PL
quintuplicadinha	quintuplicado+A+DIM+F+SG
quintuplicadinhas	quintuplicado+A+DIM+F+PL
quintuplicadinho	quintuplicado+A+DIM+M+SG
quintuplicadinhos	quintuplicado+A+DIM+M+PL
quintuplicado	quintuplicado+A+M+SG
quintuplicados	quintuplicado+A+M+PL
quintuplicadozinho	quintuplicado+A+DIM+M+SG
quintuplicadozinhos	quintuplicado+A+DIM+M+PL
quintuplicador	quintuplicador+A+M+SG
quintuplicadora	quintuplicador+A+F+SG
quintuplicadoras	quintuplicador+A+F+PL
quintuplicadorazinha	quintuplicador+A+DIM+F+SG
quintuplicadorazinhas	quintuplicador+A+DIM+F+PL
quintuplicadores	quintuplicador+A+M+PL
quintuplicadorezinhos	quintuplicador+A+DIM+M+PL
quintuplicadorinha	quintuplicador+A+DIM+F+SG
quintuplicadorinhas	quintuplicador+A+DIM+F+PL
quintuplicadorzinho	quintuplicador+A+DIM+M+SG
quintuplicadorzinhos	quintuplicador+A+DIM+M+PL
quintuplicaveizinhas	quintuplicável+A+DIM+F+PL
quintuplicaveizinhos	quintuplicável+A+DIM+M+PL
quintuplicavelzinha	quintuplicável+A+DIM+F+SG
quintuplicavelzinho	quintuplicável+A+DIM+M+SG
quintuplicáveis	quintuplicável+A+PL
quintuplicável	quintuplicável+A+SG
quintuplinerveazinha	quintuplinérveo+A+DIM+F+SG
quintuplinerveazinhas	quintuplinérveo+A+DIM+F+PL
quintuplinerveinha	quintuplinérveo+A+DIM+F+SG
quintuplinerveinhas	quintuplinérveo+A+DIM+F+PL
quintuplinerveinho	quintuplinérveo+A+DIM+M+SG
quintuplinerveinhos	quintuplinérveo+A+DIM+M+PL
quintuplinerveozinho	quintuplinérveo+A+DIM+M+SG
quintuplinerveozinhos	quintuplinérveo+A+DIM+M+PL
quintuplinérvea	quintuplinérveo+A+F+SG
quintuplinérveas	quintuplinérveo+A+F+PL
quintuplinérveo	quintuplinérveo+A+M+SG
quintuplinérveos	quintuplinérveo+A+M+PL
quintaveizinhas	quintável+A+DIM+F+PL
quintaveizinhos	quintável+A+DIM+M+PL
quintavelzinha	quintável+A+DIM+F+SG
quintavelzinho	quintável+A+DIM+M+SG
quintáveis	quintável+A+PL
quintável	quintável+A+SG
quintã	quintã+A+F+SG
quintãs	quintã+A+F+PL
quintãzinha	quintã+A+DIM+F+SG
quintãzinhas	quintã+A+DIM+F+PL
quintã	quintão+A+F+SG
quintão	quintão+A+M+SG
quintãos	quintão+A+M+PL
quintãozinho	quintão+A+DIM+M+SG
quintãozinhos	quintão+A+DIM+M+PL
quintãs	quintão+A+F+PL
quintãzinha	quintão+A+DIM+F+SG
quintãzinhas	quintão+A+DIM+F+PL
quintões	quintão+A+M+PL
quintõezinhos	quintão+A+DIM+M+PL
quinzenais	quinzenal+A+PL
quinzenaizinhas	quinzenal+A+DIM+F+PL
quinzenaizinhos	quinzenal+A+DIM+M+PL
quinzenal	quinzenal+A+SG
quinzenalzinha	quinzenal+A+DIM+F+SG
quinzenalzinho	quinzenal+A+DIM+M+SG
quinariazinha	quinário+A+DIM+F+SG
quinariazinhas	quinário+A+DIM+F+PL
quinarinha	quinário+A+DIM+F+SG
quinarinhas	quinário+A+DIM+F+PL
quinarinho	quinário+A+DIM+M+SG
quinarinhos	quinário+A+DIM+M+PL
quinariozinho	quinário+A+DIM+M+SG
quinariozinhos	quinário+A+DIM+M+PL
quinária	quinário+A+F+SG
quinárias	quinário+A+F+PL
quinário	quinário+A+M+SG
quinários	quinário+A+M+PL
quinaveizinhas	quinável+A+DIM+F+PL
quinaveizinhos	quinável+A+DIM+M+PL
quinavelzinha	quinável+A+DIM+F+SG
quinavelzinho	quinável+A+DIM+M+SG
quináveis	quinável+A+PL
quinável	quinável+A+SG
quinoidezinha	quinóide+A+DIM+F+SG
quinoidezinhas	quinóide+A+DIM+F+PL
quinoidezinho	quinóide+A+DIM+M+SG
quinoidezinhos	quinóide+A+DIM+M+PL
quinoidinha	quinóide+A+DIM+F+SG
quinoidinhas	quinóide+A+DIM+F+PL
quinoidinho	quinóide+A+DIM+M+SG
quinoidinhos	quinóide+A+DIM+M+PL
quinóide	quinóide+A+SG
quinóides	quinóide+A+PL
quiragra	quiragra+A+SG
quiragras	quiragra+A+PL
quiragrazinha	quiragra+A+DIM+F+SG
quiragrazinhas	quiragra+A+DIM+F+PL
quiragrazinho	quiragra+A+DIM+M+SG
quiragrazinhos	quiragra+A+DIM+M+PL
quiragrinha	quiragra+A+DIM+SG
quiragrinhas	quiragra+A+DIM+PL
quirereaveizinhas	quirereável+A+DIM+F+PL
quirereaveizinhos	quirereável+A+DIM+M+PL
quirereavelzinha	quirereável+A+DIM+F+SG
quirereavelzinho	quirereável+A+DIM+M+SG
quirereáveis	quirereável+A+PL
quirereável	quirereável+A+SG
quirguiz	quirguiz+A+SG
quirguizes	quirguiz+A+PL
quirguizezinhas	quirguiz+A+DIM+F+PL
quirguizezinhos	quirguiz+A+DIM+M+PL
quirguizinha	quirguiz+A+DIM+F+SG
quirguizinhas	quirguiz+A+DIM+F+PL
quirguizinho	quirguiz+A+DIM+M+SG
quirguizinhos	quirguiz+A+DIM+M+PL
quiribatiana	quiribatiano+A+F+SG
quiribatianas	quiribatiano+A+F+PL
quiribatianazinha	quiribatiano+A+DIM+F+SG
quiribatianazinhas	quiribatiano+A+DIM+F+PL
quiribatianinha	quiribatiano+A+DIM+F+SG
quiribatianinhas	quiribatiano+A+DIM+F+PL
quiribatianinho	quiribatiano+A+DIM+M+SG
quiribatianinhos	quiribatiano+A+DIM+M+PL
quiribatiano	quiribatiano+A+M+SG
quiribatianos	quiribatiano+A+M+PL
quiribatianozinho	quiribatiano+A+DIM+M+SG
quiribatianozinhos	quiribatiano+A+DIM+M+PL
quiritariazinha	quiritário+A+DIM+F+SG
quiritariazinhas	quiritário+A+DIM+F+PL
quiritarinha	quiritário+A+DIM+F+SG
quiritarinhas	quiritário+A+DIM+F+PL
quiritarinho	quiritário+A+DIM+M+SG
quiritarinhos	quiritário+A+DIM+M+PL
quiritariozinho	quiritário+A+DIM+M+SG
quiritariozinhos	quiritário+A+DIM+M+PL
quiritária	quiritário+A+F+SG
quiritárias	quiritário+A+F+PL
quiritário	quiritário+A+M+SG
quiritários	quiritário+A+M+PL
quirografariazinha	quirografário+A+DIM+F+SG
quirografariazinhas	quirografário+A+DIM+F+PL
quirografarinha	quirografário+A+DIM+F+SG
quirografarinhas	quirografário+A+DIM+F+PL
quirografarinho	quirografário+A+DIM+M+SG
quirografarinhos	quirografário+A+DIM+M+PL
quirografariozinho	quirografário+A+DIM+M+SG
quirografariozinhos	quirografário+A+DIM+M+PL
quirografária	quirografário+A+F+SG
quirografárias	quirografário+A+F+PL
quirografário	quirografário+A+M+SG
quirografários	quirografário+A+M+PL
quirografaveizinhas	quirografável+A+DIM+F+PL
quirografaveizinhos	quirografável+A+DIM+M+PL
quirografavelzinha	quirografável+A+DIM+F+SG
quirografavelzinho	quirografável+A+DIM+M+SG
quirografáveis	quirografável+A+PL
quirografável	quirografável+A+SG
quirograficazinha	quirográfico+A+DIM+F+SG
quirograficazinhas	quirográfico+A+DIM+F+PL
quirograficozinho	quirográfico+A+DIM+M+SG
quirograficozinhos	quirográfico+A+DIM+M+PL
quirografiquinha	quirográfico+A+DIM+F+SG
quirografiquinhas	quirográfico+A+DIM+F+PL
quirografiquinho	quirográfico+A+DIM+M+SG
quirografiquinhos	quirográfico+A+DIM+M+PL
quirográfica	quirográfico+A+F+SG
quirográficas	quirográfico+A+F+PL
quirográfico	quirográfico+A+M+SG
quirográficos	quirográfico+A+M+PL
quirologicazinha	quirológico+A+DIM+F+SG
quirologicazinhas	quirológico+A+DIM+F+PL
quirologicozinho	quirológico+A+DIM+M+SG
quirologicozinhos	quirológico+A+DIM+M+PL
quirologiquinha	quirológico+A+DIM+F+SG
quirologiquinhas	quirológico+A+DIM+F+PL
quirologiquinho	quirológico+A+DIM+M+SG
quirologiquinhos	quirológico+A+DIM+M+PL
quirológica	quirológico+A+F+SG
quirológicas	quirológico+A+F+PL
quirológico	quirológico+A+M+SG
quirológicos	quirológico+A+M+PL
quironomicazinha	quironómico+A+DIM+F+SG
quironomicazinhas	quironómico+A+DIM+F+PL
quironomicozinho	quironómico+A+DIM+M+SG
quironomicozinhos	quironómico+A+DIM+M+PL
quironomiquinha	quironómico+A+DIM+F+SG
quironomiquinhas	quironómico+A+DIM+F+PL
quironomiquinho	quironómico+A+DIM+M+SG
quironomiquinhos	quironómico+A+DIM+M+PL
quironómica	quironómico+A+F+SG
quironómicas	quironómico+A+F+PL
quironómico	quironómico+A+M+SG
quironómicos	quironómico+A+M+PL
quironomicazinha	quironômico+A+DIM+F+SG
quironomicazinhas	quironômico+A+DIM+F+PL
quironomicozinho	quironômico+A+DIM+M+SG
quironomicozinhos	quironômico+A+DIM+M+PL
quironomiquinha	quironômico+A+DIM+F+SG
quironomiquinhas	quironômico+A+DIM+F+PL
quironomiquinho	quironômico+A+DIM+M+SG
quironomiquinhos	quironômico+A+DIM+M+PL
quironômica	quironômico+A+F+SG
quironômicas	quironômico+A+F+PL
quironômico	quironômico+A+M+SG
quironômicos	quironômico+A+M+PL
quiropterofilazinha	quiropterófilo+A+DIM+F+SG
quiropterofilazinhas	quiropterófilo+A+DIM+F+PL
quiropterofilinha	quiropterófilo+A+DIM+F+SG
quiropterofilinhas	quiropterófilo+A+DIM+F+PL
quiropterofilinho	quiropterófilo+A+DIM+M+SG
quiropterofilinhos	quiropterófilo+A+DIM+M+PL
quiropterofilozinho	quiropterófilo+A+DIM+M+SG
quiropterofilozinhos	quiropterófilo+A+DIM+M+PL
quiropterófila	quiropterófilo+A+F+SG
quiropterófilas	quiropterófilo+A+F+PL
quiropterófilo	quiropterófilo+A+M+SG
quiropterófilos	quiropterófilo+A+M+PL
quirotonicazinha	quirotónico+A+DIM+F+SG
quirotonicazinhas	quirotónico+A+DIM+F+PL
quirotonicozinho	quirotónico+A+DIM+M+SG
quirotonicozinhos	quirotónico+A+DIM+M+PL
quirotoniquinha	quirotónico+A+DIM+F+SG
quirotoniquinhas	quirotónico+A+DIM+F+PL
quirotoniquinho	quirotónico+A+DIM+M+SG
quirotoniquinhos	quirotónico+A+DIM+M+PL
quirotónica	quirotónico+A+F+SG
quirotónicas	quirotónico+A+F+PL
quirotónico	quirotónico+A+M+SG
quirotónicos	quirotónico+A+M+PL
quirotonicazinha	quirotônico+A+DIM+F+SG
quirotonicazinhas	quirotônico+A+DIM+F+PL
quirotonicozinho	quirotônico+A+DIM+M+SG
quirotonicozinhos	quirotônico+A+DIM+M+PL
quirotoniquinha	quirotônico+A+DIM+F+SG
quirotoniquinhas	quirotônico+A+DIM+F+PL
quirotoniquinho	quirotônico+A+DIM+M+SG
quirotoniquinhos	quirotônico+A+DIM+M+PL
quirotônica	quirotônico+A+F+SG
quirotônicas	quirotônico+A+F+PL
quirotônico	quirotônico+A+M+SG
quirotônicos	quirotônico+A+M+PL
quiralgicazinha	quirálgico+A+DIM+F+SG
quiralgicazinhas	quirálgico+A+DIM+F+PL
quiralgicozinho	quirálgico+A+DIM+M+SG
quiralgicozinhos	quirálgico+A+DIM+M+PL
quiralgiquinha	quirálgico+A+DIM+F+SG
quiralgiquinhas	quirálgico+A+DIM+F+PL
quiralgiquinho	quirálgico+A+DIM+M+SG
quiralgiquinhos	quirálgico+A+DIM+M+PL
quirálgica	quirálgico+A+F+SG
quirálgicas	quirálgico+A+F+PL
quirálgico	quirálgico+A+M+SG
quirálgicos	quirálgico+A+M+PL
quiropterazinha	quiróptero+A+DIM+F+SG
quiropterazinhas	quiróptero+A+DIM+F+PL
quiropterinha	quiróptero+A+DIM+F+SG
quiropterinhas	quiróptero+A+DIM+F+PL
quiropterinho	quiróptero+A+DIM+M+SG
quiropterinhos	quiróptero+A+DIM+M+PL
quiropterozinho	quiróptero+A+DIM+M+SG
quiropterozinhos	quiróptero+A+DIM+M+PL
quiróptera	quiróptero+A+F+SG
quirópteras	quiróptero+A+F+PL
quiróptero	quiróptero+A+M+SG
quirópteros	quiróptero+A+M+PL
quista	quisto+A+F+SG
quistas	quisto+A+F+PL
quistazinha	quisto+A+DIM+F+SG
quistazinhas	quisto+A+DIM+F+PL
quistinha	quisto+A+DIM+F+SG
quistinhas	quisto+A+DIM+F+PL
quistinho	quisto+A+DIM+M+SG
quistinhos	quisto+A+DIM+M+PL
quisto	quisto+A+M+SG
quistos	quisto+A+M+PL
quistozinho	quisto+A+DIM+M+SG
quistozinhos	quisto+A+DIM+M+PL
quistosa	quistoso+A+F+SG
quistosas	quistoso+A+F+PL
quistosazinha	quistoso+A+DIM+F+SG
quistosazinhas	quistoso+A+DIM+F+PL
quistosinha	quistoso+A+DIM+F+SG
quistosinhas	quistoso+A+DIM+F+PL
quistosinho	quistoso+A+DIM+M+SG
quistosinhos	quistoso+A+DIM+M+PL
quistoso	quistoso+A+M+SG
quistosos	quistoso+A+M+PL
quistosozinho	quistoso+A+DIM+M+SG
quistosozinhos	quistoso+A+DIM+M+PL
quitador	quitador+A+M+SG
quitadora	quitador+A+F+SG
quitadoras	quitador+A+F+PL
quitadorazinha	quitador+A+DIM+F+SG
quitadorazinhas	quitador+A+DIM+F+PL
quitadores	quitador+A+M+PL
quitadorezinhos	quitador+A+DIM+M+PL
quitadorinha	quitador+A+DIM+F+SG
quitadorinhas	quitador+A+DIM+F+PL
quitadorzinho	quitador+A+DIM+M+SG
quitadorzinhos	quitador+A+DIM+M+PL
quitandaveizinhas	quitandável+A+DIM+F+PL
quitandaveizinhos	quitandável+A+DIM+M+PL
quitandavelzinha	quitandável+A+DIM+F+SG
quitandavelzinho	quitandável+A+DIM+M+SG
quitandáveis	quitandável+A+PL
quitandável	quitandável+A+SG
quite	quite+A+SG
quites	quite+A+PL
quitezinha	quite+A+DIM+F+SG
quitezinhas	quite+A+DIM+F+PL
quitezinho	quite+A+DIM+M+SG
quitezinhos	quite+A+DIM+M+PL
quitinha	quite+A+DIM+F+SG
quitinhas	quite+A+DIM+F+PL
quitinho	quite+A+DIM+M+SG
quitinhos	quite+A+DIM+M+PL
quitinosa	quitinoso+A+F+SG
quitinosas	quitinoso+A+F+PL
quitinosazinha	quitinoso+A+DIM+F+SG
quitinosazinhas	quitinoso+A+DIM+F+PL
quitinosinha	quitinoso+A+DIM+F+SG
quitinosinhas	quitinoso+A+DIM+F+PL
quitinosinho	quitinoso+A+DIM+M+SG
quitinosinhos	quitinoso+A+DIM+M+PL
quitinoso	quitinoso+A+M+SG
quitinosos	quitinoso+A+M+PL
quitinosozinho	quitinoso+A+DIM+M+SG
quitinosozinhos	quitinoso+A+DIM+M+PL
quituteira	quituteiro+A+F+SG
quituteiras	quituteiro+A+F+PL
quituteirazinha	quituteiro+A+DIM+F+SG
quituteirazinhas	quituteiro+A+DIM+F+PL
quituteirinha	quituteiro+A+DIM+F+SG
quituteirinhas	quituteiro+A+DIM+F+PL
quituteirinho	quituteiro+A+DIM+M+SG
quituteirinhos	quituteiro+A+DIM+M+PL
quituteiro	quituteiro+A+M+SG
quituteiros	quituteiro+A+M+PL
quituteirozinho	quituteiro+A+DIM+M+SG
quituteirozinhos	quituteiro+A+DIM+M+PL
quitaveizinhas	quitável+A+DIM+F+PL
quitaveizinhos	quitável+A+DIM+M+PL
quitavelzinha	quitável+A+DIM+F+SG
quitavelzinho	quitável+A+DIM+M+SG
quitáveis	quitável+A+PL
quitável	quitável+A+SG
quixotesca	quixotesco+A+F+SG
quixotescas	quixotesco+A+F+PL
quixotescazinha	quixotesco+A+DIM+F+SG
quixotescazinhas	quixotesco+A+DIM+F+PL
quixotesco	quixotesco+A+M+SG
quixotescos	quixotesco+A+M+PL
quixotescozinho	quixotesco+A+DIM+M+SG
quixotescozinhos	quixotesco+A+DIM+M+PL
quixotesquinha	quixotesco+A+DIM+F+SG
quixotesquinhas	quixotesco+A+DIM+F+PL
quixotesquinho	quixotesco+A+DIM+M+SG
quixotesquinhos	quixotesco+A+DIM+M+PL
quizilenta	quizilento+A+F+SG
quizilentas	quizilento+A+F+PL
quizilentazinha	quizilento+A+DIM+F+SG
quizilentazinhas	quizilento+A+DIM+F+PL
quizilentinha	quizilento+A+DIM+F+SG
quizilentinhas	quizilento+A+DIM+F+PL
quizilentinho	quizilento+A+DIM+M+SG
quizilentinhos	quizilento+A+DIM+M+PL
quizilento	quizilento+A+M+SG
quizilentos	quizilento+A+M+PL
quizilentozinho	quizilento+A+DIM+M+SG
quizilentozinhos	quizilento+A+DIM+M+PL
quizilaveizinhas	quizilável+A+DIM+F+PL
quizilaveizinhos	quizilável+A+DIM+M+PL
quizilavelzinha	quizilável+A+DIM+F+SG
quizilavelzinho	quizilável+A+DIM+M+SG
quiziláveis	quizilável+A+PL
quizilável	quizilável+A+SG
quiçamaense	quiçamaense+A+SG
quiçamaenses	quiçamaense+A+PL
quiçamaensezinha	quiçamaense+A+DIM+F+SG
quiçamaensezinhas	quiçamaense+A+DIM+F+PL
quiçamaensezinho	quiçamaense+A+DIM+M+SG
quiçamaensezinhos	quiçamaense+A+DIM+M+PL
quiçamaensinha	quiçamaense+A+DIM+F+SG
quiçamaensinhas	quiçamaense+A+DIM+F+PL
quiçamaensinho	quiçamaense+A+DIM+M+SG
quiçamaensinhos	quiçamaense+A+DIM+M+PL
quiçamanense	quiçamanense+A+SG
quiçamanenses	quiçamanense+A+PL
quiçamanensezinha	quiçamanense+A+DIM+F+SG
quiçamanensezinhas	quiçamanense+A+DIM+F+PL
quiçamanensezinho	quiçamanense+A+DIM+M+SG
quiçamanensezinhos	quiçamanense+A+DIM+M+PL
quiçamanensinha	quiçamanense+A+DIM+F+SG
quiçamanensinhas	quiçamanense+A+DIM+F+PL
quiçamanensinho	quiçamanense+A+DIM+M+SG
quiçamanensinhos	quiçamanense+A+DIM+M+PL
quinho	quo+A+DIM+SG
quinhos	quo+A+DIM+PL
quo	quo+A
quozinha	quo+A+DIM+F+SG
quozinhas	quo+A+DIM+F+PL
quozinho	quo+A+DIM+M+SG
quozinhos	quo+A+DIM+M+PL
quorum	quorum+A
quorunzinha	quorum+A+DIM+F+SG
quorunzinhas	quorum+A+DIM+F+PL
quorunzinho	quorum+A+DIM+M+SG
quorunzinhos	quorum+A+DIM+M+PL
quotidiana	quotidiano+A+F+SG
quotidianas	quotidiano+A+F+PL
quotidianazinha	quotidiano+A+DIM+F+SG
quotidianazinhas	quotidiano+A+DIM+F+PL
quotidianinha	quotidiano+A+DIM+F+SG
quotidianinhas	quotidiano+A+DIM+F+PL
quotidianinho	quotidiano+A+DIM+M+SG
quotidianinhos	quotidiano+A+DIM+M+PL
quotidiano	quotidiano+A+M+SG
quotidianos	quotidiano+A+M+PL
quotidianozinho	quotidiano+A+DIM+M+SG
quotidianozinhos	quotidiano+A+DIM+M+PL
quotista	quotista+A+SG
quotistas	quotista+A+PL
quotistazinha	quotista+A+DIM+F+SG
quotistazinhas	quotista+A+DIM+F+PL
quotistazinho	quotista+A+DIM+M+SG
quotistazinhos	quotista+A+DIM+M+PL
quotistinha	quotista+A+DIM+SG
quotistinhas	quotista+A+DIM+PL
quotizaveizinhas	quotizável+A+DIM+F+PL
quotizaveizinhos	quotizável+A+DIM+M+PL
quotizavelzinha	quotizável+A+DIM+F+SG
quotizavelzinho	quotizável+A+DIM+M+SG
quotizáveis	quotizável+A+PL
quotizável	quotizável+A+SG
quanticazinha	quântico+A+DIM+F+SG
quanticazinhas	quântico+A+DIM+F+PL
quanticozinho	quântico+A+DIM+M+SG
quanticozinhos	quântico+A+DIM+M+PL
quantiquinha	quântico+A+DIM+F+SG
quantiquinhas	quântico+A+DIM+F+PL
quantiquinho	quântico+A+DIM+M+SG
quantiquinhos	quântico+A+DIM+M+PL
quântica	quântico+A+F+SG
quânticas	quântico+A+F+PL
quântico	quântico+A+M+SG
quânticos	quântico+A+M+PL
quechuazinha	quéchua+A+DIM+F+SG
quechuazinhas	quéchua+A+DIM+F+PL
quechuazinho	quéchua+A+DIM+M+SG
quechuazinhos	quéchua+A+DIM+M+PL
quechuinha	quéchua+A+DIM+SG
quechuinhas	quéchua+A+DIM+PL
quéchua	quéchua+A+SG
quéchuas	quéchua+A+PL
querablezinha	quérable+A+DIM+F+SG
querablezinho	quérable+A+DIM+M+SG
querablinha	quérable+A+DIM+F+SG
querablinhas	quérable+A+DIM+F+PL
querablinho	quérable+A+DIM+M+SG
querablinhos	quérable+A+DIM+M+PL
quérable	quérable+A+SG
querulazinha	quérulo+A+DIM+F+SG
querulazinhas	quérulo+A+DIM+F+PL
querulinha	quérulo+A+DIM+F+SG
querulinhas	quérulo+A+DIM+F+PL
querulinho	quérulo+A+DIM+M+SG
querulinhos	quérulo+A+DIM+M+PL
querulozinho	quérulo+A+DIM+M+SG
querulozinhos	quérulo+A+DIM+M+PL
quérula	quérulo+A+F+SG
quérulas	quérulo+A+F+PL
quérulo	quérulo+A+M+SG
quérulos	quérulo+A+M+PL
quichuazinha	quíchua+A+DIM+F+SG
quichuazinhas	quíchua+A+DIM+F+PL
quichuazinho	quíchua+A+DIM+M+SG
quichuazinhos	quíchua+A+DIM+M+PL
quichuinha	quíchua+A+DIM+SG
quichuinhas	quíchua+A+DIM+PL
quíchua	quíchua+A+SG
quíchuas	quíchua+A+PL
quimicazinha	químico+A+DIM+F+SG
quimicazinhas	químico+A+DIM+F+PL
quimicozinho	químico+A+DIM+M+SG
quimicozinhos	químico+A+DIM+M+PL
quimiquinha	químico+A+DIM+F+SG
quimiquinhas	químico+A+DIM+F+PL
quimiquinho	químico+A+DIM+M+SG
quimiquinhos	químico+A+DIM+M+PL
química	químico+A+F+SG
químicas	químico+A+F+PL
químico	químico+A+M+SG
químicos	químico+A+M+PL
químico-fisicozinho	químico-físico+A+DIM+M+SG
químico-fisicozinhos	químico-físico+A+DIM+M+PL
químico-fisiquinho	químico-físico+A+DIM+M+SG
químico-fisiquinhos	químico-físico+A+DIM+M+PL
químico-físico	químico-físico+A+M+SG
químico-físicos	químico-físico+A+M+PL
químico-industriais	químico-industrial+A+PL
químico-industriaizinhas	químico-industrial+A+DIM+F+PL
químico-industriaizinhos	químico-industrial+A+DIM+M+PL
químico-industrial	químico-industrial+A+SG
químico-industrialzinha	químico-industrial+A+DIM+F+SG
químico-industrialzinho	químico-industrial+A+DIM+M+SG
quintuplazinha	quíntuplo+A+DIM+F+SG
quintuplazinhas	quíntuplo+A+DIM+F+PL
quintuplinha	quíntuplo+A+DIM+F+SG
quintuplinhas	quíntuplo+A+DIM+F+PL
quintuplinho	quíntuplo+A+DIM+M+SG
quintuplinhos	quíntuplo+A+DIM+M+PL
quintuplozinho	quíntuplo+A+DIM+M+SG
quintuplozinhos	quíntuplo+A+DIM+M+PL
quíntupla	quíntuplo+A+F+SG
quíntuplas	quíntuplo+A+F+PL
quíntuplo	quíntuplo+A+M+SG
quíntuplos	quíntuplo+A+M+PL
quisticazinha	quístico+A+DIM+F+SG
quisticazinhas	quístico+A+DIM+F+PL
quisticozinho	quístico+A+DIM+M+SG
quisticozinhos	quístico+A+DIM+M+PL
quistiquinha	quístico+A+DIM+F+SG
quistiquinhas	quístico+A+DIM+F+PL
quistiquinho	quístico+A+DIM+M+SG
quistiquinhos	quístico+A+DIM+M+PL
quística	quístico+A+F+SG
quísticas	quístico+A+F+PL
quístico	quístico+A+M+SG
quísticos	quístico+A+M+PL
qüinqüeangular	qüinqüeangular+A+SG
qüinqüeangulares	qüinqüeangular+A+PL
qüinqüeangularezinhas	qüinqüeangular+A+DIM+F+PL
qüinqüeangularezinhos	qüinqüeangular+A+DIM+M+PL
qüinqüeangularzinha	qüinqüeangular+A+DIM+F+SG
qüinqüeangularzinhas	qüinqüeangular+A+DIM+F+PL
qüinqüeangularzinho	qüinqüeangular+A+DIM+M+SG
qüinqüeangularzinhos	qüinqüeangular+A+DIM+M+PL
qüinqüecapsular	qüinqüecapsular+A+SG
qüinqüecapsulares	qüinqüecapsular+A+PL
qüinqüecapsularezinhas	qüinqüecapsular+A+DIM+F+PL
qüinqüecapsularezinhos	qüinqüecapsular+A+DIM+M+PL
qüinqüecapsularzinha	qüinqüecapsular+A+DIM+F+SG
qüinqüecapsularzinhas	qüinqüecapsular+A+DIM+F+PL
qüinqüecapsularzinho	qüinqüecapsular+A+DIM+M+SG
qüinqüecapsularzinhos	qüinqüecapsular+A+DIM+M+PL
qüinqüedentada	qüinqüedentado+A+F+SG
qüinqüedentadas	qüinqüedentado+A+F+PL
qüinqüedentadazinha	qüinqüedentado+A+DIM+F+SG
qüinqüedentadazinhas	qüinqüedentado+A+DIM+F+PL
qüinqüedentadinha	qüinqüedentado+A+DIM+F+SG
qüinqüedentadinhas	qüinqüedentado+A+DIM+F+PL
qüinqüedentadinho	qüinqüedentado+A+DIM+M+SG
qüinqüedentadinhos	qüinqüedentado+A+DIM+M+PL
qüinqüedentado	qüinqüedentado+A+M+SG
qüinqüedentados	qüinqüedentado+A+M+PL
qüinqüedentadozinho	qüinqüedentado+A+DIM+M+SG
qüinqüedentadozinhos	qüinqüedentado+A+DIM+M+PL
qüinqüedigitada	qüinqüedigitado+A+F+SG
qüinqüedigitadas	qüinqüedigitado+A+F+PL
qüinqüedigitadazinha	qüinqüedigitado+A+DIM+F+SG
qüinqüedigitadazinhas	qüinqüedigitado+A+DIM+F+PL
qüinqüedigitadinha	qüinqüedigitado+A+DIM+F+SG
qüinqüedigitadinhas	qüinqüedigitado+A+DIM+F+PL
qüinqüedigitadinho	qüinqüedigitado+A+DIM+M+SG
qüinqüedigitadinhos	qüinqüedigitado+A+DIM+M+PL
qüinqüedigitado	qüinqüedigitado+A+M+SG
qüinqüedigitados	qüinqüedigitado+A+M+PL
qüinqüedigitadozinho	qüinqüedigitado+A+DIM+M+SG
qüinqüedigitadozinhos	qüinqüedigitado+A+DIM+M+PL
qüinqüefoliada	qüinqüefoliado+A+F+SG
qüinqüefoliadas	qüinqüefoliado+A+F+PL
qüinqüefoliadazinha	qüinqüefoliado+A+DIM+F+SG
qüinqüefoliadazinhas	qüinqüefoliado+A+DIM+F+PL
qüinqüefoliadinha	qüinqüefoliado+A+DIM+F+SG
qüinqüefoliadinhas	qüinqüefoliado+A+DIM+F+PL
qüinqüefoliadinho	qüinqüefoliado+A+DIM+M+SG
qüinqüefoliadinhos	qüinqüefoliado+A+DIM+M+PL
qüinqüefoliado	qüinqüefoliado+A+M+SG
qüinqüefoliados	qüinqüefoliado+A+M+PL
qüinqüefoliadozinho	qüinqüefoliado+A+DIM+M+SG
qüinqüefoliadozinhos	qüinqüefoliado+A+DIM+M+PL
qüinqüefoliazinha	qüinqüefólio+A+DIM+F+SG
qüinqüefoliazinhas	qüinqüefólio+A+DIM+F+PL
qüinqüefolinha	qüinqüefólio+A+DIM+F+SG
qüinqüefolinhas	qüinqüefólio+A+DIM+F+PL
qüinqüefolinho	qüinqüefólio+A+DIM+M+SG
qüinqüefolinhos	qüinqüefólio+A+DIM+M+PL
qüinqüefoliozinho	qüinqüefólio+A+DIM+M+SG
qüinqüefoliozinhos	qüinqüefólio+A+DIM+M+PL
qüinqüefólia	qüinqüefólio+A+F+SG
qüinqüefólias	qüinqüefólio+A+F+PL
qüinqüefólio	qüinqüefólio+A+M+SG
qüinqüefólios	qüinqüefólio+A+M+PL
qüinqüelobada	qüinqüelobado+A+F+SG
qüinqüelobadas	qüinqüelobado+A+F+PL
qüinqüelobadazinha	qüinqüelobado+A+DIM+F+SG
qüinqüelobadazinhas	qüinqüelobado+A+DIM+F+PL
qüinqüelobadinha	qüinqüelobado+A+DIM+F+SG
qüinqüelobadinhas	qüinqüelobado+A+DIM+F+PL
qüinqüelobadinho	qüinqüelobado+A+DIM+M+SG
qüinqüelobadinhos	qüinqüelobado+A+DIM+M+PL
qüinqüelobado	qüinqüelobado+A+M+SG
qüinqüelobados	qüinqüelobado+A+M+PL
qüinqüelobadozinho	qüinqüelobado+A+DIM+M+SG
qüinqüelobadozinhos	qüinqüelobado+A+DIM+M+PL
qüinqüelocular	qüinqüelocular+A+SG
qüinqüeloculares	qüinqüelocular+A+PL
qüinqüelocularezinhas	qüinqüelocular+A+DIM+F+PL
qüinqüelocularezinhos	qüinqüelocular+A+DIM+M+PL
qüinqüelocularzinha	qüinqüelocular+A+DIM+F+SG
qüinqüelocularzinhas	qüinqüelocular+A+DIM+F+PL
qüinqüelocularzinho	qüinqüelocular+A+DIM+M+SG
qüinqüelocularzinhos	qüinqüelocular+A+DIM+M+PL
qüinqüelingüezinha	qüinqüelíngüe+A+DIM+F+SG
qüinqüelingüezinhas	qüinqüelíngüe+A+DIM+F+PL
qüinqüelingüezinho	qüinqüelíngüe+A+DIM+M+SG
qüinqüelingüezinhos	qüinqüelíngüe+A+DIM+M+PL
qüinqüelingüinha	qüinqüelíngüe+A+DIM+F+SG
qüinqüelingüinhas	qüinqüelíngüe+A+DIM+F+PL
qüinqüelingüinho	qüinqüelíngüe+A+DIM+M+SG
qüinqüelingüinhos	qüinqüelíngüe+A+DIM+M+PL
qüinqüelíngüe	qüinqüelíngüe+A+SG
qüinqüelíngües	qüinqüelíngüe+A+PL
qüinqüenais	qüinqüenal+A+PL
qüinqüenaizinhas	qüinqüenal+A+DIM+F+PL
qüinqüenaizinhos	qüinqüenal+A+DIM+M+PL
qüinqüenal	qüinqüenal+A+SG
qüinqüenalzinha	qüinqüenal+A+DIM+F+SG
qüinqüenalzinho	qüinqüenal+A+DIM+M+SG
qüinqüeovulada	qüinqüeovulado+A+F+SG
qüinqüeovuladas	qüinqüeovulado+A+F+PL
qüinqüeovuladazinha	qüinqüeovulado+A+DIM+F+SG
qüinqüeovuladazinhas	qüinqüeovulado+A+DIM+F+PL
qüinqüeovuladinha	qüinqüeovulado+A+DIM+F+SG
qüinqüeovuladinhas	qüinqüeovulado+A+DIM+F+PL
qüinqüeovuladinho	qüinqüeovulado+A+DIM+M+SG
qüinqüeovuladinhos	qüinqüeovulado+A+DIM+M+PL
qüinqüeovulado	qüinqüeovulado+A+M+SG
qüinqüeovulados	qüinqüeovulado+A+M+PL
qüinqüeovuladozinho	qüinqüeovulado+A+DIM+M+SG
qüinqüeovuladozinhos	qüinqüeovulado+A+DIM+M+PL
qüinqüevalve	qüinqüevalve+A+SG
qüinqüevalves	qüinqüevalve+A+PL
qüinqüevalvezinha	qüinqüevalve+A+DIM+F+SG
qüinqüevalvezinhas	qüinqüevalve+A+DIM+F+PL
qüinqüevalvezinho	qüinqüevalve+A+DIM+M+SG
qüinqüevalvezinhos	qüinqüevalve+A+DIM+M+PL
qüinqüevalvinha	qüinqüevalve+A+DIM+F+SG
qüinqüevalvinhas	qüinqüevalve+A+DIM+F+PL
qüinqüevalvinho	qüinqüevalve+A+DIM+M+SG
qüinqüevalvinhos	qüinqüevalve+A+DIM+M+PL
qüinqüevalvular	qüinqüevalvular+A+SG
qüinqüevalvulares	qüinqüevalvular+A+PL
qüinqüevalvularezinhas	qüinqüevalvular+A+DIM+F+PL
qüinqüevalvularezinhos	qüinqüevalvular+A+DIM+M+PL
qüinqüevalvularzinha	qüinqüevalvular+A+DIM+F+SG
qüinqüevalvularzinhas	qüinqüevalvular+A+DIM+F+PL
qüinqüevalvularzinho	qüinqüevalvular+A+DIM+M+SG
qüinqüevalvularzinhos	qüinqüevalvular+A+DIM+M+PL
