yamaskiticazinha	yamaskítico+A+DIM+F+SG
yamaskiticazinhas	yamaskítico+A+DIM+F+PL
yamaskiticozinho	yamaskítico+A+DIM+M+SG
yamaskiticozinhos	yamaskítico+A+DIM+M+PL
yamaskitiquinha	yamaskítico+A+DIM+F+SG
yamaskitiquinhas	yamaskítico+A+DIM+F+PL
yamaskitiquinho	yamaskítico+A+DIM+M+SG
yamaskitiquinhos	yamaskítico+A+DIM+M+PL
yamaskítica	yamaskítico+A+F+SG
yamaskíticas	yamaskítico+A+F+PL
yamaskítico	yamaskítico+A+M+SG
yamaskíticos	yamaskítico+A+M+PL
yeatsiana	yeatsiano+A+F+SG
yeatsianas	yeatsiano+A+F+PL
yeatsianazinha	yeatsiano+A+DIM+F+SG
yeatsianazinhas	yeatsiano+A+DIM+F+PL
yeatsianinha	yeatsiano+A+DIM+F+SG
yeatsianinhas	yeatsiano+A+DIM+F+PL
yeatsianinho	yeatsiano+A+DIM+M+SG
yeatsianinhos	yeatsiano+A+DIM+M+PL
yeatsiano	yeatsiano+A+M+SG
yeatsianos	yeatsiano+A+M+PL
yeatsianozinho	yeatsiano+A+DIM+M+SG
yeatsianozinhos	yeatsiano+A+DIM+M+PL
yorkense	yorkense+A+SG
yorkenses	yorkense+A+PL
yorkensezinha	yorkense+A+DIM+F+SG
yorkensezinhas	yorkense+A+DIM+F+PL
yorkensezinho	yorkense+A+DIM+M+SG
yorkensezinhos	yorkense+A+DIM+M+PL
yorkensinha	yorkense+A+DIM+F+SG
yorkensinhas	yorkense+A+DIM+F+PL
yorkensinho	yorkense+A+DIM+M+SG
yorkensinhos	yorkense+A+DIM+M+PL
yorkina	yorkino+A+F+SG
yorkinas	yorkino+A+F+PL
yorkinazinha	yorkino+A+DIM+F+SG
yorkinazinhas	yorkino+A+DIM+F+PL
yorkininha	yorkino+A+DIM+F+SG
yorkininhas	yorkino+A+DIM+F+PL
yorkininho	yorkino+A+DIM+M+SG
yorkininhos	yorkino+A+DIM+M+PL
yorkino	yorkino+A+M+SG
yorkinos	yorkino+A+M+PL
yorkinozinho	yorkino+A+DIM+M+SG
yorkinozinhos	yorkino+A+DIM+M+PL
ytterbiticazinha	ytterbítico+A+DIM+F+SG
ytterbiticazinhas	ytterbítico+A+DIM+F+PL
ytterbiticozinho	ytterbítico+A+DIM+M+SG
ytterbiticozinhos	ytterbítico+A+DIM+M+PL
ytterbitiquinha	ytterbítico+A+DIM+F+SG
ytterbitiquinhas	ytterbítico+A+DIM+F+PL
ytterbitiquinho	ytterbítico+A+DIM+M+SG
ytterbitiquinhos	ytterbítico+A+DIM+M+PL
ytterbítica	ytterbítico+A+F+SG
ytterbíticas	ytterbítico+A+F+PL
ytterbítico	ytterbítico+A+M+SG
ytterbíticos	ytterbítico+A+M+PL
yttroceriticazinha	yttrocerítico+A+DIM+F+SG
yttroceriticazinhas	yttrocerítico+A+DIM+F+PL
yttroceriticozinho	yttrocerítico+A+DIM+M+SG
yttroceriticozinhos	yttrocerítico+A+DIM+M+PL
yttroceritiquinha	yttrocerítico+A+DIM+F+SG
yttroceritiquinhas	yttrocerítico+A+DIM+F+PL
yttroceritiquinho	yttrocerítico+A+DIM+M+SG
yttroceritiquinhos	yttrocerítico+A+DIM+M+PL
yttrocerítica	yttrocerítico+A+F+SG
yttroceríticas	yttrocerítico+A+F+PL
yttrocerítico	yttrocerítico+A+M+SG
yttroceríticos	yttrocerítico+A+M+PL
yttrocrasiticazinha	yttrocrasítico+A+DIM+F+SG
yttrocrasiticazinhas	yttrocrasítico+A+DIM+F+PL
yttrocrasiticozinho	yttrocrasítico+A+DIM+M+SG
yttrocrasiticozinhos	yttrocrasítico+A+DIM+M+PL
yttrocrasitiquinha	yttrocrasítico+A+DIM+F+SG
yttrocrasitiquinhas	yttrocrasítico+A+DIM+F+PL
yttrocrasitiquinho	yttrocrasítico+A+DIM+M+SG
yttrocrasitiquinhos	yttrocrasítico+A+DIM+M+PL
yttrocrasítica	yttrocrasítico+A+F+SG
yttrocrasíticas	yttrocrasítico+A+F+PL
yttrocrasítico	yttrocrasítico+A+M+SG
yttrocrasíticos	yttrocrasítico+A+M+PL
yttrofluoriticazinha	yttrofluorítico+A+DIM+F+SG
yttrofluoriticazinhas	yttrofluorítico+A+DIM+F+PL
yttrofluoriticozinho	yttrofluorítico+A+DIM+M+SG
yttrofluoriticozinhos	yttrofluorítico+A+DIM+M+PL
yttrofluoritiquinha	yttrofluorítico+A+DIM+F+SG
yttrofluoritiquinhas	yttrofluorítico+A+DIM+F+PL
yttrofluoritiquinho	yttrofluorítico+A+DIM+M+SG
yttrofluoritiquinhos	yttrofluorítico+A+DIM+M+PL
yttrofluorítica	yttrofluorítico+A+F+SG
yttrofluoríticas	yttrofluorítico+A+F+PL
yttrofluorítico	yttrofluorítico+A+M+SG
yttrofluoríticos	yttrofluorítico+A+M+PL
yuppie	yuppie+A+SG
yuppies	yuppie+A+PL
yuppiezinha	yuppie+A+DIM+F+SG
yuppiezinhas	yuppie+A+DIM+F+PL
yuppiezinho	yuppie+A+DIM+M+SG
yuppiezinhos	yuppie+A+DIM+M+PL
yuppinha	yuppie+A+DIM+F+SG
yuppinhas	yuppie+A+DIM+F+PL
yuppinho	yuppie+A+DIM+M+SG
yuppinhos	yuppie+A+DIM+M+PL
