xaboca	xaboco+A+F+SG
xabocas	xaboco+A+F+PL
xabocazinha	xaboco+A+DIM+F+SG
xabocazinhas	xaboco+A+DIM+F+PL
xaboco	xaboco+A+M+SG
xabocos	xaboco+A+M+PL
xabocozinho	xaboco+A+DIM+M+SG
xabocozinhos	xaboco+A+DIM+M+PL
xaboquinha	xaboco+A+DIM+F+SG
xaboquinhas	xaboco+A+DIM+F+PL
xaboquinho	xaboco+A+DIM+M+SG
xaboquinhos	xaboco+A+DIM+M+PL
xabouca	xabouco+A+F+SG
xaboucas	xabouco+A+F+PL
xaboucazinha	xabouco+A+DIM+F+SG
xaboucazinhas	xabouco+A+DIM+F+PL
xabouco	xabouco+A+M+SG
xaboucos	xabouco+A+M+PL
xaboucozinho	xabouco+A+DIM+M+SG
xaboucozinhos	xabouco+A+DIM+M+PL
xabouquinha	xabouco+A+DIM+F+SG
xabouquinhas	xabouco+A+DIM+F+PL
xabouquinho	xabouco+A+DIM+M+SG
xabouquinhos	xabouco+A+DIM+M+PL
xaboucaveizinhas	xaboucável+A+DIM+F+PL
xaboucaveizinhos	xaboucável+A+DIM+M+PL
xaboucavelzinha	xaboucável+A+DIM+F+SG
xaboucavelzinho	xaboucável+A+DIM+M+SG
xaboucáveis	xaboucável+A+PL
xaboucável	xaboucável+A+SG
xabouqueira	xabouqueiro+A+F+SG
xabouqueiras	xabouqueiro+A+F+PL
xabouqueirazinha	xabouqueiro+A+DIM+F+SG
xabouqueirazinhas	xabouqueiro+A+DIM+F+PL
xabouqueirinha	xabouqueiro+A+DIM+F+SG
xabouqueirinhas	xabouqueiro+A+DIM+F+PL
xabouqueirinho	xabouqueiro+A+DIM+M+SG
xabouqueirinhos	xabouqueiro+A+DIM+M+PL
xabouqueiro	xabouqueiro+A+M+SG
xabouqueiros	xabouqueiro+A+M+PL
xabouqueirozinho	xabouqueiro+A+DIM+M+SG
xabouqueirozinhos	xabouqueiro+A+DIM+M+PL
xabregana	xabregano+A+F+SG
xabreganas	xabregano+A+F+PL
xabreganazinha	xabregano+A+DIM+F+SG
xabreganazinhas	xabregano+A+DIM+F+PL
xabreganinha	xabregano+A+DIM+F+SG
xabreganinhas	xabregano+A+DIM+F+PL
xabreganinho	xabregano+A+DIM+M+SG
xabreganinhos	xabregano+A+DIM+M+PL
xabregano	xabregano+A+M+SG
xabreganos	xabregano+A+M+PL
xabreganozinho	xabregano+A+DIM+M+SG
xabreganozinhos	xabregano+A+DIM+M+PL
xabregas	xabregas+A
xabregasinha	xabregas+A+DIM+F+SG
xabregasinhas	xabregas+A+DIM+F+PL
xabregasinho	xabregas+A+DIM+M+SG
xabregasinhos	xabregas+A+DIM+M+PL
xaca	xaca+A+SG
xacas	xaca+A+PL
xacazinha	xaca+A+DIM+F+SG
xacazinhas	xaca+A+DIM+F+PL
xacazinho	xaca+A+DIM+M+SG
xacazinhos	xaca+A+DIM+M+PL
xaquinha	xaca+A+DIM+SG
xaquinhas	xaca+A+DIM+PL
xacamecra	xacamecra+A+SG
xacamecras	xacamecra+A+PL
xacamecrazinha	xacamecra+A+DIM+F+SG
xacamecrazinhas	xacamecra+A+DIM+F+PL
xacamecrazinho	xacamecra+A+DIM+M+SG
xacamecrazinhos	xacamecra+A+DIM+M+PL
xacamecrinha	xacamecra+A+DIM+SG
xacamecrinhas	xacamecra+A+DIM+PL
xacoca	xacoco+A+F+SG
xacocas	xacoco+A+F+PL
xacocazinha	xacoco+A+DIM+F+SG
xacocazinhas	xacoco+A+DIM+F+PL
xacoco	xacoco+A+M+SG
xacocos	xacoco+A+M+PL
xacocozinho	xacoco+A+DIM+M+SG
xacocozinhos	xacoco+A+DIM+M+PL
xacoquinha	xacoco+A+DIM+F+SG
xacoquinhas	xacoco+A+DIM+F+PL
xacoquinho	xacoco+A+DIM+M+SG
xacoquinhos	xacoco+A+DIM+M+PL
xacoteuzinha	xacotéu+A+DIM+F+SG
xacoteuzinhas	xacotéu+A+DIM+F+PL
xacoteuzinho	xacotéu+A+DIM+M+SG
xacoteuzinhos	xacotéu+A+DIM+M+PL
xacotéu	xacotéu+A+SG
xacotéus	xacotéu+A+PL
xacriabazinha	xacriabá+A+DIM+F+SG
xacriabazinhas	xacriabá+A+DIM+F+PL
xacriabazinho	xacriabá+A+DIM+M+SG
xacriabazinhos	xacriabá+A+DIM+M+PL
xacriabá	xacriabá+A+SG
xacriabás	xacriabá+A+PL
xadrez	xadrez+A
xadrezinha	xadrez+A+DIM+F+SG
xadrezinhas	xadrez+A+DIM+F+PL
xadrezinho	xadrez+A+DIM+M+SG
xadrezinhos	xadrez+A+DIM+M+PL
xadrezaveizinhas	xadrezável+A+DIM+F+PL
xadrezaveizinhos	xadrezável+A+DIM+M+PL
xadrezavelzinha	xadrezável+A+DIM+F+SG
xadrezavelzinho	xadrezável+A+DIM+M+SG
xadrezáveis	xadrezável+A+PL
xadrezável	xadrezável+A+SG
xaireis	xairel+A+PL
xaireizinhas	xairel+A+DIM+F+PL
xaireizinhos	xairel+A+DIM+M+PL
xairel	xairel+A+SG
xairelzinha	xairel+A+DIM+F+SG
xairelzinho	xairel+A+DIM+M+SG
xairelada	xairelado+A+F+SG
xaireladas	xairelado+A+F+PL
xaireladazinha	xairelado+A+DIM+F+SG
xaireladazinhas	xairelado+A+DIM+F+PL
xaireladinha	xairelado+A+DIM+F+SG
xaireladinhas	xairelado+A+DIM+F+PL
xaireladinho	xairelado+A+DIM+M+SG
xaireladinhos	xairelado+A+DIM+M+PL
xairelado	xairelado+A+M+SG
xairelados	xairelado+A+M+PL
xaireladozinho	xairelado+A+DIM+M+SG
xaireladozinhos	xairelado+A+DIM+M+PL
xalostociticazinha	xalostocítico+A+DIM+F+SG
xalostociticazinhas	xalostocítico+A+DIM+F+PL
xalostociticozinho	xalostocítico+A+DIM+M+SG
xalostociticozinhos	xalostocítico+A+DIM+M+PL
xalostocitiquinha	xalostocítico+A+DIM+F+SG
xalostocitiquinhas	xalostocítico+A+DIM+F+PL
xalostocitiquinho	xalostocítico+A+DIM+M+SG
xalostocitiquinhos	xalostocítico+A+DIM+M+PL
xalostocítica	xalostocítico+A+F+SG
xalostocíticas	xalostocítico+A+F+PL
xalostocítico	xalostocítico+A+M+SG
xalostocíticos	xalostocítico+A+M+PL
xalostoquiticazinha	xalostoquítico+A+DIM+F+SG
xalostoquiticazinhas	xalostoquítico+A+DIM+F+PL
xalostoquiticozinho	xalostoquítico+A+DIM+M+SG
xalostoquiticozinhos	xalostoquítico+A+DIM+M+PL
xalostoquitiquinha	xalostoquítico+A+DIM+F+SG
xalostoquitiquinhas	xalostoquítico+A+DIM+F+PL
xalostoquitiquinho	xalostoquítico+A+DIM+M+SG
xalostoquitiquinhos	xalostoquítico+A+DIM+M+PL
xalostoquítica	xalostoquítico+A+F+SG
xalostoquíticas	xalostoquítico+A+F+PL
xalostoquítico	xalostoquítico+A+M+SG
xalostoquíticos	xalostoquítico+A+M+PL
xama	xama+A+SG
xamas	xama+A+PL
xamazinha	xama+A+DIM+F+SG
xamazinhas	xama+A+DIM+F+PL
xamazinho	xama+A+DIM+M+SG
xamazinhos	xama+A+DIM+M+PL
xaminha	xama+A+DIM+SG
xaminhas	xama+A+DIM+PL
xamacoca	xamacoco+A+F+SG
xamacocas	xamacoco+A+F+PL
xamacocazinha	xamacoco+A+DIM+F+SG
xamacocazinhas	xamacoco+A+DIM+F+PL
xamacoco	xamacoco+A+M+SG
xamacocos	xamacoco+A+M+PL
xamacocozinho	xamacoco+A+DIM+M+SG
xamacocozinhos	xamacoco+A+DIM+M+PL
xamacoquinha	xamacoco+A+DIM+F+SG
xamacoquinhas	xamacoco+A+DIM+F+PL
xamacoquinho	xamacoco+A+DIM+M+SG
xamacoquinhos	xamacoco+A+DIM+M+PL
xamanista	xamanista+A+SG
xamanistas	xamanista+A+PL
xamanistazinha	xamanista+A+DIM+F+SG
xamanistazinhas	xamanista+A+DIM+F+PL
xamanistazinho	xamanista+A+DIM+M+SG
xamanistazinhos	xamanista+A+DIM+M+PL
xamanistinha	xamanista+A+DIM+SG
xamanistinhas	xamanista+A+DIM+PL
xamanisticazinha	xamanístico+A+DIM+F+SG
xamanisticazinhas	xamanístico+A+DIM+F+PL
xamanisticozinho	xamanístico+A+DIM+M+SG
xamanisticozinhos	xamanístico+A+DIM+M+PL
xamanistiquinha	xamanístico+A+DIM+F+SG
xamanistiquinhas	xamanístico+A+DIM+F+PL
xamanistiquinho	xamanístico+A+DIM+M+SG
xamanistiquinhos	xamanístico+A+DIM+M+PL
xamanística	xamanístico+A+F+SG
xamanísticas	xamanístico+A+F+PL
xamanístico	xamanístico+A+M+SG
xamanísticos	xamanístico+A+M+PL
xambioazense	xambioazense+A+SG
xambioazenses	xambioazense+A+PL
xambioazensezinha	xambioazense+A+DIM+F+SG
xambioazensezinhas	xambioazense+A+DIM+F+PL
xambioazensezinho	xambioazense+A+DIM+M+SG
xambioazensezinhos	xambioazense+A+DIM+M+PL
xambioazensinha	xambioazense+A+DIM+F+SG
xambioazensinhas	xambioazense+A+DIM+F+PL
xambioazensinho	xambioazense+A+DIM+M+SG
xambioazensinhos	xambioazense+A+DIM+M+PL
xambioense	xambioense+A+SG
xambioenses	xambioense+A+PL
xambioensezinha	xambioense+A+DIM+F+SG
xambioensezinhas	xambioense+A+DIM+F+PL
xambioensezinho	xambioense+A+DIM+M+SG
xambioensezinhos	xambioense+A+DIM+M+PL
xambioensinha	xambioense+A+DIM+F+SG
xambioensinhas	xambioense+A+DIM+F+PL
xambioensinho	xambioense+A+DIM+M+SG
xambioensinhos	xambioense+A+DIM+M+PL
xambioazinha	xambioá+A+DIM+F+SG
xambioazinhas	xambioá+A+DIM+F+PL
xambioazinho	xambioá+A+DIM+M+SG
xambioazinhos	xambioá+A+DIM+M+PL
xambioá	xambioá+A+SG
xambioás	xambioá+A+PL
xambivazinha	xambivá+A+DIM+F+SG
xambivazinhas	xambivá+A+DIM+F+PL
xambivazinho	xambivá+A+DIM+M+SG
xambivazinhos	xambivá+A+DIM+M+PL
xambivá	xambivá+A+SG
xambivás	xambivá+A+PL
xambouqueira	xambouqueiro+A+F+SG
xambouqueiras	xambouqueiro+A+F+PL
xambouqueirazinha	xambouqueiro+A+DIM+F+SG
xambouqueirazinhas	xambouqueiro+A+DIM+F+PL
xambouqueirinha	xambouqueiro+A+DIM+F+SG
xambouqueirinhas	xambouqueiro+A+DIM+F+PL
xambouqueirinho	xambouqueiro+A+DIM+M+SG
xambouqueirinhos	xambouqueiro+A+DIM+M+PL
xambouqueiro	xambouqueiro+A+M+SG
xambouqueiros	xambouqueiro+A+M+PL
xambouqueirozinho	xambouqueiro+A+DIM+M+SG
xambouqueirozinhos	xambouqueiro+A+DIM+M+PL
xambreense	xambreense+A+SG
xambreenses	xambreense+A+PL
xambreensezinha	xambreense+A+DIM+F+SG
xambreensezinhas	xambreense+A+DIM+F+PL
xambreensezinho	xambreense+A+DIM+M+SG
xambreensezinhos	xambreense+A+DIM+M+PL
xambreensinha	xambreense+A+DIM+F+SG
xambreensinhas	xambreense+A+DIM+F+PL
xambreensinho	xambreense+A+DIM+M+SG
xambreensinhos	xambreense+A+DIM+M+PL
xambregada	xambregado+A+F+SG
xambregadas	xambregado+A+F+PL
xambregadazinha	xambregado+A+DIM+F+SG
xambregadazinhas	xambregado+A+DIM+F+PL
xambregadinha	xambregado+A+DIM+F+SG
xambregadinhas	xambregado+A+DIM+F+PL
xambregadinho	xambregado+A+DIM+M+SG
xambregadinhos	xambregado+A+DIM+M+PL
xambregado	xambregado+A+M+SG
xambregados	xambregado+A+M+PL
xambregadozinho	xambregado+A+DIM+M+SG
xambregadozinhos	xambregado+A+DIM+M+PL
xangaense	xangaense+A+SG
xangaenses	xangaense+A+PL
xangaensezinha	xangaense+A+DIM+F+SG
xangaensezinhas	xangaense+A+DIM+F+PL
xangaensezinho	xangaense+A+DIM+M+SG
xangaensezinhos	xangaense+A+DIM+M+PL
xangaensinha	xangaense+A+DIM+F+SG
xangaensinhas	xangaense+A+DIM+F+PL
xangaensinho	xangaense+A+DIM+M+SG
xangaensinhos	xangaense+A+DIM+M+PL
xangaesinha	xangaês+A+DIM+F+SG
xangaesinhas	xangaês+A+DIM+F+PL
xangaesinho	xangaês+A+DIM+M+SG
xangaesinhos	xangaês+A+DIM+M+PL
xangaês	xangaês+A+SG
xangaêss	xangaês+A+PL
xangainazinha	xangaíno+A+DIM+F+SG
xangainazinhas	xangaíno+A+DIM+F+PL
xangaininha	xangaíno+A+DIM+F+SG
xangaininhas	xangaíno+A+DIM+F+PL
xangaininho	xangaíno+A+DIM+M+SG
xangaininhos	xangaíno+A+DIM+M+PL
xangainozinho	xangaíno+A+DIM+M+SG
xangainozinhos	xangaíno+A+DIM+M+PL
xangaína	xangaíno+A+F+SG
xangaínas	xangaíno+A+F+PL
xangaíno	xangaíno+A+M+SG
xangaínos	xangaíno+A+M+PL
xantamilicazinha	xantamílico+A+DIM+F+SG
xantamilicazinhas	xantamílico+A+DIM+F+PL
xantamilicozinho	xantamílico+A+DIM+M+SG
xantamilicozinhos	xantamílico+A+DIM+M+PL
xantamiliquinha	xantamílico+A+DIM+F+SG
xantamiliquinhas	xantamílico+A+DIM+F+PL
xantamiliquinho	xantamílico+A+DIM+M+SG
xantamiliquinhos	xantamílico+A+DIM+M+PL
xantamílica	xantamílico+A+F+SG
xantamílicas	xantamílico+A+F+PL
xantamílico	xantamílico+A+M+SG
xantamílicos	xantamílico+A+M+PL
xantinuricazinha	xantinúrico+A+DIM+F+SG
xantinuricazinhas	xantinúrico+A+DIM+F+PL
xantinuricozinho	xantinúrico+A+DIM+M+SG
xantinuricozinhos	xantinúrico+A+DIM+M+PL
xantinuriquinha	xantinúrico+A+DIM+F+SG
xantinuriquinhas	xantinúrico+A+DIM+F+PL
xantinuriquinho	xantinúrico+A+DIM+M+SG
xantinuriquinhos	xantinúrico+A+DIM+M+PL
xantinúrica	xantinúrico+A+F+SG
xantinúricas	xantinúrico+A+F+PL
xantinúrico	xantinúrico+A+M+SG
xantinúricos	xantinúrico+A+M+PL
xantocarpa	xantocarpo+A+F+SG
xantocarpas	xantocarpo+A+F+PL
xantocarpazinha	xantocarpo+A+DIM+F+SG
xantocarpazinhas	xantocarpo+A+DIM+F+PL
xantocarpinha	xantocarpo+A+DIM+F+SG
xantocarpinhas	xantocarpo+A+DIM+F+PL
xantocarpinho	xantocarpo+A+DIM+M+SG
xantocarpinhos	xantocarpo+A+DIM+M+PL
xantocarpo	xantocarpo+A+M+SG
xantocarpos	xantocarpo+A+M+PL
xantocarpozinho	xantocarpo+A+DIM+M+SG
xantocarpozinhos	xantocarpo+A+DIM+M+PL
xantocromaticazinha	xantocromático+A+DIM+F+SG
xantocromaticazinhas	xantocromático+A+DIM+F+PL
xantocromaticozinho	xantocromático+A+DIM+M+SG
xantocromaticozinhos	xantocromático+A+DIM+M+PL
xantocromatiquinha	xantocromático+A+DIM+F+SG
xantocromatiquinhas	xantocromático+A+DIM+F+PL
xantocromatiquinho	xantocromático+A+DIM+M+SG
xantocromatiquinhos	xantocromático+A+DIM+M+PL
xantocromática	xantocromático+A+F+SG
xantocromáticas	xantocromático+A+F+PL
xantocromático	xantocromático+A+M+SG
xantocromáticos	xantocromático+A+M+PL
xantocromicazinha	xantocrómico+A+DIM+F+SG
xantocromicazinhas	xantocrómico+A+DIM+F+PL
xantocromicozinho	xantocrómico+A+DIM+M+SG
xantocromicozinhos	xantocrómico+A+DIM+M+PL
xantocromiquinha	xantocrómico+A+DIM+F+SG
xantocromiquinhas	xantocrómico+A+DIM+F+PL
xantocromiquinho	xantocrómico+A+DIM+M+SG
xantocromiquinhos	xantocrómico+A+DIM+M+PL
xantocrómica	xantocrómico+A+F+SG
xantocrómicas	xantocrómico+A+F+PL
xantocrómico	xantocrómico+A+M+SG
xantocrómicos	xantocrómico+A+M+PL
xantocromicazinha	xantocrômico+A+DIM+F+SG
xantocromicazinhas	xantocrômico+A+DIM+F+PL
xantocromicozinho	xantocrômico+A+DIM+M+SG
xantocromicozinhos	xantocrômico+A+DIM+M+PL
xantocromiquinha	xantocrômico+A+DIM+F+SG
xantocromiquinhas	xantocrômico+A+DIM+F+PL
xantocromiquinho	xantocrômico+A+DIM+M+SG
xantocromiquinhos	xantocrômico+A+DIM+M+PL
xantocrômica	xantocrômico+A+F+SG
xantocrômicas	xantocrômico+A+F+PL
xantocrômico	xantocrômico+A+M+SG
xantocrômicos	xantocrômico+A+M+PL
xantocefalazinha	xantocéfalo+A+DIM+F+SG
xantocefalazinhas	xantocéfalo+A+DIM+F+PL
xantocefalinha	xantocéfalo+A+DIM+F+SG
xantocefalinhas	xantocéfalo+A+DIM+F+PL
xantocefalinho	xantocéfalo+A+DIM+M+SG
xantocefalinhos	xantocéfalo+A+DIM+M+PL
xantocefalozinho	xantocéfalo+A+DIM+M+SG
xantocefalozinhos	xantocéfalo+A+DIM+M+PL
xantocéfala	xantocéfalo+A+F+SG
xantocéfalas	xantocéfalo+A+F+PL
xantocéfalo	xantocéfalo+A+M+SG
xantocéfalos	xantocéfalo+A+M+PL
xantoderme	xantoderme+A+M+SG
xantodermes	xantoderme+A+M+PL
xantodermezinho	xantoderme+A+DIM+M+SG
xantodermezinhos	xantoderme+A+DIM+M+PL
xantoderminho	xantoderme+A+DIM+M+SG
xantoderminhos	xantoderme+A+DIM+M+PL
xantoderma	xantodermo+A+F+SG
xantodermas	xantodermo+A+F+PL
xantodermazinha	xantodermo+A+DIM+F+SG
xantodermazinhas	xantodermo+A+DIM+F+PL
xantoderminha	xantodermo+A+DIM+F+SG
xantoderminhas	xantodermo+A+DIM+F+PL
xantoderminho	xantodermo+A+DIM+M+SG
xantoderminhos	xantodermo+A+DIM+M+PL
xantodermo	xantodermo+A+M+SG
xantodermos	xantodermo+A+M+PL
xantodermozinho	xantodermo+A+DIM+M+SG
xantodermozinhos	xantodermo+A+DIM+M+PL
xantodonte	xantodonte+A+SG
xantodontes	xantodonte+A+PL
xantodontezinha	xantodonte+A+DIM+F+SG
xantodontezinhas	xantodonte+A+DIM+F+PL
xantodontezinho	xantodonte+A+DIM+M+SG
xantodontezinhos	xantodonte+A+DIM+M+PL
xantodontinha	xantodonte+A+DIM+F+SG
xantodontinhas	xantodonte+A+DIM+F+PL
xantodontinho	xantodonte+A+DIM+M+SG
xantodontinhos	xantodonte+A+DIM+M+PL
xantodermicazinha	xantodérmico+A+DIM+F+SG
xantodermicazinhas	xantodérmico+A+DIM+F+PL
xantodermicozinho	xantodérmico+A+DIM+M+SG
xantodermicozinhos	xantodérmico+A+DIM+M+PL
xantodermiquinha	xantodérmico+A+DIM+F+SG
xantodermiquinhas	xantodérmico+A+DIM+F+PL
xantodermiquinho	xantodérmico+A+DIM+M+SG
xantodermiquinhos	xantodérmico+A+DIM+M+PL
xantodérmica	xantodérmico+A+F+SG
xantodérmicas	xantodérmico+A+F+PL
xantodérmico	xantodérmico+A+M+SG
xantodérmicos	xantodérmico+A+M+PL
xantofoticazinha	xantofótico+A+DIM+F+SG
xantofoticazinhas	xantofótico+A+DIM+F+PL
xantofoticozinho	xantofótico+A+DIM+M+SG
xantofoticozinhos	xantofótico+A+DIM+M+PL
xantofotiquinha	xantofótico+A+DIM+F+SG
xantofotiquinhas	xantofótico+A+DIM+F+PL
xantofotiquinho	xantofótico+A+DIM+M+SG
xantofotiquinhos	xantofótico+A+DIM+M+PL
xantofótica	xantofótico+A+F+SG
xantofóticas	xantofótico+A+F+PL
xantofótico	xantofótico+A+M+SG
xantofóticos	xantofótico+A+M+PL
xantogastra	xantogastro+A+F+SG
xantogastras	xantogastro+A+F+PL
xantogastrazinha	xantogastro+A+DIM+F+SG
xantogastrazinhas	xantogastro+A+DIM+F+PL
xantogastrinha	xantogastro+A+DIM+F+SG
xantogastrinhas	xantogastro+A+DIM+F+PL
xantogastrinho	xantogastro+A+DIM+M+SG
xantogastrinhos	xantogastro+A+DIM+M+PL
xantogastro	xantogastro+A+M+SG
xantogastros	xantogastro+A+M+PL
xantogastrozinho	xantogastro+A+DIM+M+SG
xantogastrozinhos	xantogastro+A+DIM+M+PL
xantogenicazinha	xantogénico+A+DIM+F+SG
xantogenicazinhas	xantogénico+A+DIM+F+PL
xantogenicozinho	xantogénico+A+DIM+M+SG
xantogenicozinhos	xantogénico+A+DIM+M+PL
xantogeniquinha	xantogénico+A+DIM+F+SG
xantogeniquinhas	xantogénico+A+DIM+F+PL
xantogeniquinho	xantogénico+A+DIM+M+SG
xantogeniquinhos	xantogénico+A+DIM+M+PL
xantogénica	xantogénico+A+F+SG
xantogénicas	xantogénico+A+F+PL
xantogénico	xantogénico+A+M+SG
xantogénicos	xantogénico+A+M+PL
xantogenicazinha	xantogênico+A+DIM+F+SG
xantogenicazinhas	xantogênico+A+DIM+F+PL
xantogenicozinho	xantogênico+A+DIM+M+SG
xantogenicozinhos	xantogênico+A+DIM+M+PL
xantogeniquinha	xantogênico+A+DIM+F+SG
xantogeniquinhas	xantogênico+A+DIM+F+PL
xantogeniquinho	xantogênico+A+DIM+M+SG
xantogeniquinhos	xantogênico+A+DIM+M+PL
xantogênica	xantogênico+A+F+SG
xantogênicas	xantogênico+A+F+PL
xantogênico	xantogênico+A+M+SG
xantogênicos	xantogênico+A+M+PL
xantomatosicazinha	xantomatósico+A+DIM+F+SG
xantomatosicazinhas	xantomatósico+A+DIM+F+PL
xantomatosicozinho	xantomatósico+A+DIM+M+SG
xantomatosicozinhos	xantomatósico+A+DIM+M+PL
xantomatosiquinha	xantomatósico+A+DIM+F+SG
xantomatosiquinhas	xantomatósico+A+DIM+F+PL
xantomatosiquinho	xantomatósico+A+DIM+M+SG
xantomatosiquinhos	xantomatósico+A+DIM+M+PL
xantomatósica	xantomatósico+A+F+SG
xantomatósicas	xantomatósico+A+F+PL
xantomatósico	xantomatósico+A+M+SG
xantomatósicos	xantomatósico+A+M+PL
xantomatoticazinha	xantomatótico+A+DIM+F+SG
xantomatoticazinhas	xantomatótico+A+DIM+F+PL
xantomatoticozinho	xantomatótico+A+DIM+M+SG
xantomatoticozinhos	xantomatótico+A+DIM+M+PL
xantomatotiquinha	xantomatótico+A+DIM+F+SG
xantomatotiquinhas	xantomatótico+A+DIM+F+PL
xantomatotiquinho	xantomatótico+A+DIM+M+SG
xantomatotiquinhos	xantomatótico+A+DIM+M+PL
xantomatótica	xantomatótico+A+F+SG
xantomatóticas	xantomatótico+A+F+PL
xantomatótico	xantomatótico+A+M+SG
xantomatóticos	xantomatótico+A+M+PL
xantonota	xantonoto+A+F+SG
xantonotas	xantonoto+A+F+PL
xantonotazinha	xantonoto+A+DIM+F+SG
xantonotazinhas	xantonoto+A+DIM+F+PL
xantonotinha	xantonoto+A+DIM+F+SG
xantonotinhas	xantonoto+A+DIM+F+PL
xantonotinho	xantonoto+A+DIM+M+SG
xantonotinhos	xantonoto+A+DIM+M+PL
xantonoto	xantonoto+A+M+SG
xantonotos	xantonoto+A+M+PL
xantonotozinho	xantonoto+A+DIM+M+SG
xantonotozinhos	xantonoto+A+DIM+M+PL
xantoproteica	xantoproteico+A+F+SG
xantoproteicas	xantoproteico+A+F+PL
xantoproteicazinha	xantoproteico+A+DIM+F+SG
xantoproteicazinhas	xantoproteico+A+DIM+F+PL
xantoproteico	xantoproteico+A+M+SG
xantoproteicos	xantoproteico+A+M+PL
xantoproteicozinho	xantoproteico+A+DIM+M+SG
xantoproteicozinhos	xantoproteico+A+DIM+M+PL
xantoproteiquinha	xantoproteico+A+DIM+F+SG
xantoproteiquinhas	xantoproteico+A+DIM+F+PL
xantoproteiquinho	xantoproteico+A+DIM+M+SG
xantoproteiquinhos	xantoproteico+A+DIM+M+PL
xantopsidracicazinha	xantopsidrácico+A+DIM+F+SG
xantopsidracicazinhas	xantopsidrácico+A+DIM+F+PL
xantopsidracicozinho	xantopsidrácico+A+DIM+M+SG
xantopsidracicozinhos	xantopsidrácico+A+DIM+M+PL
xantopsidraciquinha	xantopsidrácico+A+DIM+F+SG
xantopsidraciquinhas	xantopsidrácico+A+DIM+F+PL
xantopsidraciquinho	xantopsidrácico+A+DIM+M+SG
xantopsidraciquinhos	xantopsidrácico+A+DIM+M+PL
xantopsidrácica	xantopsidrácico+A+F+SG
xantopsidrácicas	xantopsidrácico+A+F+PL
xantopsidrácico	xantopsidrácico+A+M+SG
xantopsidrácicos	xantopsidrácico+A+M+PL
xantorreica	xantorreico+A+F+SG
xantorreicas	xantorreico+A+F+PL
xantorreicazinha	xantorreico+A+DIM+F+SG
xantorreicazinhas	xantorreico+A+DIM+F+PL
xantorreico	xantorreico+A+M+SG
xantorreicos	xantorreico+A+M+PL
xantorreicozinho	xantorreico+A+DIM+M+SG
xantorreicozinhos	xantorreico+A+DIM+M+PL
xantorreiquinha	xantorreico+A+DIM+F+SG
xantorreiquinhas	xantorreico+A+DIM+F+PL
xantorreiquinho	xantorreico+A+DIM+M+SG
xantorreiquinhos	xantorreico+A+DIM+M+PL
xantorriza	xantorrizo+A+F+SG
xantorrizas	xantorrizo+A+F+PL
xantorrizazinha	xantorrizo+A+DIM+F+SG
xantorrizazinhas	xantorrizo+A+DIM+F+PL
xantorrizinha	xantorrizo+A+DIM+F+SG
xantorrizinhas	xantorrizo+A+DIM+F+PL
xantorrizinho	xantorrizo+A+DIM+M+SG
xantorrizinhos	xantorrizo+A+DIM+M+PL
xantorrizo	xantorrizo+A+M+SG
xantorrizos	xantorrizo+A+M+PL
xantorrizozinho	xantorrizo+A+DIM+M+SG
xantorrizozinhos	xantorrizo+A+DIM+M+PL
xantosa	xantoso+A+F+SG
xantosas	xantoso+A+F+PL
xantosazinha	xantoso+A+DIM+F+SG
xantosazinhas	xantoso+A+DIM+F+PL
xantosinha	xantoso+A+DIM+F+SG
xantosinhas	xantoso+A+DIM+F+PL
xantosinho	xantoso+A+DIM+M+SG
xantosinhos	xantoso+A+DIM+M+PL
xantoso	xantoso+A+M+SG
xantosos	xantoso+A+M+PL
xantosozinho	xantoso+A+DIM+M+SG
xantosozinhos	xantoso+A+DIM+M+PL
xantosperma	xantospermo+A+F+SG
xantospermas	xantospermo+A+F+PL
xantospermazinha	xantospermo+A+DIM+F+SG
xantospermazinhas	xantospermo+A+DIM+F+PL
xantosperminha	xantospermo+A+DIM+F+SG
xantosperminhas	xantospermo+A+DIM+F+PL
xantosperminho	xantospermo+A+DIM+M+SG
xantosperminhos	xantospermo+A+DIM+M+PL
xantospermo	xantospermo+A+M+SG
xantospermos	xantospermo+A+M+PL
xantospermozinho	xantospermo+A+DIM+M+SG
xantospermozinhos	xantospermo+A+DIM+M+PL
xantusiideazinha	xantusiídeo+A+DIM+F+SG
xantusiideazinhas	xantusiídeo+A+DIM+F+PL
xantusiideinha	xantusiídeo+A+DIM+F+SG
xantusiideinhas	xantusiídeo+A+DIM+F+PL
xantusiideinho	xantusiídeo+A+DIM+M+SG
xantusiideinhos	xantusiídeo+A+DIM+M+PL
xantusiideozinho	xantusiídeo+A+DIM+M+SG
xantusiideozinhos	xantusiídeo+A+DIM+M+PL
xantusiídea	xantusiídeo+A+F+SG
xantusiídeas	xantusiídeo+A+F+PL
xantusiídeo	xantusiídeo+A+M+SG
xantusiídeos	xantusiídeo+A+M+PL
xantaticazinha	xantático+A+DIM+F+SG
xantaticazinhas	xantático+A+DIM+F+PL
xantaticozinho	xantático+A+DIM+M+SG
xantaticozinhos	xantático+A+DIM+M+PL
xantatiquinha	xantático+A+DIM+F+SG
xantatiquinhas	xantático+A+DIM+F+PL
xantatiquinho	xantático+A+DIM+M+SG
xantatiquinhos	xantático+A+DIM+M+PL
xantática	xantático+A+F+SG
xantáticas	xantático+A+F+PL
xantático	xantático+A+M+SG
xantáticos	xantático+A+M+PL
xantemicazinha	xantêmico+A+DIM+F+SG
xantemicazinhas	xantêmico+A+DIM+F+PL
xantemicozinho	xantêmico+A+DIM+M+SG
xantemicozinhos	xantêmico+A+DIM+M+PL
xantemiquinha	xantêmico+A+DIM+F+SG
xantemiquinhas	xantêmico+A+DIM+F+PL
xantemiquinho	xantêmico+A+DIM+M+SG
xantemiquinhos	xantêmico+A+DIM+M+PL
xantêmica	xantêmico+A+F+SG
xantêmicas	xantêmico+A+F+PL
xantêmico	xantêmico+A+M+SG
xantêmicos	xantêmico+A+M+PL
xantideazinha	xantídeo+A+DIM+F+SG
xantideazinhas	xantídeo+A+DIM+F+PL
xantideinha	xantídeo+A+DIM+F+SG
xantideinhas	xantídeo+A+DIM+F+PL
xantideinho	xantídeo+A+DIM+M+SG
xantideinhos	xantídeo+A+DIM+M+PL
xantideozinho	xantídeo+A+DIM+M+SG
xantideozinhos	xantídeo+A+DIM+M+PL
xantídea	xantídeo+A+F+SG
xantídeas	xantídeo+A+F+PL
xantídeo	xantídeo+A+M+SG
xantídeos	xantídeo+A+M+PL
xantilicazinha	xantílico+A+DIM+F+SG
xantilicazinhas	xantílico+A+DIM+F+PL
xantilicozinho	xantílico+A+DIM+M+SG
xantilicozinhos	xantílico+A+DIM+M+PL
xantiliquinha	xantílico+A+DIM+F+SG
xantiliquinhas	xantílico+A+DIM+F+PL
xantiliquinho	xantílico+A+DIM+M+SG
xantiliquinhos	xantílico+A+DIM+M+PL
xantílica	xantílico+A+F+SG
xantílicas	xantílico+A+F+PL
xantílico	xantílico+A+M+SG
xantílicos	xantílico+A+M+PL
xantognatazinha	xantógnato+A+DIM+F+SG
xantognatazinhas	xantógnato+A+DIM+F+PL
xantognatinha	xantógnato+A+DIM+F+SG
xantognatinhas	xantógnato+A+DIM+F+PL
xantognatinho	xantógnato+A+DIM+M+SG
xantognatinhos	xantógnato+A+DIM+M+PL
xantognatozinho	xantógnato+A+DIM+M+SG
xantognatozinhos	xantógnato+A+DIM+M+PL
xantógnata	xantógnato+A+F+SG
xantógnatas	xantógnato+A+F+PL
xantógnato	xantógnato+A+M+SG
xantógnatos	xantógnato+A+M+PL
xantografazinha	xantógrafo+A+DIM+F+SG
xantografazinhas	xantógrafo+A+DIM+F+PL
xantografinha	xantógrafo+A+DIM+F+SG
xantografinhas	xantógrafo+A+DIM+F+PL
xantografinho	xantógrafo+A+DIM+M+SG
xantografinhos	xantógrafo+A+DIM+M+PL
xantografozinho	xantógrafo+A+DIM+M+SG
xantografozinhos	xantógrafo+A+DIM+M+PL
xantógrafa	xantógrafo+A+F+SG
xantógrafas	xantógrafo+A+F+PL
xantógrafo	xantógrafo+A+M+SG
xantógrafos	xantógrafo+A+M+PL
xantopodezinha	xantópode+A+DIM+F+SG
xantopodezinhas	xantópode+A+DIM+F+PL
xantopodezinho	xantópode+A+DIM+M+SG
xantopodezinhos	xantópode+A+DIM+M+PL
xantopodinha	xantópode+A+DIM+F+SG
xantopodinhas	xantópode+A+DIM+F+PL
xantopodinho	xantópode+A+DIM+M+SG
xantopodinhos	xantópode+A+DIM+M+PL
xantópode	xantópode+A+SG
xantópodes	xantópode+A+PL
xantopterazinha	xantóptero+A+DIM+F+SG
xantopterazinhas	xantóptero+A+DIM+F+PL
xantopterinha	xantóptero+A+DIM+F+SG
xantopterinhas	xantóptero+A+DIM+F+PL
xantopterinho	xantóptero+A+DIM+M+SG
xantopterinhos	xantóptero+A+DIM+M+PL
xantopterozinho	xantóptero+A+DIM+M+SG
xantopterozinhos	xantóptero+A+DIM+M+PL
xantóptera	xantóptero+A+F+SG
xantópteras	xantóptero+A+F+PL
xantóptero	xantóptero+A+M+SG
xantópteros	xantóptero+A+M+PL
xantopticazinha	xantóptico+A+DIM+F+SG
xantopticazinhas	xantóptico+A+DIM+F+PL
xantopticozinho	xantóptico+A+DIM+M+SG
xantopticozinhos	xantóptico+A+DIM+M+PL
xantoptiquinha	xantóptico+A+DIM+F+SG
xantoptiquinhas	xantóptico+A+DIM+F+PL
xantoptiquinho	xantóptico+A+DIM+M+SG
xantoptiquinhos	xantóptico+A+DIM+M+PL
xantóptica	xantóptico+A+F+SG
xantópticas	xantóptico+A+F+PL
xantóptico	xantóptico+A+M+SG
xantópticos	xantóptico+A+M+PL
xantospilazinha	xantóspilo+A+DIM+F+SG
xantospilazinhas	xantóspilo+A+DIM+F+PL
xantospilinha	xantóspilo+A+DIM+F+SG
xantospilinhas	xantóspilo+A+DIM+F+PL
xantospilinho	xantóspilo+A+DIM+M+SG
xantospilinhos	xantóspilo+A+DIM+M+PL
xantospilozinho	xantóspilo+A+DIM+M+SG
xantospilozinhos	xantóspilo+A+DIM+M+PL
xantóspila	xantóspilo+A+F+SG
xantóspilas	xantóspilo+A+F+PL
xantóspilo	xantóspilo+A+M+SG
xantóspilos	xantóspilo+A+M+PL
xantoxilazinha	xantóxilo+A+DIM+F+SG
xantoxilazinhas	xantóxilo+A+DIM+F+PL
xantoxilinha	xantóxilo+A+DIM+F+SG
xantoxilinhas	xantóxilo+A+DIM+F+PL
xantoxilinho	xantóxilo+A+DIM+M+SG
xantoxilinhos	xantóxilo+A+DIM+M+PL
xantoxilozinho	xantóxilo+A+DIM+M+SG
xantoxilozinhos	xantóxilo+A+DIM+M+PL
xantóxila	xantóxilo+A+F+SG
xantóxilas	xantóxilo+A+F+PL
xantóxilo	xantóxilo+A+M+SG
xantóxilos	xantóxilo+A+M+PL
xanxereense	xanxereense+A+SG
xanxereenses	xanxereense+A+PL
xanxereensezinha	xanxereense+A+DIM+F+SG
xanxereensezinhas	xanxereense+A+DIM+F+PL
xanxereensezinho	xanxereense+A+DIM+M+SG
xanxereensezinhos	xanxereense+A+DIM+M+PL
xanxereensinha	xanxereense+A+DIM+F+SG
xanxereensinhas	xanxereense+A+DIM+F+PL
xanxereensinho	xanxereense+A+DIM+M+SG
xanxereensinhos	xanxereense+A+DIM+M+PL
xapuriense	xapuriense+A+SG
xapurienses	xapuriense+A+PL
xapuriensezinha	xapuriense+A+DIM+F+SG
xapuriensezinhas	xapuriense+A+DIM+F+PL
xapuriensezinho	xapuriense+A+DIM+M+SG
xapuriensezinhos	xapuriense+A+DIM+M+PL
xapuriensinha	xapuriense+A+DIM+F+SG
xapuriensinhas	xapuriense+A+DIM+F+PL
xapuriensinho	xapuriense+A+DIM+M+SG
xapuriensinhos	xapuriense+A+DIM+M+PL
xaqueaveizinhas	xaqueável+A+DIM+F+PL
xaqueaveizinhos	xaqueável+A+DIM+M+PL
xaqueavelzinha	xaqueável+A+DIM+F+SG
xaqueavelzinho	xaqueável+A+DIM+M+SG
xaqueáveis	xaqueável+A+PL
xaqueável	xaqueável+A+SG
xardosa	xardoso+A+F+SG
xardosas	xardoso+A+F+PL
xardosazinha	xardoso+A+DIM+F+SG
xardosazinhas	xardoso+A+DIM+F+PL
xardosinha	xardoso+A+DIM+F+SG
xardosinhas	xardoso+A+DIM+F+PL
xardosinho	xardoso+A+DIM+M+SG
xardosinhos	xardoso+A+DIM+M+PL
xardoso	xardoso+A+M+SG
xardosos	xardoso+A+M+PL
xardosozinho	xardoso+A+DIM+M+SG
xardosozinhos	xardoso+A+DIM+M+PL
xaria	xaria+A+SG
xarias	xaria+A+PL
xariazinha	xaria+A+DIM+F+SG
xariazinhas	xaria+A+DIM+F+PL
xariazinho	xaria+A+DIM+M+SG
xariazinhos	xaria+A+DIM+M+PL
xarinha	xaria+A+DIM+SG
xarinhas	xaria+A+DIM+PL
xaropeaveizinhas	xaropeável+A+DIM+F+PL
xaropeaveizinhos	xaropeável+A+DIM+M+PL
xaropeavelzinha	xaropeável+A+DIM+F+SG
xaropeavelzinho	xaropeável+A+DIM+M+SG
xaropeáveis	xaropeável+A+PL
xaropeável	xaropeável+A+SG
xaroposa	xaroposo+A+F+SG
xaroposas	xaroposo+A+F+PL
xaroposazinha	xaroposo+A+DIM+F+SG
xaroposazinhas	xaroposo+A+DIM+F+PL
xaroposinha	xaroposo+A+DIM+F+SG
xaroposinhas	xaroposo+A+DIM+F+PL
xaroposinho	xaroposo+A+DIM+M+SG
xaroposinhos	xaroposo+A+DIM+M+PL
xaroposo	xaroposo+A+M+SG
xaroposos	xaroposo+A+M+PL
xaroposozinho	xaroposo+A+DIM+M+SG
xaroposozinhos	xaroposo+A+DIM+M+PL
xaropaveizinhas	xaropável+A+DIM+F+PL
xaropaveizinhos	xaropável+A+DIM+M+PL
xaropavelzinha	xaropável+A+DIM+F+SG
xaropavelzinho	xaropável+A+DIM+M+SG
xaropáveis	xaropável+A+PL
xaropável	xaropável+A+SG
xarazinha	xará+A+DIM+F+SG
xarazinhas	xará+A+DIM+F+PL
xarazinho	xará+A+DIM+M+SG
xarazinhos	xará+A+DIM+M+PL
xará	xará+A+SG
xarás	xará+A+PL
xavante	xavante+A+SG
xavantes	xavante+A+PL
xavantezinha	xavante+A+DIM+F+SG
xavantezinhas	xavante+A+DIM+F+PL
xavantezinho	xavante+A+DIM+M+SG
xavantezinhos	xavante+A+DIM+M+PL
xavantinha	xavante+A+DIM+F+SG
xavantinhas	xavante+A+DIM+F+PL
xavantinho	xavante+A+DIM+M+SG
xavantinhos	xavante+A+DIM+M+PL
xavantense	xavantense+A+SG
xavantenses	xavantense+A+PL
xavantensezinha	xavantense+A+DIM+F+SG
xavantensezinhas	xavantense+A+DIM+F+PL
xavantensezinho	xavantense+A+DIM+M+SG
xavantensezinhos	xavantense+A+DIM+M+PL
xavantensinha	xavantense+A+DIM+F+SG
xavantensinhas	xavantense+A+DIM+F+PL
xavantensinho	xavantense+A+DIM+M+SG
xavantensinhos	xavantense+A+DIM+M+PL
xavantina	xavantino+A+F+SG
xavantinas	xavantino+A+F+PL
xavantinazinha	xavantino+A+DIM+F+SG
xavantinazinhas	xavantino+A+DIM+F+PL
xavantininha	xavantino+A+DIM+F+SG
xavantininhas	xavantino+A+DIM+F+PL
xavantininho	xavantino+A+DIM+M+SG
xavantininhos	xavantino+A+DIM+M+PL
xavantino	xavantino+A+M+SG
xavantinos	xavantino+A+M+PL
xavantinozinho	xavantino+A+DIM+M+SG
xavantinozinhos	xavantino+A+DIM+M+PL
xaxinense	xaxinense+A+SG
xaxinenses	xaxinense+A+PL
xaxinensezinha	xaxinense+A+DIM+F+SG
xaxinensezinhas	xaxinense+A+DIM+F+PL
xaxinensezinho	xaxinense+A+DIM+M+SG
xaxinensezinhos	xaxinense+A+DIM+M+PL
xaxinensinha	xaxinense+A+DIM+F+SG
xaxinensinhas	xaxinense+A+DIM+F+PL
xaxinensinho	xaxinense+A+DIM+M+SG
xaxinensinhos	xaxinense+A+DIM+M+PL
xenartra	xenartro+A+F+SG
xenartras	xenartro+A+F+PL
xenartrazinha	xenartro+A+DIM+F+SG
xenartrazinhas	xenartro+A+DIM+F+PL
xenartrinha	xenartro+A+DIM+F+SG
xenartrinhas	xenartro+A+DIM+F+PL
xenartrinho	xenartro+A+DIM+M+SG
xenartrinhos	xenartro+A+DIM+M+PL
xenartro	xenartro+A+M+SG
xenartros	xenartro+A+M+PL
xenartrozinho	xenartro+A+DIM+M+SG
xenartrozinhos	xenartro+A+DIM+M+PL
xendengue	xendengue+A+SG
xendengues	xendengue+A+PL
xendenguezinha	xendengue+A+DIM+F+SG
xendenguezinhas	xendengue+A+DIM+F+PL
xendenguezinho	xendengue+A+DIM+M+SG
xendenguezinhos	xendengue+A+DIM+M+PL
xendenguinha	xendengue+A+DIM+F+SG
xendenguinhas	xendengue+A+DIM+F+PL
xendenguinho	xendengue+A+DIM+M+SG
xendenguinhos	xendengue+A+DIM+M+PL
xenoblasticazinha	xenoblástico+A+DIM+F+SG
xenoblasticazinhas	xenoblástico+A+DIM+F+PL
xenoblasticozinho	xenoblástico+A+DIM+M+SG
xenoblasticozinhos	xenoblástico+A+DIM+M+PL
xenoblastiquinha	xenoblástico+A+DIM+F+SG
xenoblastiquinhas	xenoblástico+A+DIM+F+PL
xenoblastiquinho	xenoblástico+A+DIM+M+SG
xenoblastiquinhos	xenoblástico+A+DIM+M+PL
xenoblástica	xenoblástico+A+F+SG
xenoblásticas	xenoblástico+A+F+PL
xenoblástico	xenoblástico+A+M+SG
xenoblásticos	xenoblástico+A+M+PL
xenofilicazinha	xenofílico+A+DIM+F+SG
xenofilicazinhas	xenofílico+A+DIM+F+PL
xenofilicozinho	xenofílico+A+DIM+M+SG
xenofilicozinhos	xenofílico+A+DIM+M+PL
xenofiliquinha	xenofílico+A+DIM+F+SG
xenofiliquinhas	xenofílico+A+DIM+F+PL
xenofiliquinho	xenofílico+A+DIM+M+SG
xenofiliquinhos	xenofílico+A+DIM+M+PL
xenofílica	xenofílico+A+F+SG
xenofílicas	xenofílico+A+F+PL
xenofílico	xenofílico+A+M+SG
xenofílicos	xenofílico+A+M+PL
xenofobicazinha	xenofóbico+A+DIM+F+SG
xenofobicazinhas	xenofóbico+A+DIM+F+PL
xenofobicozinho	xenofóbico+A+DIM+M+SG
xenofobicozinhos	xenofóbico+A+DIM+M+PL
xenofobiquinha	xenofóbico+A+DIM+F+SG
xenofobiquinhas	xenofóbico+A+DIM+F+PL
xenofobiquinho	xenofóbico+A+DIM+M+SG
xenofobiquinhos	xenofóbico+A+DIM+M+PL
xenofóbica	xenofóbico+A+F+SG
xenofóbicas	xenofóbico+A+F+PL
xenofóbico	xenofóbico+A+M+SG
xenofóbicos	xenofóbico+A+M+PL
xenofonicazinha	xenofónico+A+DIM+F+SG
xenofonicazinhas	xenofónico+A+DIM+F+PL
xenofonicozinho	xenofónico+A+DIM+M+SG
xenofonicozinhos	xenofónico+A+DIM+M+PL
xenofoniquinha	xenofónico+A+DIM+F+SG
xenofoniquinhas	xenofónico+A+DIM+F+PL
xenofoniquinho	xenofónico+A+DIM+M+SG
xenofoniquinhos	xenofónico+A+DIM+M+PL
xenofónica	xenofónico+A+F+SG
xenofónicas	xenofónico+A+F+PL
xenofónico	xenofónico+A+M+SG
xenofónicos	xenofónico+A+M+PL
xenofonicazinha	xenofônico+A+DIM+F+SG
xenofonicazinhas	xenofônico+A+DIM+F+PL
xenofonicozinho	xenofônico+A+DIM+M+SG
xenofonicozinhos	xenofônico+A+DIM+M+PL
xenofoniquinha	xenofônico+A+DIM+F+SG
xenofoniquinhas	xenofônico+A+DIM+F+PL
xenofoniquinho	xenofônico+A+DIM+M+SG
xenofoniquinhos	xenofônico+A+DIM+M+PL
xenofônica	xenofônico+A+F+SG
xenofônicas	xenofônico+A+F+PL
xenofônico	xenofônico+A+M+SG
xenofônicos	xenofônico+A+M+PL
xenogeneticazinha	xenogenético+A+DIM+F+SG
xenogeneticazinhas	xenogenético+A+DIM+F+PL
xenogeneticozinho	xenogenético+A+DIM+M+SG
xenogeneticozinhos	xenogenético+A+DIM+M+PL
xenogenetiquinha	xenogenético+A+DIM+F+SG
xenogenetiquinhas	xenogenético+A+DIM+F+PL
xenogenetiquinho	xenogenético+A+DIM+M+SG
xenogenetiquinhos	xenogenético+A+DIM+M+PL
xenogenética	xenogenético+A+F+SG
xenogenéticas	xenogenético+A+F+PL
xenogenético	xenogenético+A+M+SG
xenogenéticos	xenogenético+A+M+PL
xenograficazinha	xenográfico+A+DIM+F+SG
xenograficazinhas	xenográfico+A+DIM+F+PL
xenograficozinho	xenográfico+A+DIM+M+SG
xenograficozinhos	xenográfico+A+DIM+M+PL
xenografiquinha	xenográfico+A+DIM+F+SG
xenografiquinhas	xenográfico+A+DIM+F+PL
xenografiquinho	xenográfico+A+DIM+M+SG
xenografiquinhos	xenográfico+A+DIM+M+PL
xenográfica	xenográfico+A+F+SG
xenográficas	xenográfico+A+F+PL
xenográfico	xenográfico+A+M+SG
xenográficos	xenográfico+A+M+PL
xenomaniacazinha	xenomaníaco+A+DIM+F+SG
xenomaniacazinhas	xenomaníaco+A+DIM+F+PL
xenomaniacozinho	xenomaníaco+A+DIM+M+SG
xenomaniacozinhos	xenomaníaco+A+DIM+M+PL
xenomaniaquinha	xenomaníaco+A+DIM+F+SG
xenomaniaquinhas	xenomaníaco+A+DIM+F+PL
xenomaniaquinho	xenomaníaco+A+DIM+M+SG
xenomaniaquinhos	xenomaníaco+A+DIM+M+PL
xenomaníaca	xenomaníaco+A+F+SG
xenomaníacas	xenomaníaco+A+F+PL
xenomaníaco	xenomaníaco+A+M+SG
xenomaníacos	xenomaníaco+A+M+PL
xenomorficazinha	xenomórfico+A+DIM+F+SG
xenomorficazinhas	xenomórfico+A+DIM+F+PL
xenomorficozinho	xenomórfico+A+DIM+M+SG
xenomorficozinhos	xenomórfico+A+DIM+M+PL
xenomorfiquinha	xenomórfico+A+DIM+F+SG
xenomorfiquinhas	xenomórfico+A+DIM+F+PL
xenomorfiquinho	xenomórfico+A+DIM+M+SG
xenomorfiquinhos	xenomórfico+A+DIM+M+PL
xenomórfica	xenomórfico+A+F+SG
xenomórficas	xenomórfico+A+F+PL
xenomórfico	xenomórfico+A+M+SG
xenomórficos	xenomórfico+A+M+PL
xenopeltideazinha	xenopeltídeo+A+DIM+F+SG
xenopeltideazinhas	xenopeltídeo+A+DIM+F+PL
xenopeltideinha	xenopeltídeo+A+DIM+F+SG
xenopeltideinhas	xenopeltídeo+A+DIM+F+PL
xenopeltideinho	xenopeltídeo+A+DIM+M+SG
xenopeltideinhos	xenopeltídeo+A+DIM+M+PL
xenopeltideozinho	xenopeltídeo+A+DIM+M+SG
xenopeltideozinhos	xenopeltídeo+A+DIM+M+PL
xenopeltídea	xenopeltídeo+A+F+SG
xenopeltídeas	xenopeltídeo+A+F+PL
xenopeltídeo	xenopeltídeo+A+M+SG
xenopeltídeos	xenopeltídeo+A+M+PL
xenopterigiazinha	xenopterígio+A+DIM+F+SG
xenopterigiazinhas	xenopterígio+A+DIM+F+PL
xenopteriginha	xenopterígio+A+DIM+F+SG
xenopteriginhas	xenopterígio+A+DIM+F+PL
xenopteriginho	xenopterígio+A+DIM+M+SG
xenopteriginhos	xenopterígio+A+DIM+M+PL
xenopterigiozinho	xenopterígio+A+DIM+M+SG
xenopterigiozinhos	xenopterígio+A+DIM+M+PL
xenopterígia	xenopterígio+A+F+SG
xenopterígias	xenopterígio+A+F+PL
xenopterígio	xenopterígio+A+M+SG
xenopterígios	xenopterígio+A+M+PL
xenungulada	xenungulado+A+F+SG
xenunguladas	xenungulado+A+F+PL
xenunguladazinha	xenungulado+A+DIM+F+SG
xenunguladazinhas	xenungulado+A+DIM+F+PL
xenunguladinha	xenungulado+A+DIM+F+SG
xenunguladinhas	xenungulado+A+DIM+F+PL
xenunguladinho	xenungulado+A+DIM+M+SG
xenunguladinhos	xenungulado+A+DIM+M+PL
xenungulado	xenungulado+A+M+SG
xenungulados	xenungulado+A+M+PL
xenunguladozinho	xenungulado+A+DIM+M+SG
xenunguladozinhos	xenungulado+A+DIM+M+PL
xenofilazinha	xenófilo+A+DIM+F+SG
xenofilazinhas	xenófilo+A+DIM+F+PL
xenofilinha	xenófilo+A+DIM+F+SG
xenofilinhas	xenófilo+A+DIM+F+PL
xenofilinho	xenófilo+A+DIM+M+SG
xenofilinhos	xenófilo+A+DIM+M+PL
xenofilozinho	xenófilo+A+DIM+M+SG
xenofilozinhos	xenófilo+A+DIM+M+PL
xenófila	xenófilo+A+F+SG
xenófilas	xenófilo+A+F+PL
xenófilo	xenófilo+A+M+SG
xenófilos	xenófilo+A+M+PL
xenofobazinha	xenófobo+A+DIM+F+SG
xenofobazinhas	xenófobo+A+DIM+F+PL
xenofobinha	xenófobo+A+DIM+F+SG
xenofobinhas	xenófobo+A+DIM+F+PL
xenofobinho	xenófobo+A+DIM+M+SG
xenofobinhos	xenófobo+A+DIM+M+PL
xenofobozinho	xenófobo+A+DIM+M+SG
xenofobozinhos	xenófobo+A+DIM+M+PL
xenófoba	xenófobo+A+F+SG
xenófobas	xenófobo+A+F+PL
xenófobo	xenófobo+A+M+SG
xenófobos	xenófobo+A+M+PL
xenomanazinha	xenômano+A+DIM+F+SG
xenomanazinhas	xenômano+A+DIM+F+PL
xenomaninha	xenômano+A+DIM+F+SG
xenomaninhas	xenômano+A+DIM+F+PL
xenomaninho	xenômano+A+DIM+M+SG
xenomaninhos	xenômano+A+DIM+M+PL
xenomanozinho	xenômano+A+DIM+M+SG
xenomanozinhos	xenômano+A+DIM+M+PL
xenômana	xenômano+A+F+SG
xenômanas	xenômano+A+F+PL
xenômano	xenômano+A+M+SG
xenômanos	xenômano+A+M+PL
xereta	xereta+A+SG
xeretas	xereta+A+PL
xeretazinha	xereta+A+DIM+F+SG
xeretazinhas	xereta+A+DIM+F+PL
xeretazinho	xereta+A+DIM+M+SG
xeretazinhos	xereta+A+DIM+M+PL
xeretinha	xereta+A+DIM+SG
xeretinhas	xereta+A+DIM+PL
xereteaveizinhas	xereteável+A+DIM+F+PL
xereteaveizinhos	xereteável+A+DIM+M+PL
xereteavelzinha	xereteável+A+DIM+F+SG
xereteavelzinho	xereteável+A+DIM+M+SG
xereteáveis	xereteável+A+PL
xereteável	xereteável+A+SG
xeretaveizinhas	xeretável+A+DIM+F+PL
xeretaveizinhos	xeretável+A+DIM+M+PL
xeretavelzinha	xeretável+A+DIM+F+SG
xeretavelzinho	xeretável+A+DIM+M+SG
xeretáveis	xeretável+A+PL
xeretável	xeretável+A+SG
xerifina	xerifino+A+F+SG
xerifinas	xerifino+A+F+PL
xerifinazinha	xerifino+A+DIM+F+SG
xerifinazinhas	xerifino+A+DIM+F+PL
xerifininha	xerifino+A+DIM+F+SG
xerifininhas	xerifino+A+DIM+F+PL
xerifininho	xerifino+A+DIM+M+SG
xerifininhos	xerifino+A+DIM+M+PL
xerifino	xerifino+A+M+SG
xerifinos	xerifino+A+M+PL
xerifinozinho	xerifino+A+DIM+M+SG
xerifinozinhos	xerifino+A+DIM+M+PL
xerocador	xerocador+A+M+SG
xerocadora	xerocador+A+F+SG
xerocadoras	xerocador+A+F+PL
xerocadorazinha	xerocador+A+DIM+F+SG
xerocadorazinhas	xerocador+A+DIM+F+PL
xerocadores	xerocador+A+M+PL
xerocadorezinhos	xerocador+A+DIM+M+PL
xerocadorinha	xerocador+A+DIM+F+SG
xerocadorinhas	xerocador+A+DIM+F+PL
xerocadorzinho	xerocador+A+DIM+M+SG
xerocadorzinhos	xerocador+A+DIM+M+PL
xerocaveizinhas	xerocável+A+DIM+F+PL
xerocaveizinhos	xerocável+A+DIM+M+PL
xerocavelzinha	xerocável+A+DIM+F+SG
xerocavelzinho	xerocável+A+DIM+M+SG
xerocáveis	xerocável+A+PL
xerocável	xerocável+A+SG
xerodermicazinha	xerodérmico+A+DIM+F+SG
xerodermicazinhas	xerodérmico+A+DIM+F+PL
xerodermicozinho	xerodérmico+A+DIM+M+SG
xerodermicozinhos	xerodérmico+A+DIM+M+PL
xerodermiquinha	xerodérmico+A+DIM+F+SG
xerodermiquinhas	xerodérmico+A+DIM+F+PL
xerodermiquinho	xerodérmico+A+DIM+M+SG
xerodermiquinhos	xerodérmico+A+DIM+M+PL
xerodérmica	xerodérmico+A+F+SG
xerodérmicas	xerodérmico+A+F+PL
xerodérmico	xerodérmico+A+M+SG
xerodérmicos	xerodérmico+A+M+PL
xeroftalmicazinha	xeroftálmico+A+DIM+F+SG
xeroftalmicazinhas	xeroftálmico+A+DIM+F+PL
xeroftalmicozinho	xeroftálmico+A+DIM+M+SG
xeroftalmicozinhos	xeroftálmico+A+DIM+M+PL
xeroftalmiquinha	xeroftálmico+A+DIM+F+SG
xeroftalmiquinhas	xeroftálmico+A+DIM+F+PL
xeroftalmiquinho	xeroftálmico+A+DIM+M+SG
xeroftalmiquinhos	xeroftálmico+A+DIM+M+PL
xeroftálmica	xeroftálmico+A+F+SG
xeroftálmicas	xeroftálmico+A+F+PL
xeroftálmico	xeroftálmico+A+M+SG
xeroftálmicos	xeroftálmico+A+M+PL
xerofagicazinha	xerofágico+A+DIM+F+SG
xerofagicazinhas	xerofágico+A+DIM+F+PL
xerofagicozinho	xerofágico+A+DIM+M+SG
xerofagicozinhos	xerofágico+A+DIM+M+PL
xerofagiquinha	xerofágico+A+DIM+F+SG
xerofagiquinhas	xerofágico+A+DIM+F+PL
xerofagiquinho	xerofágico+A+DIM+M+SG
xerofagiquinhos	xerofágico+A+DIM+M+PL
xerofágica	xerofágico+A+F+SG
xerofágicas	xerofágico+A+F+PL
xerofágico	xerofágico+A+M+SG
xerofágicos	xerofágico+A+M+PL
xerofilicazinha	xerofílico+A+DIM+F+SG
xerofilicazinhas	xerofílico+A+DIM+F+PL
xerofilicozinho	xerofílico+A+DIM+M+SG
xerofilicozinhos	xerofílico+A+DIM+M+PL
xerofiliquinha	xerofílico+A+DIM+F+SG
xerofiliquinhas	xerofílico+A+DIM+F+PL
xerofiliquinho	xerofílico+A+DIM+M+SG
xerofiliquinhos	xerofílico+A+DIM+M+PL
xerofílica	xerofílico+A+F+SG
xerofílicas	xerofílico+A+F+PL
xerofílico	xerofílico+A+M+SG
xerofílicos	xerofílico+A+M+PL
xerofiticazinha	xerofítico+A+DIM+F+SG
xerofiticazinhas	xerofítico+A+DIM+F+PL
xerofiticozinho	xerofítico+A+DIM+M+SG
xerofiticozinhos	xerofítico+A+DIM+M+PL
xerofitiquinha	xerofítico+A+DIM+F+SG
xerofitiquinhas	xerofítico+A+DIM+F+PL
xerofitiquinho	xerofítico+A+DIM+M+SG
xerofitiquinhos	xerofítico+A+DIM+M+PL
xerofítica	xerofítico+A+F+SG
xerofíticas	xerofítico+A+F+PL
xerofítico	xerofítico+A+M+SG
xerofíticos	xerofítico+A+M+PL
xerografaveizinhas	xerografável+A+DIM+F+PL
xerografaveizinhos	xerografável+A+DIM+M+PL
xerografavelzinha	xerografável+A+DIM+F+SG
xerografavelzinho	xerografável+A+DIM+M+SG
xerografáveis	xerografável+A+PL
xerografável	xerografável+A+SG
xerograficazinha	xerográfico+A+DIM+F+SG
xerograficazinhas	xerográfico+A+DIM+F+PL
xerograficozinho	xerográfico+A+DIM+M+SG
xerograficozinhos	xerográfico+A+DIM+M+PL
xerografiquinha	xerográfico+A+DIM+F+SG
xerografiquinhas	xerográfico+A+DIM+F+PL
xerografiquinho	xerográfico+A+DIM+M+SG
xerografiquinhos	xerográfico+A+DIM+M+PL
xerográfica	xerográfico+A+F+SG
xerográficas	xerográfico+A+F+PL
xerográfico	xerográfico+A+M+SG
xerográficos	xerográfico+A+M+PL
xeromorfa	xeromorfo+A+F+SG
xeromorfas	xeromorfo+A+F+PL
xeromorfazinha	xeromorfo+A+DIM+F+SG
xeromorfazinhas	xeromorfo+A+DIM+F+PL
xeromorfinha	xeromorfo+A+DIM+F+SG
xeromorfinhas	xeromorfo+A+DIM+F+PL
xeromorfinho	xeromorfo+A+DIM+M+SG
xeromorfinhos	xeromorfo+A+DIM+M+PL
xeromorfo	xeromorfo+A+M+SG
xeromorfos	xeromorfo+A+M+PL
xeromorfozinho	xeromorfo+A+DIM+M+SG
xeromorfozinhos	xeromorfo+A+DIM+M+PL
xeromorficazinha	xeromórfico+A+DIM+F+SG
xeromorficazinhas	xeromórfico+A+DIM+F+PL
xeromorficozinho	xeromórfico+A+DIM+M+SG
xeromorficozinhos	xeromórfico+A+DIM+M+PL
xeromorfiquinha	xeromórfico+A+DIM+F+SG
xeromorfiquinhas	xeromórfico+A+DIM+F+PL
xeromorfiquinho	xeromórfico+A+DIM+M+SG
xeromorfiquinhos	xeromórfico+A+DIM+M+PL
xeromórfica	xeromórfico+A+F+SG
xeromórficas	xeromórfico+A+F+PL
xeromórfico	xeromórfico+A+M+SG
xeromórficos	xeromórfico+A+M+PL
xerostomicazinha	xerostômico+A+DIM+F+SG
xerostomicazinhas	xerostômico+A+DIM+F+PL
xerostomicozinho	xerostômico+A+DIM+M+SG
xerostomicozinhos	xerostômico+A+DIM+M+PL
xerostomiquinha	xerostômico+A+DIM+F+SG
xerostomiquinhas	xerostômico+A+DIM+F+PL
xerostomiquinho	xerostômico+A+DIM+M+SG
xerostomiquinhos	xerostômico+A+DIM+M+PL
xerostômica	xerostômico+A+F+SG
xerostômicas	xerostômico+A+F+PL
xerostômico	xerostômico+A+M+SG
xerostômicos	xerostômico+A+M+PL
xeroterma	xerotermo+A+F+SG
xerotermas	xerotermo+A+F+PL
xerotermazinha	xerotermo+A+DIM+F+SG
xerotermazinhas	xerotermo+A+DIM+F+PL
xeroterminha	xerotermo+A+DIM+F+SG
xeroterminhas	xerotermo+A+DIM+F+PL
xeroterminho	xerotermo+A+DIM+M+SG
xeroterminhos	xerotermo+A+DIM+M+PL
xerotermo	xerotermo+A+M+SG
xerotermos	xerotermo+A+M+PL
xerotermozinho	xerotermo+A+DIM+M+SG
xerotermozinhos	xerotermo+A+DIM+M+PL
xeroxaveizinhas	xeroxável+A+DIM+F+PL
xeroxaveizinhos	xeroxável+A+DIM+M+PL
xeroxavelzinha	xeroxável+A+DIM+F+SG
xeroxavelzinho	xeroxável+A+DIM+M+SG
xeroxáveis	xeroxável+A+PL
xeroxável	xeroxável+A+SG
xerofagazinha	xerófago+A+DIM+F+SG
xerofagazinhas	xerófago+A+DIM+F+PL
xerofagozinho	xerófago+A+DIM+M+SG
xerofagozinhos	xerófago+A+DIM+M+PL
xerofaguinha	xerófago+A+DIM+F+SG
xerofaguinhas	xerófago+A+DIM+F+PL
xerofaguinho	xerófago+A+DIM+M+SG
xerofaguinhos	xerófago+A+DIM+M+PL
xerófaga	xerófago+A+F+SG
xerófagas	xerófago+A+F+PL
xerófago	xerófago+A+M+SG
xerófagos	xerófago+A+M+PL
xerofilazinha	xerófilo+A+DIM+F+SG
xerofilazinhas	xerófilo+A+DIM+F+PL
xerofilinha	xerófilo+A+DIM+F+SG
xerofilinhas	xerófilo+A+DIM+F+PL
xerofilinho	xerófilo+A+DIM+M+SG
xerofilinhos	xerófilo+A+DIM+M+PL
xerofilozinho	xerófilo+A+DIM+M+SG
xerofilozinhos	xerófilo+A+DIM+M+PL
xerófila	xerófilo+A+F+SG
xerófilas	xerófilo+A+F+PL
xerófilo	xerófilo+A+M+SG
xerófilos	xerófilo+A+M+PL
xerofitazinha	xerófito+A+DIM+F+SG
xerofitazinhas	xerófito+A+DIM+F+PL
xerofitinha	xerófito+A+DIM+F+SG
xerofitinhas	xerófito+A+DIM+F+PL
xerofitinho	xerófito+A+DIM+M+SG
xerofitinhos	xerófito+A+DIM+M+PL
xerofitozinho	xerófito+A+DIM+M+SG
xerofitozinhos	xerófito+A+DIM+M+PL
xerófita	xerófito+A+F+SG
xerófitas	xerófito+A+F+PL
xerófito	xerófito+A+M+SG
xerófitos	xerófito+A+M+PL
xetraveizinhas	xetrável+A+DIM+F+PL
xetraveizinhos	xetrável+A+DIM+M+PL
xetravelzinha	xetrável+A+DIM+F+SG
xetravelzinho	xetrável+A+DIM+M+SG
xetráveis	xetrável+A+PL
xetrável	xetrável+A+SG
xevazinha	xevá+A+DIM+F+SG
xevazinhas	xevá+A+DIM+F+PL
xevazinho	xevá+A+DIM+M+SG
xevazinhos	xevá+A+DIM+M+PL
xevá	xevá+A+SG
xevás	xevá+A+PL
xexelenta	xexelento+A+F+SG
xexelentas	xexelento+A+F+PL
xexelentazinha	xexelento+A+DIM+F+SG
xexelentazinhas	xexelento+A+DIM+F+PL
xexelentinha	xexelento+A+DIM+F+SG
xexelentinhas	xexelento+A+DIM+F+PL
xexelentinho	xexelento+A+DIM+M+SG
xexelentinhos	xexelento+A+DIM+M+PL
xexelento	xexelento+A+M+SG
xexelentos	xexelento+A+M+PL
xexelentozinho	xexelento+A+DIM+M+SG
xexelentozinhos	xexelento+A+DIM+M+PL
xexezinha	xexé+A+DIM+F+SG
xexezinhas	xexé+A+DIM+F+PL
xexezinho	xexé+A+DIM+M+SG
xexezinhos	xexé+A+DIM+M+PL
xexé	xexé+A+SG
xexés	xexé+A+PL
xifirrinca	xifirrinco+A+F+SG
xifirrincas	xifirrinco+A+F+PL
xifirrincazinha	xifirrinco+A+DIM+F+SG
xifirrincazinhas	xifirrinco+A+DIM+F+PL
xifirrinco	xifirrinco+A+M+SG
xifirrincos	xifirrinco+A+M+PL
xifirrincozinho	xifirrinco+A+DIM+M+SG
xifirrincozinhos	xifirrinco+A+DIM+M+PL
xifirrinquinha	xifirrinco+A+DIM+F+SG
xifirrinquinhas	xifirrinco+A+DIM+F+PL
xifirrinquinho	xifirrinco+A+DIM+M+SG
xifirrinquinhos	xifirrinco+A+DIM+M+PL
xifiideazinha	xifiídeo+A+DIM+F+SG
xifiideazinhas	xifiídeo+A+DIM+F+PL
xifiideinha	xifiídeo+A+DIM+F+SG
xifiideinhas	xifiídeo+A+DIM+F+PL
xifiideinho	xifiídeo+A+DIM+M+SG
xifiideinhos	xifiídeo+A+DIM+M+PL
xifiideozinho	xifiídeo+A+DIM+M+SG
xifiideozinhos	xifiídeo+A+DIM+M+PL
xifiídea	xifiídeo+A+F+SG
xifiídeas	xifiídeo+A+F+PL
xifiídeo	xifiídeo+A+M+SG
xifiídeos	xifiídeo+A+M+PL
xifofila	xifofilo+A+F+SG
xifofilas	xifofilo+A+F+PL
xifofilazinha	xifofilo+A+DIM+F+SG
xifofilazinhas	xifofilo+A+DIM+F+PL
xifofilinha	xifofilo+A+DIM+F+SG
xifofilinhas	xifofilo+A+DIM+F+PL
xifofilinho	xifofilo+A+DIM+M+SG
xifofilinhos	xifofilo+A+DIM+M+PL
xifofilo	xifofilo+A+M+SG
xifofilos	xifofilo+A+M+PL
xifofilozinho	xifofilo+A+DIM+M+SG
xifofilozinhos	xifofilo+A+DIM+M+PL
xifoide	xifoide+A+SG
xifoides	xifoide+A+PL
xifoidezinha	xifoide+A+DIM+F+SG
xifoidezinhas	xifoide+A+DIM+F+PL
xifoidezinho	xifoide+A+DIM+M+SG
xifoidezinhos	xifoide+A+DIM+M+PL
xifoidinha	xifoide+A+DIM+F+SG
xifoidinhas	xifoide+A+DIM+F+PL
xifoidinho	xifoide+A+DIM+M+SG
xifoidinhos	xifoide+A+DIM+M+PL
xifoidiana	xifoidiano+A+F+SG
xifoidianas	xifoidiano+A+F+PL
xifoidianazinha	xifoidiano+A+DIM+F+SG
xifoidianazinhas	xifoidiano+A+DIM+F+PL
xifoidianinha	xifoidiano+A+DIM+F+SG
xifoidianinhas	xifoidiano+A+DIM+F+PL
xifoidianinho	xifoidiano+A+DIM+M+SG
xifoidianinhos	xifoidiano+A+DIM+M+PL
xifoidiano	xifoidiano+A+M+SG
xifoidianos	xifoidiano+A+M+PL
xifoidianozinho	xifoidiano+A+DIM+M+SG
xifoidianozinhos	xifoidiano+A+DIM+M+PL
xifosura	xifosuro+A+F+SG
xifosuras	xifosuro+A+F+PL
xifosurazinha	xifosuro+A+DIM+F+SG
xifosurazinhas	xifosuro+A+DIM+F+PL
xifosurinha	xifosuro+A+DIM+F+SG
xifosurinhas	xifosuro+A+DIM+F+PL
xifosurinho	xifosuro+A+DIM+M+SG
xifosurinhos	xifosuro+A+DIM+M+PL
xifosuro	xifosuro+A+M+SG
xifosuros	xifosuro+A+M+PL
xifosurozinho	xifosuro+A+DIM+M+SG
xifosurozinhos	xifosuro+A+DIM+M+PL
xifodimazinha	xifódimo+A+DIM+F+SG
xifodimazinhas	xifódimo+A+DIM+F+PL
xifodiminha	xifódimo+A+DIM+F+SG
xifodiminhas	xifódimo+A+DIM+F+PL
xifodiminho	xifódimo+A+DIM+M+SG
xifodiminhos	xifódimo+A+DIM+M+PL
xifodimozinho	xifódimo+A+DIM+M+SG
xifodimozinhos	xifódimo+A+DIM+M+PL
xifódima	xifódimo+A+F+SG
xifódimas	xifódimo+A+F+PL
xifódimo	xifódimo+A+M+SG
xifódimos	xifódimo+A+M+PL
xifofilazinha	xifófilo+A+DIM+F+SG
xifofilazinhas	xifófilo+A+DIM+F+PL
xifofilinha	xifófilo+A+DIM+F+SG
xifofilinhas	xifófilo+A+DIM+F+PL
xifofilinho	xifófilo+A+DIM+M+SG
xifofilinhos	xifófilo+A+DIM+M+PL
xifofilozinho	xifófilo+A+DIM+M+SG
xifofilozinhos	xifófilo+A+DIM+M+PL
xifófila	xifófilo+A+F+SG
xifófilas	xifófilo+A+F+PL
xifófilo	xifófilo+A+M+SG
xifófilos	xifófilo+A+M+PL
xifogapazinha	xifógapo+A+DIM+F+SG
xifogapazinhas	xifógapo+A+DIM+F+PL
xifogapinha	xifógapo+A+DIM+F+SG
xifogapinhas	xifógapo+A+DIM+F+PL
xifogapinho	xifógapo+A+DIM+M+SG
xifogapinhos	xifógapo+A+DIM+M+PL
xifogapozinho	xifógapo+A+DIM+M+SG
xifogapozinhos	xifógapo+A+DIM+M+PL
xifógapa	xifógapo+A+F+SG
xifógapas	xifógapo+A+F+PL
xifógapo	xifógapo+A+M+SG
xifógapos	xifógapo+A+M+PL
xifoidezinha	xifóide+A+DIM+F+SG
xifoidezinhas	xifóide+A+DIM+F+PL
xifoidezinho	xifóide+A+DIM+M+SG
xifoidezinhos	xifóide+A+DIM+M+PL
xifoidinha	xifóide+A+DIM+F+SG
xifoidinhas	xifóide+A+DIM+F+PL
xifoidinho	xifóide+A+DIM+M+SG
xifoidinhos	xifóide+A+DIM+M+PL
xifóide	xifóide+A+SG
xifóides	xifóide+A+PL
xifoideazinha	xifóideo+A+DIM+F+SG
xifoideazinhas	xifóideo+A+DIM+F+PL
xifoideinha	xifóideo+A+DIM+F+SG
xifoideinhas	xifóideo+A+DIM+F+PL
xifoideinho	xifóideo+A+DIM+M+SG
xifoideinhos	xifóideo+A+DIM+M+PL
xifoideozinho	xifóideo+A+DIM+M+SG
xifoideozinhos	xifóideo+A+DIM+M+PL
xifóidea	xifóideo+A+F+SG
xifóideas	xifóideo+A+F+PL
xifóideo	xifóideo+A+M+SG
xifóideos	xifóideo+A+M+PL
xifopagazinha	xifópago+A+DIM+F+SG
xifopagazinhas	xifópago+A+DIM+F+PL
xifopagozinho	xifópago+A+DIM+M+SG
xifopagozinhos	xifópago+A+DIM+M+PL
xifopaguinha	xifópago+A+DIM+F+SG
xifopaguinhas	xifópago+A+DIM+F+PL
xifopaguinho	xifópago+A+DIM+M+SG
xifopaguinhos	xifópago+A+DIM+M+PL
xifópaga	xifópago+A+F+SG
xifópagas	xifópago+A+F+PL
xifópago	xifópago+A+M+SG
xifópagos	xifópago+A+M+PL
xiita	xiita+A+SG
xiitas	xiita+A+PL
xiitazinha	xiita+A+DIM+F+SG
xiitazinhas	xiita+A+DIM+F+PL
xiitazinho	xiita+A+DIM+M+SG
xiitazinhos	xiita+A+DIM+M+PL
xiitinha	xiita+A+DIM+SG
xiitinhas	xiita+A+DIM+PL
xilematicazinha	xilemático+A+DIM+F+SG
xilematicazinhas	xilemático+A+DIM+F+PL
xilematicozinho	xilemático+A+DIM+M+SG
xilematicozinhos	xilemático+A+DIM+M+PL
xilematiquinha	xilemático+A+DIM+F+SG
xilematiquinhas	xilemático+A+DIM+F+PL
xilematiquinho	xilemático+A+DIM+M+SG
xilematiquinhos	xilemático+A+DIM+M+PL
xilemática	xilemático+A+F+SG
xilemáticas	xilemático+A+F+PL
xilemático	xilemático+A+M+SG
xilemáticos	xilemático+A+M+PL
xilocopideazinha	xilocopídeo+A+DIM+F+SG
xilocopideazinhas	xilocopídeo+A+DIM+F+PL
xilocopideinha	xilocopídeo+A+DIM+F+SG
xilocopideinhas	xilocopídeo+A+DIM+F+PL
xilocopideinho	xilocopídeo+A+DIM+M+SG
xilocopideinhos	xilocopídeo+A+DIM+M+PL
xilocopideozinho	xilocopídeo+A+DIM+M+SG
xilocopideozinhos	xilocopídeo+A+DIM+M+PL
xilocopídea	xilocopídeo+A+F+SG
xilocopídeas	xilocopídeo+A+F+PL
xilocopídeo	xilocopídeo+A+M+SG
xilocopídeos	xilocopídeo+A+M+PL
xilofonista	xilofonista+A+SG
xilofonistas	xilofonista+A+PL
xilofonistazinha	xilofonista+A+DIM+F+SG
xilofonistazinhas	xilofonista+A+DIM+F+PL
xilofonistazinho	xilofonista+A+DIM+M+SG
xilofonistazinhos	xilofonista+A+DIM+M+PL
xilofonistinha	xilofonista+A+DIM+SG
xilofonistinhas	xilofonista+A+DIM+PL
xilofagicazinha	xilofágico+A+DIM+F+SG
xilofagicazinhas	xilofágico+A+DIM+F+PL
xilofagicozinho	xilofágico+A+DIM+M+SG
xilofagicozinhos	xilofágico+A+DIM+M+PL
xilofagiquinha	xilofágico+A+DIM+F+SG
xilofagiquinhas	xilofágico+A+DIM+F+PL
xilofagiquinho	xilofágico+A+DIM+M+SG
xilofagiquinhos	xilofágico+A+DIM+M+PL
xilofágica	xilofágico+A+F+SG
xilofágicas	xilofágico+A+F+PL
xilofágico	xilofágico+A+M+SG
xilofágicos	xilofágico+A+M+PL
xiloglificazinha	xiloglífico+A+DIM+F+SG
xiloglificazinhas	xiloglífico+A+DIM+F+PL
xiloglificozinho	xiloglífico+A+DIM+M+SG
xiloglificozinhos	xiloglífico+A+DIM+M+PL
xiloglifiquinha	xiloglífico+A+DIM+F+SG
xiloglifiquinhas	xiloglífico+A+DIM+F+PL
xiloglifiquinho	xiloglífico+A+DIM+M+SG
xiloglifiquinhos	xiloglífico+A+DIM+M+PL
xiloglífica	xiloglífico+A+F+SG
xiloglíficas	xiloglífico+A+F+PL
xiloglífico	xiloglífico+A+M+SG
xiloglíficos	xiloglífico+A+M+PL
xilografaveizinhas	xilografável+A+DIM+F+PL
xilografaveizinhos	xilografável+A+DIM+M+PL
xilografavelzinha	xilografável+A+DIM+F+SG
xilografavelzinho	xilografável+A+DIM+M+SG
xilografáveis	xilografável+A+PL
xilografável	xilografável+A+SG
xilogravada	xilogravado+A+F+SG
xilogravadas	xilogravado+A+F+PL
xilogravadazinha	xilogravado+A+DIM+F+SG
xilogravadazinhas	xilogravado+A+DIM+F+PL
xilogravadinha	xilogravado+A+DIM+F+SG
xilogravadinhas	xilogravado+A+DIM+F+PL
xilogravadinho	xilogravado+A+DIM+M+SG
xilogravadinhos	xilogravado+A+DIM+M+PL
xilogravado	xilogravado+A+M+SG
xilogravados	xilogravado+A+M+PL
xilogravadozinho	xilogravado+A+DIM+M+SG
xilogravadozinhos	xilogravado+A+DIM+M+PL
xilogravaveizinhas	xilogravável+A+DIM+F+PL
xilogravaveizinhos	xilogravável+A+DIM+M+PL
xilogravavelzinha	xilogravável+A+DIM+F+SG
xilogravavelzinho	xilogravável+A+DIM+M+SG
xilograváveis	xilogravável+A+PL
xilogravável	xilogravável+A+SG
xilograficazinha	xilográfico+A+DIM+F+SG
xilograficazinhas	xilográfico+A+DIM+F+PL
xilograficozinho	xilográfico+A+DIM+M+SG
xilograficozinhos	xilográfico+A+DIM+M+PL
xilografiquinha	xilográfico+A+DIM+F+SG
xilografiquinhas	xilográfico+A+DIM+F+PL
xilografiquinho	xilográfico+A+DIM+M+SG
xilografiquinhos	xilográfico+A+DIM+M+PL
xilográfica	xilográfico+A+F+SG
xilográficas	xilográfico+A+F+PL
xilográfico	xilográfico+A+M+SG
xilográficos	xilográfico+A+M+PL
xiloide	xiloide+A+SG
xiloides	xiloide+A+PL
xiloidezinha	xiloide+A+DIM+F+SG
xiloidezinhas	xiloide+A+DIM+F+PL
xiloidezinho	xiloide+A+DIM+M+SG
xiloidezinhos	xiloide+A+DIM+M+PL
xiloidinha	xiloide+A+DIM+F+SG
xiloidinhas	xiloide+A+DIM+F+PL
xiloidinho	xiloide+A+DIM+M+SG
xiloidinhos	xiloide+A+DIM+M+PL
xilolatricazinha	xilolátrico+A+DIM+F+SG
xilolatricazinhas	xilolátrico+A+DIM+F+PL
xilolatricozinho	xilolátrico+A+DIM+M+SG
xilolatricozinhos	xilolátrico+A+DIM+M+PL
xilolatriquinha	xilolátrico+A+DIM+F+SG
xilolatriquinhas	xilolátrico+A+DIM+F+PL
xilolatriquinho	xilolátrico+A+DIM+M+SG
xilolatriquinhos	xilolátrico+A+DIM+M+PL
xilolátrica	xilolátrico+A+F+SG
xilolátricas	xilolátrico+A+F+PL
xilolátrico	xilolátrico+A+M+SG
xilolátricos	xilolátrico+A+M+PL
xilologicazinha	xilológico+A+DIM+F+SG
xilologicazinhas	xilológico+A+DIM+F+PL
xilologicozinho	xilológico+A+DIM+M+SG
xilologicozinhos	xilológico+A+DIM+M+PL
xilologiquinha	xilológico+A+DIM+F+SG
xilologiquinhas	xilológico+A+DIM+F+PL
xilologiquinho	xilológico+A+DIM+M+SG
xilologiquinhos	xilológico+A+DIM+M+PL
xilológica	xilológico+A+F+SG
xilológicas	xilológico+A+F+PL
xilológico	xilológico+A+M+SG
xilológicos	xilológico+A+M+PL
xilomicete	xilomicete+A+SG
xilomicetes	xilomicete+A+PL
xilomicetezinha	xilomicete+A+DIM+F+SG
xilomicetezinhas	xilomicete+A+DIM+F+PL
xilomicetezinho	xilomicete+A+DIM+M+SG
xilomicetezinhos	xilomicete+A+DIM+M+PL
xilomicetinha	xilomicete+A+DIM+F+SG
xilomicetinhas	xilomicete+A+DIM+F+PL
xilomicetinho	xilomicete+A+DIM+M+SG
xilomicetinhos	xilomicete+A+DIM+M+PL
xilomanticazinha	xilomântico+A+DIM+F+SG
xilomanticazinhas	xilomântico+A+DIM+F+PL
xilomanticozinho	xilomântico+A+DIM+M+SG
xilomanticozinhos	xilomântico+A+DIM+M+PL
xilomantiquinha	xilomântico+A+DIM+F+SG
xilomantiquinhas	xilomântico+A+DIM+F+PL
xilomantiquinho	xilomântico+A+DIM+M+SG
xilomantiquinhos	xilomântico+A+DIM+M+PL
xilomântica	xilomântico+A+F+SG
xilomânticas	xilomântico+A+F+PL
xilomântico	xilomântico+A+M+SG
xilomânticos	xilomântico+A+M+PL
xilenicazinha	xilénico+A+DIM+F+SG
xilenicazinhas	xilénico+A+DIM+F+PL
xilenicozinho	xilénico+A+DIM+M+SG
xilenicozinhos	xilénico+A+DIM+M+PL
xileniquinha	xilénico+A+DIM+F+SG
xileniquinhas	xilénico+A+DIM+F+PL
xileniquinho	xilénico+A+DIM+M+SG
xileniquinhos	xilénico+A+DIM+M+PL
xilénica	xilénico+A+F+SG
xilénicas	xilénico+A+F+PL
xilénico	xilénico+A+M+SG
xilénicos	xilénico+A+M+PL
xilenicazinha	xilênico+A+DIM+F+SG
xilenicazinhas	xilênico+A+DIM+F+PL
xilenicozinho	xilênico+A+DIM+M+SG
xilenicozinhos	xilênico+A+DIM+M+PL
xileniquinha	xilênico+A+DIM+F+SG
xileniquinhas	xilênico+A+DIM+F+PL
xileniquinho	xilênico+A+DIM+M+SG
xileniquinhos	xilênico+A+DIM+M+PL
xilênica	xilênico+A+F+SG
xilênicas	xilênico+A+F+PL
xilênico	xilênico+A+M+SG
xilênicos	xilênico+A+M+PL
xilocopazinha	xilócopo+A+DIM+F+SG
xilocopazinhas	xilócopo+A+DIM+F+PL
xilocopinha	xilócopo+A+DIM+F+SG
xilocopinhas	xilócopo+A+DIM+F+PL
xilocopinho	xilócopo+A+DIM+M+SG
xilocopinhos	xilócopo+A+DIM+M+PL
xilocopozinho	xilócopo+A+DIM+M+SG
xilocopozinhos	xilócopo+A+DIM+M+PL
xilócopa	xilócopo+A+F+SG
xilócopas	xilócopo+A+F+PL
xilócopo	xilócopo+A+M+SG
xilócopos	xilócopo+A+M+PL
xilofagazinha	xilófago+A+DIM+F+SG
xilofagazinhas	xilófago+A+DIM+F+PL
xilofagozinho	xilófago+A+DIM+M+SG
xilofagozinhos	xilófago+A+DIM+M+PL
xilofaguinha	xilófago+A+DIM+F+SG
xilofaguinhas	xilófago+A+DIM+F+PL
xilofaguinho	xilófago+A+DIM+M+SG
xilofaguinhos	xilófago+A+DIM+M+PL
xilófaga	xilófago+A+F+SG
xilófagas	xilófago+A+F+PL
xilófago	xilófago+A+M+SG
xilófagos	xilófago+A+M+PL
xilofilazinha	xilófilo+A+DIM+F+SG
xilofilazinhas	xilófilo+A+DIM+F+PL
xilofilinha	xilófilo+A+DIM+F+SG
xilofilinhas	xilófilo+A+DIM+F+PL
xilofilinho	xilófilo+A+DIM+M+SG
xilofilinhos	xilófilo+A+DIM+M+PL
xilofilozinho	xilófilo+A+DIM+M+SG
xilofilozinhos	xilófilo+A+DIM+M+PL
xilófila	xilófilo+A+F+SG
xilófilas	xilófilo+A+F+PL
xilófilo	xilófilo+A+M+SG
xilófilos	xilófilo+A+M+PL
xilogenazinha	xilógeno+A+DIM+F+SG
xilogenazinhas	xilógeno+A+DIM+F+PL
xilogeninha	xilógeno+A+DIM+F+SG
xilogeninhas	xilógeno+A+DIM+F+PL
xilogeninho	xilógeno+A+DIM+M+SG
xilogeninhos	xilógeno+A+DIM+M+PL
xilogenozinho	xilógeno+A+DIM+M+SG
xilogenozinhos	xilógeno+A+DIM+M+PL
xilógena	xilógeno+A+F+SG
xilógenas	xilógeno+A+F+PL
xilógeno	xilógeno+A+M+SG
xilógenos	xilógeno+A+M+PL
xiloidezinha	xilóide+A+DIM+F+SG
xiloidezinhas	xilóide+A+DIM+F+PL
xiloidezinho	xilóide+A+DIM+M+SG
xiloidezinhos	xilóide+A+DIM+M+PL
xiloidinha	xilóide+A+DIM+F+SG
xiloidinhas	xilóide+A+DIM+F+PL
xiloidinho	xilóide+A+DIM+M+SG
xiloidinhos	xilóide+A+DIM+M+PL
xilóide	xilóide+A+SG
xilóides	xilóide+A+PL
xilotomazinha	xilótomo+A+DIM+F+SG
xilotomazinhas	xilótomo+A+DIM+F+PL
xilotominha	xilótomo+A+DIM+F+SG
xilotominhas	xilótomo+A+DIM+F+PL
xilotominho	xilótomo+A+DIM+M+SG
xilotominhos	xilótomo+A+DIM+M+PL
xilotomozinho	xilótomo+A+DIM+M+SG
xilotomozinhos	xilótomo+A+DIM+M+PL
xilótoma	xilótomo+A+F+SG
xilótomas	xilótomo+A+F+PL
xilótomo	xilótomo+A+M+SG
xilótomos	xilótomo+A+M+PL
xingador	xingador+A+M+SG
xingadora	xingador+A+F+SG
xingadoras	xingador+A+F+PL
xingadorazinha	xingador+A+DIM+F+SG
xingadorazinhas	xingador+A+DIM+F+PL
xingadores	xingador+A+M+PL
xingadorezinhos	xingador+A+DIM+M+PL
xingadorinha	xingador+A+DIM+F+SG
xingadorinhas	xingador+A+DIM+F+PL
xingadorzinho	xingador+A+DIM+M+SG
xingadorzinhos	xingador+A+DIM+M+PL
xingatoriazinha	xingatório+A+DIM+F+SG
xingatoriazinhas	xingatório+A+DIM+F+PL
xingatorinha	xingatório+A+DIM+F+SG
xingatorinhas	xingatório+A+DIM+F+PL
xingatorinho	xingatório+A+DIM+M+SG
xingatorinhos	xingatório+A+DIM+M+PL
xingatoriozinho	xingatório+A+DIM+M+SG
xingatoriozinhos	xingatório+A+DIM+M+PL
xingatória	xingatório+A+F+SG
xingatórias	xingatório+A+F+PL
xingatório	xingatório+A+M+SG
xingatórios	xingatório+A+M+PL
xinguense	xinguense+A+SG
xinguenses	xinguense+A+PL
xinguensezinha	xinguense+A+DIM+F+SG
xinguensezinhas	xinguense+A+DIM+F+PL
xinguensezinho	xinguense+A+DIM+M+SG
xinguensezinhos	xinguense+A+DIM+M+PL
xinguensinha	xinguense+A+DIM+F+SG
xinguensinhas	xinguense+A+DIM+F+PL
xinguensinho	xinguense+A+DIM+M+SG
xinguensinhos	xinguense+A+DIM+M+PL
xingaveizinhas	xingável+A+DIM+F+PL
xingaveizinhos	xingável+A+DIM+M+PL
xingavelzinha	xingável+A+DIM+F+SG
xingavelzinho	xingável+A+DIM+M+SG
xingáveis	xingável+A+PL
xingável	xingável+A+SG
xintoistazinha	xintoísta+A+DIM+F+SG
xintoistazinhas	xintoísta+A+DIM+F+PL
xintoistazinho	xintoísta+A+DIM+M+SG
xintoistazinhos	xintoísta+A+DIM+M+PL
xintoistinha	xintoísta+A+DIM+SG
xintoistinhas	xintoísta+A+DIM+PL
xintoísta	xintoísta+A+SG
xintoístas	xintoísta+A+PL
xiquexiquense	xiquexiquense+A+SG
xiquexiquenses	xiquexiquense+A+PL
xiquexiquensezinha	xiquexiquense+A+DIM+F+SG
xiquexiquensezinhas	xiquexiquense+A+DIM+F+PL
xiquexiquensezinho	xiquexiquense+A+DIM+M+SG
xiquexiquensezinhos	xiquexiquense+A+DIM+M+PL
xiquexiquensinha	xiquexiquense+A+DIM+F+SG
xiquexiquensinhas	xiquexiquense+A+DIM+F+PL
xiquexiquensinho	xiquexiquense+A+DIM+M+SG
xiquexiquensinhos	xiquexiquense+A+DIM+M+PL
xiridaceazinha	xiridáceo+A+DIM+F+SG
xiridaceazinhas	xiridáceo+A+DIM+F+PL
xiridaceinha	xiridáceo+A+DIM+F+SG
xiridaceinhas	xiridáceo+A+DIM+F+PL
xiridaceinho	xiridáceo+A+DIM+M+SG
xiridaceinhos	xiridáceo+A+DIM+M+PL
xiridaceozinho	xiridáceo+A+DIM+M+SG
xiridaceozinhos	xiridáceo+A+DIM+M+PL
xiridácea	xiridáceo+A+F+SG
xiridáceas	xiridáceo+A+F+PL
xiridáceo	xiridáceo+A+M+SG
xiridáceos	xiridáceo+A+M+PL
xistenta	xistento+A+F+SG
xistentas	xistento+A+F+PL
xistentazinha	xistento+A+DIM+F+SG
xistentazinhas	xistento+A+DIM+F+PL
xistentinha	xistento+A+DIM+F+SG
xistentinhas	xistento+A+DIM+F+PL
xistentinho	xistento+A+DIM+M+SG
xistentinhos	xistento+A+DIM+M+PL
xistento	xistento+A+M+SG
xistentos	xistento+A+M+PL
xistentozinho	xistento+A+DIM+M+SG
xistentozinhos	xistento+A+DIM+M+PL
xistocarpa	xistocarpo+A+F+SG
xistocarpas	xistocarpo+A+F+PL
xistocarpazinha	xistocarpo+A+DIM+F+SG
xistocarpazinhas	xistocarpo+A+DIM+F+PL
xistocarpinha	xistocarpo+A+DIM+F+SG
xistocarpinhas	xistocarpo+A+DIM+F+PL
xistocarpinho	xistocarpo+A+DIM+M+SG
xistocarpinhos	xistocarpo+A+DIM+M+PL
xistocarpo	xistocarpo+A+M+SG
xistocarpos	xistocarpo+A+M+PL
xistocarpozinho	xistocarpo+A+DIM+M+SG
xistocarpozinhos	xistocarpo+A+DIM+M+PL
xistocristalina	xistocristalino+A+F+SG
xistocristalinas	xistocristalino+A+F+PL
xistocristalinazinha	xistocristalino+A+DIM+F+SG
xistocristalinazinhas	xistocristalino+A+DIM+F+PL
xistocristalininha	xistocristalino+A+DIM+F+SG
xistocristalininhas	xistocristalino+A+DIM+F+PL
xistocristalininho	xistocristalino+A+DIM+M+SG
xistocristalininhos	xistocristalino+A+DIM+M+PL
xistocristalino	xistocristalino+A+M+SG
xistocristalinos	xistocristalino+A+M+PL
xistocristalinozinho	xistocristalino+A+DIM+M+SG
xistocristalinozinhos	xistocristalino+A+DIM+M+PL
xistoide	xistoide+A+SG
xistoides	xistoide+A+PL
xistoidezinha	xistoide+A+DIM+F+SG
xistoidezinhas	xistoide+A+DIM+F+PL
xistoidezinho	xistoide+A+DIM+M+SG
xistoidezinhos	xistoide+A+DIM+M+PL
xistoidinha	xistoide+A+DIM+F+SG
xistoidinhas	xistoide+A+DIM+F+PL
xistoidinho	xistoide+A+DIM+M+SG
xistoidinhos	xistoide+A+DIM+M+PL
xistoquimicazinha	xistoquímico+A+DIM+F+SG
xistoquimicazinhas	xistoquímico+A+DIM+F+PL
xistoquimicozinho	xistoquímico+A+DIM+M+SG
xistoquimicozinhos	xistoquímico+A+DIM+M+PL
xistoquimiquinha	xistoquímico+A+DIM+F+SG
xistoquimiquinhas	xistoquímico+A+DIM+F+PL
xistoquimiquinho	xistoquímico+A+DIM+M+SG
xistoquimiquinhos	xistoquímico+A+DIM+M+PL
xistoquímica	xistoquímico+A+F+SG
xistoquímicas	xistoquímico+A+F+PL
xistoquímico	xistoquímico+A+M+SG
xistoquímicos	xistoquímico+A+M+PL
xistosa	xistoso+A+F+SG
xistosas	xistoso+A+F+PL
xistosazinha	xistoso+A+DIM+F+SG
xistosazinhas	xistoso+A+DIM+F+PL
xistosinha	xistoso+A+DIM+F+SG
xistosinhas	xistoso+A+DIM+F+PL
xistosinho	xistoso+A+DIM+M+SG
xistosinhos	xistoso+A+DIM+M+PL
xistoso	xistoso+A+M+SG
xistosos	xistoso+A+M+PL
xistosozinho	xistoso+A+DIM+M+SG
xistosozinhos	xistoso+A+DIM+M+PL
xistropodezinha	xistrópode+A+DIM+F+SG
xistropodezinhas	xistrópode+A+DIM+F+PL
xistropodezinho	xistrópode+A+DIM+M+SG
xistropodezinhos	xistrópode+A+DIM+M+PL
xistropodinha	xistrópode+A+DIM+F+SG
xistropodinhas	xistrópode+A+DIM+F+PL
xistropodinho	xistrópode+A+DIM+M+SG
xistropodinhos	xistrópode+A+DIM+M+PL
xistrópode	xistrópode+A+SG
xistrópodes	xistrópode+A+PL
xistaceazinha	xistáceo+A+DIM+F+SG
xistaceazinhas	xistáceo+A+DIM+F+PL
xistaceinha	xistáceo+A+DIM+F+SG
xistaceinhas	xistáceo+A+DIM+F+PL
xistaceinho	xistáceo+A+DIM+M+SG
xistaceinhos	xistáceo+A+DIM+M+PL
xistaceozinho	xistáceo+A+DIM+M+SG
xistaceozinhos	xistáceo+A+DIM+M+PL
xistácea	xistáceo+A+F+SG
xistáceas	xistáceo+A+F+PL
xistáceo	xistáceo+A+M+SG
xistáceos	xistáceo+A+M+PL
xistoidezinha	xistóide+A+DIM+F+SG
xistoidezinhas	xistóide+A+DIM+F+PL
xistoidezinho	xistóide+A+DIM+M+SG
xistoidezinhos	xistóide+A+DIM+M+PL
xistoidinha	xistóide+A+DIM+F+SG
xistoidinhas	xistóide+A+DIM+F+PL
xistoidinho	xistóide+A+DIM+M+SG
xistoidinhos	xistóide+A+DIM+M+PL
xistóide	xistóide+A+SG
xistóides	xistóide+A+PL
xixilada	xixilado+A+F+SG
xixiladas	xixilado+A+F+PL
xixiladazinha	xixilado+A+DIM+F+SG
xixiladazinhas	xixilado+A+DIM+F+PL
xixiladinha	xixilado+A+DIM+F+SG
xixiladinhas	xixilado+A+DIM+F+PL
xixiladinho	xixilado+A+DIM+M+SG
xixiladinhos	xixilado+A+DIM+M+PL
xixilado	xixilado+A+M+SG
xixilados	xixilado+A+M+PL
xixiladozinho	xixilado+A+DIM+M+SG
xixiladozinhos	xixilado+A+DIM+M+PL
xoclengue	xoclengue+A+SG
xoclengues	xoclengue+A+PL
xoclenguezinha	xoclengue+A+DIM+F+SG
xoclenguezinhas	xoclengue+A+DIM+F+PL
xoclenguezinho	xoclengue+A+DIM+M+SG
xoclenguezinhos	xoclengue+A+DIM+M+PL
xoclenguinha	xoclengue+A+DIM+F+SG
xoclenguinhas	xoclengue+A+DIM+F+PL
xoclenguinho	xoclengue+A+DIM+M+SG
xoclenguinhos	xoclengue+A+DIM+M+PL
xocaveizinhas	xocável+A+DIM+F+PL
xocaveizinhos	xocável+A+DIM+M+PL
xocavelzinha	xocável+A+DIM+F+SG
xocavelzinho	xocável+A+DIM+M+SG
xocáveis	xocável+A+PL
xocável	xocável+A+SG
xontaquira	xontaquiro+A+F+SG
xontaquiras	xontaquiro+A+F+PL
xontaquirazinha	xontaquiro+A+DIM+F+SG
xontaquirazinhas	xontaquiro+A+DIM+F+PL
xontaquirinha	xontaquiro+A+DIM+F+SG
xontaquirinhas	xontaquiro+A+DIM+F+PL
xontaquirinho	xontaquiro+A+DIM+M+SG
xontaquirinhos	xontaquiro+A+DIM+M+PL
xontaquiro	xontaquiro+A+M+SG
xontaquiros	xontaquiro+A+M+PL
xontaquirozinho	xontaquiro+A+DIM+M+SG
xontaquirozinhos	xontaquiro+A+DIM+M+PL
xorda	xordo+A+F+SG
xordas	xordo+A+F+PL
xordazinha	xordo+A+DIM+F+SG
xordazinhas	xordo+A+DIM+F+PL
xordinha	xordo+A+DIM+F+SG
xordinhas	xordo+A+DIM+F+PL
xordinho	xordo+A+DIM+M+SG
xordinhos	xordo+A+DIM+M+PL
xordo	xordo+A+M+SG
xordos	xordo+A+M+PL
xordozinho	xordo+A+DIM+M+SG
xordozinhos	xordo+A+DIM+M+PL
xotaveizinhas	xotável+A+DIM+F+PL
xotaveizinhos	xotável+A+DIM+M+PL
xotavelzinha	xotável+A+DIM+F+SG
xotavelzinho	xotável+A+DIM+M+SG
xotáveis	xotável+A+PL
xotável	xotável+A+SG
xucra	xucro+A+F+SG
xucras	xucro+A+F+PL
xucrazinha	xucro+A+DIM+F+SG
xucrazinhas	xucro+A+DIM+F+PL
xucrinha	xucro+A+DIM+F+SG
xucrinhas	xucro+A+DIM+F+PL
xucrinho	xucro+A+DIM+M+SG
xucrinhos	xucro+A+DIM+M+PL
xucro	xucro+A+M+SG
xucros	xucro+A+M+PL
xucrozinho	xucro+A+DIM+M+SG
xucrozinhos	xucro+A+DIM+M+PL
xumbergaveizinhas	xumbergável+A+DIM+F+PL
xumbergaveizinhos	xumbergável+A+DIM+M+PL
xumbergavelzinha	xumbergável+A+DIM+F+SG
xumbergavelzinho	xumbergável+A+DIM+M+SG
xumbergáveis	xumbergável+A+PL
xumbergável	xumbergável+A+SG
xumbregaveizinhas	xumbregável+A+DIM+F+PL
xumbregaveizinhos	xumbregável+A+DIM+M+PL
xumbregavelzinha	xumbregável+A+DIM+F+SG
xumbregavelzinho	xumbregável+A+DIM+M+SG
xumbregáveis	xumbregável+A+PL
xumbregável	xumbregável+A+SG
xuezinha	xué+A+DIM+F+SG
xuezinhas	xué+A+DIM+F+PL
xuezinho	xué+A+DIM+M+SG
xuezinhos	xué+A+DIM+M+PL
xué	xué+A+SG
xués	xué+A+PL
xanticazinha	xântico+A+DIM+F+SG
xanticazinhas	xântico+A+DIM+F+PL
xanticozinho	xântico+A+DIM+M+SG
xanticozinhos	xântico+A+DIM+M+PL
xantiquinha	xântico+A+DIM+F+SG
xantiquinhas	xântico+A+DIM+F+PL
xantiquinho	xântico+A+DIM+M+SG
xantiquinhos	xântico+A+DIM+M+PL
xântica	xântico+A+F+SG
xânticas	xântico+A+F+PL
xântico	xântico+A+M+SG
xânticos	xântico+A+M+PL
xantopazinha	xântopo+A+DIM+F+SG
xantopazinhas	xântopo+A+DIM+F+PL
xantopinha	xântopo+A+DIM+F+SG
xantopinhas	xântopo+A+DIM+F+PL
xantopinho	xântopo+A+DIM+M+SG
xantopinhos	xântopo+A+DIM+M+PL
xantopozinho	xântopo+A+DIM+M+SG
xantopozinhos	xântopo+A+DIM+M+PL
xântopa	xântopo+A+F+SG
xântopas	xântopo+A+F+PL
xântopo	xântopo+A+M+SG
xântopos	xântopo+A+M+PL
xenicazinha	xênico+A+DIM+F+SG
xenicazinhas	xênico+A+DIM+F+PL
xenicozinho	xênico+A+DIM+M+SG
xenicozinhos	xênico+A+DIM+M+PL
xeniquinha	xênico+A+DIM+F+SG
xeniquinhas	xênico+A+DIM+F+PL
xeniquinho	xênico+A+DIM+M+SG
xeniquinhos	xênico+A+DIM+M+PL
xênica	xênico+A+F+SG
xênicas	xênico+A+F+PL
xênico	xênico+A+M+SG
xênicos	xênico+A+M+PL
xilicazinha	xílico+A+DIM+F+SG
xilicazinhas	xílico+A+DIM+F+PL
xilicozinho	xílico+A+DIM+M+SG
xilicozinhos	xílico+A+DIM+M+PL
xiliquinha	xílico+A+DIM+F+SG
xiliquinhas	xílico+A+DIM+F+PL
xiliquinho	xílico+A+DIM+M+SG
xiliquinhos	xílico+A+DIM+M+PL
xílica	xílico+A+F+SG
xílicas	xílico+A+F+PL
xílico	xílico+A+M+SG
xílicos	xílico+A+M+PL
xisticazinha	xístico+A+DIM+F+SG
xisticazinhas	xístico+A+DIM+F+PL
xisticozinho	xístico+A+DIM+M+SG
xisticozinhos	xístico+A+DIM+M+PL
xistiquinha	xístico+A+DIM+F+SG
xistiquinhas	xístico+A+DIM+F+PL
xistiquinho	xístico+A+DIM+M+SG
xistiquinhos	xístico+A+DIM+M+PL
xística	xístico+A+F+SG
xísticas	xístico+A+F+PL
xístico	xístico+A+M+SG
xísticos	xístico+A+M+PL
