zabaneira	zabaneiro+A+F+SG
zabaneiras	zabaneiro+A+F+PL
zabaneirazinha	zabaneiro+A+DIM+F+SG
zabaneirazinhas	zabaneiro+A+DIM+F+PL
zabaneirinha	zabaneiro+A+DIM+F+SG
zabaneirinhas	zabaneiro+A+DIM+F+PL
zabaneirinho	zabaneiro+A+DIM+M+SG
zabaneirinhos	zabaneiro+A+DIM+M+PL
zabaneiro	zabaneiro+A+M+SG
zabaneiros	zabaneiro+A+M+PL
zabaneirozinho	zabaneiro+A+DIM+M+SG
zabaneirozinhos	zabaneiro+A+DIM+M+PL
zabela	zabelo+A+F+SG
zabelas	zabelo+A+F+PL
zabelazinha	zabelo+A+DIM+F+SG
zabelazinhas	zabelo+A+DIM+F+PL
zabelinha	zabelo+A+DIM+F+SG
zabelinhas	zabelo+A+DIM+F+PL
zabelinho	zabelo+A+DIM+M+SG
zabelinhos	zabelo+A+DIM+M+PL
zabelo	zabelo+A+M+SG
zabelos	zabelo+A+M+PL
zabelozinho	zabelo+A+DIM+M+SG
zabelozinhos	zabelo+A+DIM+M+PL
zabumbaveizinhas	zabumbável+A+DIM+F+PL
zabumbaveizinhos	zabumbável+A+DIM+M+PL
zabumbavelzinha	zabumbável+A+DIM+F+SG
zabumbavelzinho	zabumbável+A+DIM+M+SG
zabumbáveis	zabumbável+A+PL
zabumbável	zabumbável+A+SG
zaburra	zaburro+A+F+SG
zaburras	zaburro+A+F+PL
zaburrazinha	zaburro+A+DIM+F+SG
zaburrazinhas	zaburro+A+DIM+F+PL
zaburrinha	zaburro+A+DIM+F+SG
zaburrinhas	zaburro+A+DIM+F+PL
zaburrinho	zaburro+A+DIM+M+SG
zaburrinhos	zaburro+A+DIM+M+PL
zaburro	zaburro+A+M+SG
zaburros	zaburro+A+M+PL
zaburrozinho	zaburro+A+DIM+M+SG
zaburrozinhos	zaburro+A+DIM+M+PL
zacariense	zacariense+A+SG
zacarienses	zacariense+A+PL
zacariensezinha	zacariense+A+DIM+F+SG
zacariensezinhas	zacariense+A+DIM+F+PL
zacariensezinho	zacariense+A+DIM+M+SG
zacariensezinhos	zacariense+A+DIM+M+PL
zacariensinha	zacariense+A+DIM+F+SG
zacariensinhas	zacariense+A+DIM+F+PL
zacariensinho	zacariense+A+DIM+M+SG
zacariensinhos	zacariense+A+DIM+M+PL
zacateque	zacateque+A+SG
zacateques	zacateque+A+PL
zacatequezinha	zacateque+A+DIM+F+SG
zacatequezinhas	zacateque+A+DIM+F+PL
zacatequezinho	zacateque+A+DIM+M+SG
zacatequezinhos	zacateque+A+DIM+M+PL
zacatequinha	zacateque+A+DIM+F+SG
zacatequinhas	zacateque+A+DIM+F+PL
zacatequinho	zacateque+A+DIM+M+SG
zacatequinhos	zacateque+A+DIM+M+PL
zaconicazinha	zacónico+A+DIM+F+SG
zaconicazinhas	zacónico+A+DIM+F+PL
zaconicozinho	zacónico+A+DIM+M+SG
zaconicozinhos	zacónico+A+DIM+M+PL
zaconiquinha	zacónico+A+DIM+F+SG
zaconiquinhas	zacónico+A+DIM+F+PL
zaconiquinho	zacónico+A+DIM+M+SG
zaconiquinhos	zacónico+A+DIM+M+PL
zacónica	zacónico+A+F+SG
zacónicas	zacónico+A+F+PL
zacónico	zacónico+A+M+SG
zacónicos	zacónico+A+M+PL
zaconicazinha	zacônico+A+DIM+F+SG
zaconicazinhas	zacônico+A+DIM+F+PL
zaconicozinho	zacônico+A+DIM+M+SG
zaconicozinhos	zacônico+A+DIM+M+PL
zaconiquinha	zacônico+A+DIM+F+SG
zaconiquinhas	zacônico+A+DIM+F+PL
zaconiquinho	zacônico+A+DIM+M+SG
zaconiquinhos	zacônico+A+DIM+M+PL
zacônica	zacônico+A+F+SG
zacônicas	zacônico+A+F+PL
zacônico	zacônico+A+M+SG
zacônicos	zacônico+A+M+PL
zafimeira	zafimeiro+A+F+SG
zafimeiras	zafimeiro+A+F+PL
zafimeirazinha	zafimeiro+A+DIM+F+SG
zafimeirazinhas	zafimeiro+A+DIM+F+PL
zafimeirinha	zafimeiro+A+DIM+F+SG
zafimeirinhas	zafimeiro+A+DIM+F+PL
zafimeirinho	zafimeiro+A+DIM+M+SG
zafimeirinhos	zafimeiro+A+DIM+M+PL
zafimeiro	zafimeiro+A+M+SG
zafimeiros	zafimeiro+A+M+PL
zafimeirozinho	zafimeiro+A+DIM+M+SG
zafimeirozinhos	zafimeiro+A+DIM+M+PL
zagaiaveizinhas	zagaiável+A+DIM+F+PL
zagaiaveizinhos	zagaiável+A+DIM+M+PL
zagaiavelzinha	zagaiável+A+DIM+F+SG
zagaiavelzinho	zagaiável+A+DIM+M+SG
zagaiáveis	zagaiável+A+PL
zagaiável	zagaiável+A+SG
zagalesca	zagalesco+A+F+SG
zagalescas	zagalesco+A+F+PL
zagalescazinha	zagalesco+A+DIM+F+SG
zagalescazinhas	zagalesco+A+DIM+F+PL
zagalesco	zagalesco+A+M+SG
zagalescos	zagalesco+A+M+PL
zagalescozinho	zagalesco+A+DIM+M+SG
zagalescozinhos	zagalesco+A+DIM+M+PL
zagalesquinha	zagalesco+A+DIM+F+SG
zagalesquinhas	zagalesco+A+DIM+F+PL
zagalesquinho	zagalesco+A+DIM+M+SG
zagalesquinhos	zagalesco+A+DIM+M+PL
zagorrina	zagorrino+A+F+SG
zagorrinas	zagorrino+A+F+PL
zagorrinazinha	zagorrino+A+DIM+F+SG
zagorrinazinhas	zagorrino+A+DIM+F+PL
zagorrininha	zagorrino+A+DIM+F+SG
zagorrininhas	zagorrino+A+DIM+F+PL
zagorrininho	zagorrino+A+DIM+M+SG
zagorrininhos	zagorrino+A+DIM+M+PL
zagorrino	zagorrino+A+M+SG
zagorrinos	zagorrino+A+M+PL
zagorrinozinho	zagorrino+A+DIM+M+SG
zagorrinozinhos	zagorrino+A+DIM+M+PL
zagorra	zagorro+A+F+SG
zagorras	zagorro+A+F+PL
zagorrazinha	zagorro+A+DIM+F+SG
zagorrazinhas	zagorro+A+DIM+F+PL
zagorrinha	zagorro+A+DIM+F+SG
zagorrinhas	zagorro+A+DIM+F+PL
zagorrinho	zagorro+A+DIM+M+SG
zagorrinhos	zagorro+A+DIM+M+PL
zagorro	zagorro+A+M+SG
zagorros	zagorro+A+M+PL
zagorrozinho	zagorro+A+DIM+M+SG
zagorrozinhos	zagorro+A+DIM+M+PL
zagrebina	zagrebino+A+F+SG
zagrebinas	zagrebino+A+F+PL
zagrebinazinha	zagrebino+A+DIM+F+SG
zagrebinazinhas	zagrebino+A+DIM+F+PL
zagrebininha	zagrebino+A+DIM+F+SG
zagrebininhas	zagrebino+A+DIM+F+PL
zagrebininho	zagrebino+A+DIM+M+SG
zagrebininhos	zagrebino+A+DIM+M+PL
zagrebino	zagrebino+A+M+SG
zagrebinos	zagrebino+A+M+PL
zagrebinozinho	zagrebino+A+DIM+M+SG
zagrebinozinhos	zagrebino+A+DIM+M+PL
zagrenta	zagrento+A+F+SG
zagrentas	zagrento+A+F+PL
zagrentazinha	zagrento+A+DIM+F+SG
zagrentazinhas	zagrento+A+DIM+F+PL
zagrentinha	zagrento+A+DIM+F+SG
zagrentinhas	zagrento+A+DIM+F+PL
zagrentinho	zagrento+A+DIM+M+SG
zagrentinhos	zagrento+A+DIM+M+PL
zagrento	zagrento+A+M+SG
zagrentos	zagrento+A+M+PL
zagrentozinho	zagrento+A+DIM+M+SG
zagrentozinhos	zagrento+A+DIM+M+PL
zagucha	zagucho+A+F+SG
zaguchas	zagucho+A+F+PL
zaguchazinha	zagucho+A+DIM+F+SG
zaguchazinhas	zagucho+A+DIM+F+PL
zaguchinha	zagucho+A+DIM+F+SG
zaguchinhas	zagucho+A+DIM+F+PL
zaguchinho	zagucho+A+DIM+M+SG
zaguchinhos	zagucho+A+DIM+M+PL
zagucho	zagucho+A+M+SG
zaguchos	zagucho+A+M+PL
zaguchozinho	zagucho+A+DIM+M+SG
zaguchozinhos	zagucho+A+DIM+M+PL
zagunchaveizinhas	zagunchável+A+DIM+F+PL
zagunchaveizinhos	zagunchável+A+DIM+M+PL
zagunchavelzinha	zagunchável+A+DIM+F+SG
zagunchavelzinho	zagunchável+A+DIM+M+SG
zaguncháveis	zagunchável+A+PL
zagunchável	zagunchável+A+SG
zaina	zaina+A+F+SG
zainas	zaina+A+F+PL
zainazinha	zaina+A+DIM+F+SG
zainazinhas	zaina+A+DIM+F+PL
zaininha	zaina+A+DIM+F+SG
zaininhas	zaina+A+DIM+F+PL
zaina	zaino+A+F+SG
zainas	zaino+A+F+PL
zainazinha	zaino+A+DIM+F+SG
zainazinhas	zaino+A+DIM+F+PL
zaininha	zaino+A+DIM+F+SG
zaininhas	zaino+A+DIM+F+PL
zaininho	zaino+A+DIM+M+SG
zaininhos	zaino+A+DIM+M+PL
zaino	zaino+A+M+SG
zainos	zaino+A+M+PL
zainozinho	zaino+A+DIM+M+SG
zainozinhos	zaino+A+DIM+M+PL
zairense	zairense+A+SG
zairenses	zairense+A+PL
zairensezinha	zairense+A+DIM+F+SG
zairensezinhas	zairense+A+DIM+F+PL
zairensezinho	zairense+A+DIM+M+SG
zairensezinhos	zairense+A+DIM+M+PL
zairensinha	zairense+A+DIM+F+SG
zairensinhas	zairense+A+DIM+F+PL
zairensinho	zairense+A+DIM+M+SG
zairensinhos	zairense+A+DIM+M+PL
zairiana	zairiano+A+F+SG
zairianas	zairiano+A+F+PL
zairianazinha	zairiano+A+DIM+F+SG
zairianazinhas	zairiano+A+DIM+F+PL
zairianinha	zairiano+A+DIM+F+SG
zairianinhas	zairiano+A+DIM+F+PL
zairianinho	zairiano+A+DIM+M+SG
zairianinhos	zairiano+A+DIM+M+PL
zairiano	zairiano+A+M+SG
zairianos	zairiano+A+M+PL
zairianozinho	zairiano+A+DIM+M+SG
zairianozinhos	zairiano+A+DIM+M+PL
zairista	zairista+A+SG
zairistas	zairista+A+PL
zairistazinha	zairista+A+DIM+F+SG
zairistazinhas	zairista+A+DIM+F+PL
zairistazinho	zairista+A+DIM+M+SG
zairistazinhos	zairista+A+DIM+M+PL
zairistinha	zairista+A+DIM+SG
zairistinhas	zairista+A+DIM+PL
zambaia	zambaio+A+F+SG
zambaias	zambaio+A+F+PL
zambaiazinha	zambaio+A+DIM+F+SG
zambaiazinhas	zambaio+A+DIM+F+PL
zambainha	zambaio+A+DIM+F+SG
zambainhas	zambaio+A+DIM+F+PL
zambainho	zambaio+A+DIM+M+SG
zambainhos	zambaio+A+DIM+M+PL
zambaio	zambaio+A+M+SG
zambaios	zambaio+A+M+PL
zambaiozinho	zambaio+A+DIM+M+SG
zambaiozinhos	zambaio+A+DIM+M+PL
zambana	zambana+A+SG
zambanas	zambana+A+PL
zambanazinha	zambana+A+DIM+F+SG
zambanazinhas	zambana+A+DIM+F+PL
zambanazinho	zambana+A+DIM+M+SG
zambanazinhos	zambana+A+DIM+M+PL
zambaninha	zambana+A+DIM+SG
zambaninhas	zambana+A+DIM+PL
zambeira	zambeiro+A+F+SG
zambeiras	zambeiro+A+F+PL
zambeirazinha	zambeiro+A+DIM+F+SG
zambeirazinhas	zambeiro+A+DIM+F+PL
zambeirinha	zambeiro+A+DIM+F+SG
zambeirinhas	zambeiro+A+DIM+F+PL
zambeirinho	zambeiro+A+DIM+M+SG
zambeirinhos	zambeiro+A+DIM+M+PL
zambeiro	zambeiro+A+M+SG
zambeiros	zambeiro+A+M+PL
zambeirozinho	zambeiro+A+DIM+M+SG
zambeirozinhos	zambeiro+A+DIM+M+PL
zambembe	zambembe+A+SG
zambembes	zambembe+A+PL
zambembezinha	zambembe+A+DIM+F+SG
zambembezinhas	zambembe+A+DIM+F+PL
zambembezinho	zambembe+A+DIM+M+SG
zambembezinhos	zambembe+A+DIM+M+PL
zambembinha	zambembe+A+DIM+F+SG
zambembinhas	zambembe+A+DIM+F+PL
zambembinho	zambembe+A+DIM+M+SG
zambembinhos	zambembe+A+DIM+M+PL
zambeta	zambeta+A+SG
zambetas	zambeta+A+PL
zambetazinha	zambeta+A+DIM+F+SG
zambetazinhas	zambeta+A+DIM+F+PL
zambetazinho	zambeta+A+DIM+M+SG
zambetazinhos	zambeta+A+DIM+M+PL
zambetinha	zambeta+A+DIM+SG
zambetinhas	zambeta+A+DIM+PL
zambiana	zambiano+A+F+SG
zambianas	zambiano+A+F+PL
zambianazinha	zambiano+A+DIM+F+SG
zambianazinhas	zambiano+A+DIM+F+PL
zambianinha	zambiano+A+DIM+F+SG
zambianinhas	zambiano+A+DIM+F+PL
zambianinho	zambiano+A+DIM+M+SG
zambianinhos	zambiano+A+DIM+M+PL
zambiano	zambiano+A+M+SG
zambianos	zambiano+A+M+PL
zambianozinho	zambiano+A+DIM+M+SG
zambianozinhos	zambiano+A+DIM+M+PL
zambiense	zambiense+A+SG
zambienses	zambiense+A+PL
zambiensezinha	zambiense+A+DIM+F+SG
zambiensezinhas	zambiense+A+DIM+F+PL
zambiensezinho	zambiense+A+DIM+M+SG
zambiensezinhos	zambiense+A+DIM+M+PL
zambiensinha	zambiense+A+DIM+F+SG
zambiensinhas	zambiense+A+DIM+F+PL
zambiensinho	zambiense+A+DIM+M+SG
zambiensinhos	zambiense+A+DIM+M+PL
zamba	zambo+A+F+SG
zambas	zambo+A+F+PL
zambazinha	zambo+A+DIM+F+SG
zambazinhas	zambo+A+DIM+F+PL
zambinha	zambo+A+DIM+F+SG
zambinhas	zambo+A+DIM+F+PL
zambinho	zambo+A+DIM+M+SG
zambinhos	zambo+A+DIM+M+PL
zambo	zambo+A+M+SG
zambos	zambo+A+M+PL
zambozinho	zambo+A+DIM+M+SG
zambozinhos	zambo+A+DIM+M+PL
zambra	zambro+A+F+SG
zambras	zambro+A+F+PL
zambrazinha	zambro+A+DIM+F+SG
zambrazinhas	zambro+A+DIM+F+PL
zambrinha	zambro+A+DIM+F+SG
zambrinhas	zambro+A+DIM+F+PL
zambrinho	zambro+A+DIM+M+SG
zambrinhos	zambro+A+DIM+M+PL
zambro	zambro+A+M+SG
zambros	zambro+A+M+PL
zambrozinho	zambro+A+DIM+M+SG
zambrozinhos	zambro+A+DIM+M+PL
zambulha	zambulha+A+SG
zambulhas	zambulha+A+PL
zambulhazinha	zambulha+A+DIM+F+SG
zambulhazinhas	zambulha+A+DIM+F+PL
zambulhazinho	zambulha+A+DIM+M+SG
zambulhazinhos	zambulha+A+DIM+M+PL
zambulhinha	zambulha+A+DIM+SG
zambulhinhas	zambulha+A+DIM+PL
zambulheira	zambulheira+A+F+SG
zambulheiras	zambulheira+A+F+PL
zambulheirazinha	zambulheira+A+DIM+F+SG
zambulheirazinhas	zambulheira+A+DIM+F+PL
zambulheirinha	zambulheira+A+DIM+F+SG
zambulheirinhas	zambulheira+A+DIM+F+PL
zamense	zamense+A+SG
zamenses	zamense+A+PL
zamensezinha	zamense+A+DIM+F+SG
zamensezinhas	zamense+A+DIM+F+PL
zamensezinho	zamense+A+DIM+M+SG
zamensezinhos	zamense+A+DIM+M+PL
zamensinha	zamense+A+DIM+F+SG
zamensinhas	zamense+A+DIM+F+PL
zamensinho	zamense+A+DIM+M+SG
zamensinhos	zamense+A+DIM+M+PL
zamiaceazinha	zamiáceo+A+DIM+F+SG
zamiaceazinhas	zamiáceo+A+DIM+F+PL
zamiaceinha	zamiáceo+A+DIM+F+SG
zamiaceinhas	zamiáceo+A+DIM+F+PL
zamiaceinho	zamiáceo+A+DIM+M+SG
zamiaceinhos	zamiáceo+A+DIM+M+PL
zamiaceozinho	zamiáceo+A+DIM+M+SG
zamiaceozinhos	zamiáceo+A+DIM+M+PL
zamiácea	zamiáceo+A+F+SG
zamiáceas	zamiáceo+A+F+PL
zamiáceo	zamiáceo+A+M+SG
zamiáceos	zamiáceo+A+M+PL
zampaveizinhas	zampável+A+DIM+F+PL
zampaveizinhos	zampável+A+DIM+M+PL
zampavelzinha	zampável+A+DIM+F+SG
zampavelzinho	zampável+A+DIM+M+SG
zampáveis	zampável+A+PL
zampável	zampável+A+SG
zamuco	zamuco+A+SG
zamucos	zamuco+A+PL
zamucozinha	zamuco+A+DIM+F+SG
zamucozinhas	zamuco+A+DIM+F+PL
zamucozinho	zamuco+A+DIM+M+SG
zamucozinhos	zamuco+A+DIM+M+PL
zamuquinho	zamuco+A+DIM+SG
zamuquinhos	zamuco+A+DIM+PL
zanaga	zanaga+A+SG
zanagas	zanaga+A+PL
zanagazinha	zanaga+A+DIM+F+SG
zanagazinhas	zanaga+A+DIM+F+PL
zanagazinho	zanaga+A+DIM+M+SG
zanagazinhos	zanaga+A+DIM+M+PL
zanaguinha	zanaga+A+DIM+SG
zanaguinhas	zanaga+A+DIM+PL
zanaga	zanago+A+F+SG
zanagas	zanago+A+F+PL
zanagazinha	zanago+A+DIM+F+SG
zanagazinhas	zanago+A+DIM+F+PL
zanago	zanago+A+SG
zanagos	zanago+A+PL
zanagozinha	zanago+A+DIM+F+SG
zanagozinhas	zanago+A+DIM+F+PL
zanagozinho	zanago+A+DIM+M+SG
zanagozinhos	zanago+A+DIM+M+PL
zanaguinha	zanago+A+DIM+F+SG
zanaguinhas	zanago+A+DIM+F+PL
zanaguinho	zanago+A+DIM+SG
zanaguinhos	zanago+A+DIM+PL
zanatense	zanatense+A+SG
zanatenses	zanatense+A+PL
zanatensezinha	zanatense+A+DIM+F+SG
zanatensezinhas	zanatense+A+DIM+F+PL
zanatensezinho	zanatense+A+DIM+M+SG
zanatensezinhos	zanatense+A+DIM+M+PL
zanatensinha	zanatense+A+DIM+F+SG
zanatensinhas	zanatense+A+DIM+F+PL
zanatensinho	zanatense+A+DIM+M+SG
zanatensinhos	zanatense+A+DIM+M+PL
zancleia	zancleia+A+F+SG
zancleias	zancleia+A+F+PL
zancleiazinha	zancleia+A+DIM+F+SG
zancleiazinhas	zancleia+A+DIM+F+PL
zancleinha	zancleia+A+DIM+F+SG
zancleinhas	zancleia+A+DIM+F+PL
zancleu	zancleu+A+M+SG
zancleus	zancleu+A+M+PL
zancleuzinho	zancleu+A+DIM+M+SG
zancleuzinhos	zancleu+A+DIM+M+PL
zanclideazinha	zanclídeo+A+DIM+F+SG
zanclideazinhas	zanclídeo+A+DIM+F+PL
zanclideinha	zanclídeo+A+DIM+F+SG
zanclideinhas	zanclídeo+A+DIM+F+PL
zanclideinho	zanclídeo+A+DIM+M+SG
zanclideinhos	zanclídeo+A+DIM+M+PL
zanclideozinho	zanclídeo+A+DIM+M+SG
zanclideozinhos	zanclídeo+A+DIM+M+PL
zanclídea	zanclídeo+A+F+SG
zanclídeas	zanclídeo+A+F+PL
zanclídeo	zanclídeo+A+M+SG
zanclídeos	zanclídeo+A+M+PL
zandavalense	zandavalense+A+SG
zandavalenses	zandavalense+A+PL
zandavalensezinha	zandavalense+A+DIM+F+SG
zandavalensezinhas	zandavalense+A+DIM+F+PL
zandavalensezinho	zandavalense+A+DIM+M+SG
zandavalensezinhos	zandavalense+A+DIM+M+PL
zandavalensinha	zandavalense+A+DIM+F+SG
zandavalensinhas	zandavalense+A+DIM+F+PL
zandavalensinho	zandavalense+A+DIM+M+SG
zandavalensinhos	zandavalense+A+DIM+M+PL
zande	zande+A+SG
zandes	zande+A+PL
zandezinha	zande+A+DIM+F+SG
zandezinhas	zande+A+DIM+F+PL
zandezinho	zande+A+DIM+M+SG
zandezinhos	zande+A+DIM+M+PL
zandinha	zande+A+DIM+F+SG
zandinhas	zande+A+DIM+F+PL
zandinho	zande+A+DIM+M+SG
zandinhos	zande+A+DIM+M+PL
zangadicinha	zangadiço+A+DIM+F+SG
zangadicinhas	zangadiço+A+DIM+F+PL
zangadicinho	zangadiço+A+DIM+M+SG
zangadicinhos	zangadiço+A+DIM+M+PL
zangadiça	zangadiço+A+F+SG
zangadiças	zangadiço+A+F+PL
zangadiçazinha	zangadiço+A+DIM+F+SG
zangadiçazinhas	zangadiço+A+DIM+F+PL
zangadiço	zangadiço+A+M+SG
zangadiços	zangadiço+A+M+PL
zangadiçozinho	zangadiço+A+DIM+M+SG
zangadiçozinhos	zangadiço+A+DIM+M+PL
zangada	zangado+A+F+SG
zangadas	zangado+A+F+PL
zangadazinha	zangado+A+DIM+F+SG
zangadazinhas	zangado+A+DIM+F+PL
zangadazita	zangado+A+DIM+F+SG
zangadazitas	zangado+A+DIM+F+PL
zangadinha	zangado+A+DIM+F+SG
zangadinhas	zangado+A+DIM+F+PL
zangadinho	zangado+A+DIM+M+SG
zangadinhos	zangado+A+DIM+M+PL
zangadita	zangado+A+DIM+F+SG
zangaditas	zangado+A+DIM+F+PL
zangadito	zangado+A+DIM+M+SG
zangaditos	zangado+A+DIM+M+PL
zangado	zangado+A+M+SG
zangados	zangado+A+M+PL
zangadozinho	zangado+A+DIM+M+SG
zangadozinhos	zangado+A+DIM+M+PL
zangadozito	zangado+A+DIM+M+SG
zangadozitos	zangado+A+DIM+M+PL
zangadíssima	zangado+A+SUPER+F+SG
zangadíssimas	zangado+A+SUPER+F+PL
zangadíssimo	zangado+A+SUPER+M+SG
zangadíssimos	zangado+A+SUPER+M+PL
zangador	zangador+A+M+SG
zangadora	zangador+A+F+SG
zangadoras	zangador+A+F+PL
zangadorazinha	zangador+A+DIM+F+SG
zangadorazinhas	zangador+A+DIM+F+PL
zangadores	zangador+A+M+PL
zangadorezinhos	zangador+A+DIM+M+PL
zangadorinha	zangador+A+DIM+F+SG
zangadorinhas	zangador+A+DIM+F+PL
zangadorzinho	zangador+A+DIM+M+SG
zangadorzinhos	zangador+A+DIM+M+PL
zangarilhaveizinhas	zangarilhável+A+DIM+F+PL
zangarilhaveizinhos	zangarilhável+A+DIM+M+PL
zangarilhavelzinha	zangarilhável+A+DIM+F+SG
zangarilhavelzinho	zangarilhável+A+DIM+M+SG
zangarilháveis	zangarilhável+A+PL
zangarilhável	zangarilhável+A+SG
zangarreaveizinhas	zangarreável+A+DIM+F+PL
zangarreaveizinhos	zangarreável+A+DIM+M+PL
zangarreavelzinha	zangarreável+A+DIM+F+SG
zangarreavelzinho	zangarreável+A+DIM+M+SG
zangarreáveis	zangarreável+A+PL
zangarreável	zangarreável+A+SG
zanguizarreaveizinhas	zanguizarreável+A+DIM+F+PL
zanguizarreaveizinhos	zanguizarreável+A+DIM+M+PL
zanguizarreavelzinha	zanguizarreável+A+DIM+F+SG
zanguizarreavelzinho	zanguizarreável+A+DIM+M+SG
zanguizarreáveis	zanguizarreável+A+PL
zanguizarreável	zanguizarreável+A+SG
zangurraveizinhas	zangurrável+A+DIM+F+PL
zangurraveizinhos	zangurrável+A+DIM+M+PL
zangurravelzinha	zangurrável+A+DIM+F+SG
zangurravelzinho	zangurrável+A+DIM+M+SG
zangurráveis	zangurrável+A+PL
zangurrável	zangurrável+A+SG
zangaveizinhas	zangável+A+DIM+F+PL
zangaveizinhos	zangável+A+DIM+M+PL
zangavelzinha	zangável+A+DIM+F+SG
zangavelzinho	zangável+A+DIM+M+SG
zangáveis	zangável+A+PL
zangável	zangável+A+SG
zanoia	zanoio+A+F+SG
zanoias	zanoio+A+F+PL
zanoiazinha	zanoio+A+DIM+F+SG
zanoiazinhas	zanoio+A+DIM+F+PL
zanoinha	zanoio+A+DIM+F+SG
zanoinhas	zanoio+A+DIM+F+PL
zanoinho	zanoio+A+DIM+M+SG
zanoinhos	zanoio+A+DIM+M+PL
zanoio	zanoio+A+M+SG
zanoios	zanoio+A+M+PL
zanoiozinho	zanoio+A+DIM+M+SG
zanoiozinhos	zanoio+A+DIM+M+PL
zanolha	zanolho+A+F+SG
zanolhas	zanolho+A+F+PL
zanolhazinha	zanolho+A+DIM+F+SG
zanolhazinhas	zanolho+A+DIM+F+PL
zanolhinha	zanolho+A+DIM+F+SG
zanolhinhas	zanolho+A+DIM+F+PL
zanolhinho	zanolho+A+DIM+M+SG
zanolhinhos	zanolho+A+DIM+M+PL
zanolho	zanolho+A+M+SG
zanolhos	zanolho+A+M+PL
zanolhozinho	zanolho+A+DIM+M+SG
zanolhozinhos	zanolho+A+DIM+M+PL
zanzador	zanzador+A+M+SG
zanzadora	zanzador+A+F+SG
zanzadoras	zanzador+A+F+PL
zanzadorazinha	zanzador+A+DIM+F+SG
zanzadorazinhas	zanzador+A+DIM+F+PL
zanzadores	zanzador+A+M+PL
zanzadorezinhos	zanzador+A+DIM+M+PL
zanzadorinha	zanzador+A+DIM+F+SG
zanzadorinhas	zanzador+A+DIM+F+PL
zanzadorzinho	zanzador+A+DIM+M+SG
zanzadorzinhos	zanzador+A+DIM+M+PL
zanzarilhaveizinhas	zanzarilhável+A+DIM+F+PL
zanzarilhaveizinhos	zanzarilhável+A+DIM+M+PL
zanzarilhavelzinha	zanzarilhável+A+DIM+F+SG
zanzarilhavelzinho	zanzarilhável+A+DIM+M+SG
zanzarilháveis	zanzarilhável+A+PL
zanzarilhável	zanzarilhável+A+SG
zanzibarita	zanzibarita+A+SG
zanzibaritas	zanzibarita+A+PL
zanzibaritazinha	zanzibarita+A+DIM+F+SG
zanzibaritazinhas	zanzibarita+A+DIM+F+PL
zanzibaritazinho	zanzibarita+A+DIM+M+SG
zanzibaritazinhos	zanzibarita+A+DIM+M+PL
zanzibaritinha	zanzibarita+A+DIM+SG
zanzibaritinhas	zanzibarita+A+DIM+PL
zanzaveizinhas	zanzável+A+DIM+F+PL
zanzaveizinhos	zanzável+A+DIM+M+PL
zanzavelzinha	zanzável+A+DIM+F+SG
zanzavelzinho	zanzável+A+DIM+M+SG
zanzáveis	zanzável+A+PL
zanzável	zanzável+A+SG
zapatista	zapatista+A+SG
zapatistas	zapatista+A+PL
zapatistazinha	zapatista+A+DIM+F+SG
zapatistazinhas	zapatista+A+DIM+F+PL
zapatistazinho	zapatista+A+DIM+M+SG
zapatistazinhos	zapatista+A+DIM+M+PL
zapatistinha	zapatista+A+DIM+SG
zapatistinhas	zapatista+A+DIM+PL
zaragateaveizinhas	zaragateável+A+DIM+F+PL
zaragateaveizinhos	zaragateável+A+DIM+M+PL
zaragateavelzinha	zaragateável+A+DIM+F+SG
zaragateavelzinho	zaragateável+A+DIM+M+SG
zaragateáveis	zaragateável+A+PL
zaragateável	zaragateável+A+SG
zaragatoaveizinhas	zaragatoável+A+DIM+F+PL
zaragatoaveizinhos	zaragatoável+A+DIM+M+PL
zaragatoavelzinha	zaragatoável+A+DIM+F+SG
zaragatoavelzinho	zaragatoável+A+DIM+M+SG
zaragatoáveis	zaragatoável+A+PL
zaragatoável	zaragatoável+A+SG
zaranzaveizinhas	zaranzável+A+DIM+F+PL
zaranzaveizinhos	zaranzável+A+DIM+M+PL
zaranzavelzinha	zaranzável+A+DIM+F+SG
zaranzavelzinho	zaranzável+A+DIM+M+SG
zaranzáveis	zaranzável+A+PL
zaranzável	zaranzável+A+SG
zarca	zarco+A+F+SG
zarcas	zarco+A+F+PL
zarcazinha	zarco+A+DIM+F+SG
zarcazinhas	zarco+A+DIM+F+PL
zarco	zarco+A+M+SG
zarcos	zarco+A+M+PL
zarcozinho	zarco+A+DIM+M+SG
zarcozinhos	zarco+A+DIM+M+PL
zarquinha	zarco+A+DIM+F+SG
zarquinhas	zarco+A+DIM+F+PL
zarquinho	zarco+A+DIM+M+SG
zarquinhos	zarco+A+DIM+M+PL
zarelhaveizinhas	zarelhável+A+DIM+F+PL
zarelhaveizinhos	zarelhável+A+DIM+M+PL
zarelhavelzinha	zarelhável+A+DIM+F+SG
zarelhavelzinho	zarelhável+A+DIM+M+SG
zarelháveis	zarelhável+A+PL
zarelhável	zarelhável+A+SG
zarga	zargo+A+F+SG
zargas	zargo+A+F+PL
zargazinha	zargo+A+DIM+F+SG
zargazinhas	zargo+A+DIM+F+PL
zargo	zargo+A+M+SG
zargos	zargo+A+M+PL
zargozinho	zargo+A+DIM+M+SG
zargozinhos	zargo+A+DIM+M+PL
zarguinha	zargo+A+DIM+F+SG
zarguinhas	zargo+A+DIM+F+PL
zarguinho	zargo+A+DIM+M+SG
zarguinhos	zargo+A+DIM+M+PL
zargunchaveizinhas	zargunchável+A+DIM+F+PL
zargunchaveizinhos	zargunchável+A+DIM+M+PL
zargunchavelzinha	zargunchável+A+DIM+F+SG
zargunchavelzinho	zargunchável+A+DIM+M+SG
zarguncháveis	zargunchável+A+PL
zargunchável	zargunchável+A+SG
zarolha	zarolho+A+F+SG
zarolhas	zarolho+A+F+PL
zarolhazinha	zarolho+A+DIM+F+SG
zarolhazinhas	zarolho+A+DIM+F+PL
zarolhinha	zarolho+A+DIM+F+SG
zarolhinhas	zarolho+A+DIM+F+PL
zarolhinho	zarolho+A+DIM+M+SG
zarolhinhos	zarolho+A+DIM+M+PL
zarolho	zarolho+A+M+SG
zarolhos	zarolho+A+M+PL
zarolhozinho	zarolho+A+DIM+M+SG
zarolhozinhos	zarolho+A+DIM+M+PL
zarpada	zarpado+A+F+SG
zarpadas	zarpado+A+F+PL
zarpadazinha	zarpado+A+DIM+F+SG
zarpadazinhas	zarpado+A+DIM+F+PL
zarpadinha	zarpado+A+DIM+F+SG
zarpadinhas	zarpado+A+DIM+F+PL
zarpadinho	zarpado+A+DIM+M+SG
zarpadinhos	zarpado+A+DIM+M+PL
zarpado	zarpado+A+M+SG
zarpados	zarpado+A+M+PL
zarpadozinho	zarpado+A+DIM+M+SG
zarpadozinhos	zarpado+A+DIM+M+PL
zarpaveizinhas	zarpável+A+DIM+F+PL
zarpaveizinhos	zarpável+A+DIM+M+PL
zarpavelzinha	zarpável+A+DIM+F+SG
zarpavelzinho	zarpável+A+DIM+M+SG
zarpáveis	zarpável+A+PL
zarpável	zarpável+A+SG
zarra	zarro+A+F+SG
zarras	zarro+A+F+PL
zarrazinha	zarro+A+DIM+F+SG
zarrazinhas	zarro+A+DIM+F+PL
zarrinha	zarro+A+DIM+F+SG
zarrinhas	zarro+A+DIM+F+PL
zarrinho	zarro+A+DIM+M+SG
zarrinhos	zarro+A+DIM+M+PL
zarro	zarro+A+M+SG
zarros	zarro+A+M+PL
zarrozinho	zarro+A+DIM+M+SG
zarrozinhos	zarro+A+DIM+M+PL
zaruca	zaruca+A+SG
zarucas	zaruca+A+PL
zarucazinha	zaruca+A+DIM+F+SG
zarucazinhas	zaruca+A+DIM+F+PL
zarucazinho	zaruca+A+DIM+M+SG
zarucazinhos	zaruca+A+DIM+M+PL
zaruco	zaruca+A+M+SG
zarucos	zaruca+A+M+PL
zarucozinho	zaruca+A+DIM+M+SG
zarucozinhos	zaruca+A+DIM+M+PL
zaruquinha	zaruca+A+DIM+SG
zaruquinhas	zaruca+A+DIM+PL
zaruquinho	zaruca+A+DIM+M+SG
zaruquinhos	zaruca+A+DIM+M+PL
zarezinha	zaré+A+DIM+F+SG
zarezinhas	zaré+A+DIM+F+PL
zarezinho	zaré+A+DIM+M+SG
zarezinhos	zaré+A+DIM+M+PL
zaré	zaré+A+SG
zarés	zaré+A+PL
zavada	zavado+A+F+SG
zavadas	zavado+A+F+PL
zavadazinha	zavado+A+DIM+F+SG
zavadazinhas	zavado+A+DIM+F+PL
zavadinha	zavado+A+DIM+F+SG
zavadinhas	zavado+A+DIM+F+PL
zavadinho	zavado+A+DIM+M+SG
zavadinhos	zavado+A+DIM+M+PL
zavado	zavado+A+M+SG
zavados	zavado+A+M+PL
zavadozinho	zavado+A+DIM+M+SG
zavadozinhos	zavado+A+DIM+M+PL
zavaneira	zavaneira+A+F+SG
zavaneiras	zavaneira+A+F+PL
zavaneirazinha	zavaneira+A+DIM+F+SG
zavaneirazinhas	zavaneira+A+DIM+F+PL
zavaneirinha	zavaneira+A+DIM+F+SG
zavaneirinhas	zavaneira+A+DIM+F+PL
zavaveizinhas	zavável+A+DIM+F+PL
zavaveizinhos	zavável+A+DIM+M+PL
zavavelzinha	zavável+A+DIM+F+SG
zavavelzinho	zavável+A+DIM+M+SG
zaváveis	zavável+A+PL
zavável	zavável+A+SG
zazumbaveizinhas	zazumbável+A+DIM+F+PL
zazumbaveizinhos	zazumbável+A+DIM+M+PL
zazumbavelzinha	zazumbável+A+DIM+F+SG
zazumbavelzinho	zazumbável+A+DIM+M+SG
zazumbáveis	zazumbável+A+PL
zazumbável	zazumbável+A+SG
zairidazinha	zaírida+A+DIM+F+SG
zairidazinhas	zaírida+A+DIM+F+PL
zairidazinho	zaírida+A+DIM+M+SG
zairidazinhos	zaírida+A+DIM+M+PL
zairidinha	zaírida+A+DIM+SG
zairidinhas	zaírida+A+DIM+PL
zaírida	zaírida+A+SG
zaíridas	zaírida+A+PL
zebrada	zebrado+A+F+SG
zebradas	zebrado+A+F+PL
zebradazinha	zebrado+A+DIM+F+SG
zebradazinhas	zebrado+A+DIM+F+PL
zebradinha	zebrado+A+DIM+F+SG
zebradinhas	zebrado+A+DIM+F+PL
zebradinho	zebrado+A+DIM+M+SG
zebradinhos	zebrado+A+DIM+M+PL
zebrado	zebrado+A+M+SG
zebrados	zebrado+A+M+PL
zebradozinho	zebrado+A+DIM+M+SG
zebradozinhos	zebrado+A+DIM+M+PL
zebrais	zebral+A+PL
zebraizinhas	zebral+A+DIM+F+PL
zebraizinhos	zebral+A+DIM+M+PL
zebral	zebral+A+SG
zebralzinha	zebral+A+DIM+F+SG
zebralzinho	zebral+A+DIM+M+SG
zebrina	zebrino+A+F+SG
zebrinas	zebrino+A+F+PL
zebrinazinha	zebrino+A+DIM+F+SG
zebrinazinhas	zebrino+A+DIM+F+PL
zebrininha	zebrino+A+DIM+F+SG
zebrininhas	zebrino+A+DIM+F+PL
zebrininho	zebrino+A+DIM+M+SG
zebrininhos	zebrino+A+DIM+M+PL
zebrino	zebrino+A+M+SG
zebrinos	zebrino+A+M+PL
zebrinozinho	zebrino+A+DIM+M+SG
zebrinozinhos	zebrino+A+DIM+M+PL
zebroide	zebroide+A+SG
zebroides	zebroide+A+PL
zebroidezinha	zebroide+A+DIM+F+SG
zebroidezinhas	zebroide+A+DIM+F+PL
zebroidezinho	zebroide+A+DIM+M+SG
zebroidezinhos	zebroide+A+DIM+M+PL
zebroidinha	zebroide+A+DIM+F+SG
zebroidinhas	zebroide+A+DIM+F+PL
zebroidinho	zebroide+A+DIM+M+SG
zebroidinhos	zebroide+A+DIM+M+PL
zebrum	zebrum+A+SG
zebruns	zebrum+A+PL
zebrunzinha	zebrum+A+DIM+F+SG
zebrunzinhas	zebrum+A+DIM+F+PL
zebrunzinho	zebrum+A+DIM+M+SG
zebrunzinhos	zebrum+A+DIM+M+PL
zebruna	zebruno+A+F+SG
zebrunas	zebruno+A+F+PL
zebrunazinha	zebruno+A+DIM+F+SG
zebrunazinhas	zebruno+A+DIM+F+PL
zebruninha	zebruno+A+DIM+F+SG
zebruninhas	zebruno+A+DIM+F+PL
zebruninho	zebruno+A+DIM+M+SG
zebruninhos	zebruno+A+DIM+M+PL
zebruno	zebruno+A+M+SG
zebrunos	zebruno+A+M+PL
zebrunozinho	zebruno+A+DIM+M+SG
zebrunozinhos	zebruno+A+DIM+M+PL
zebrariazinha	zebrário+A+DIM+F+SG
zebrariazinhas	zebrário+A+DIM+F+PL
zebrarinha	zebrário+A+DIM+F+SG
zebrarinhas	zebrário+A+DIM+F+PL
zebrarinho	zebrário+A+DIM+M+SG
zebrarinhos	zebrário+A+DIM+M+PL
zebrariozinho	zebrário+A+DIM+M+SG
zebrariozinhos	zebrário+A+DIM+M+PL
zebrária	zebrário+A+F+SG
zebrárias	zebrário+A+F+PL
zebrário	zebrário+A+M+SG
zebrários	zebrário+A+M+PL
zebraveizinhas	zebrável+A+DIM+F+PL
zebraveizinhos	zebrável+A+DIM+M+PL
zebravelzinha	zebrável+A+DIM+F+SG
zebravelzinho	zebrável+A+DIM+M+SG
zebráveis	zebrável+A+PL
zebrável	zebrável+A+SG
zebroidezinha	zebróide+A+DIM+F+SG
zebroidezinhas	zebróide+A+DIM+F+PL
zebroidezinho	zebróide+A+DIM+M+SG
zebroidezinhos	zebróide+A+DIM+M+PL
zebroidinha	zebróide+A+DIM+F+SG
zebroidinhas	zebróide+A+DIM+F+PL
zebroidinho	zebróide+A+DIM+M+SG
zebroidinhos	zebróide+A+DIM+M+PL
zebróide	zebróide+A+SG
zebróides	zebróide+A+PL
zebu	zebu+A+SG
zebus	zebu+A+PL
zebuzinha	zebu+A+DIM+F+SG
zebuzinhas	zebu+A+DIM+F+PL
zebuzinho	zebu+A+DIM+M+SG
zebuzinhos	zebu+A+DIM+M+PL
zebuinazinha	zebuíno+A+DIM+F+SG
zebuinazinhas	zebuíno+A+DIM+F+PL
zebuininha	zebuíno+A+DIM+F+SG
zebuininhas	zebuíno+A+DIM+F+PL
zebuininho	zebuíno+A+DIM+M+SG
zebuininhos	zebuíno+A+DIM+M+PL
zebuinozinho	zebuíno+A+DIM+M+SG
zebuinozinhos	zebuíno+A+DIM+M+PL
zebuína	zebuíno+A+F+SG
zebuínas	zebuíno+A+F+PL
zebuíno	zebuíno+A+M+SG
zebuínos	zebuíno+A+M+PL
zefirina	zefirino+A+F+SG
zefirinas	zefirino+A+F+PL
zefirinazinha	zefirino+A+DIM+F+SG
zefirinazinhas	zefirino+A+DIM+F+PL
zefirininha	zefirino+A+DIM+F+SG
zefirininhas	zefirino+A+DIM+F+PL
zefirininho	zefirino+A+DIM+M+SG
zefirininhos	zefirino+A+DIM+M+PL
zefirino	zefirino+A+M+SG
zefirinos	zefirino+A+M+PL
zefirinozinho	zefirino+A+DIM+M+SG
zefirinozinhos	zefirino+A+DIM+M+PL
zelador	zelador+A+M+SG
zeladora	zelador+A+F+SG
zeladoras	zelador+A+F+PL
zeladorazinha	zelador+A+DIM+F+SG
zeladorazinhas	zelador+A+DIM+F+PL
zeladores	zelador+A+M+PL
zeladorezinhos	zelador+A+DIM+M+PL
zeladorinha	zelador+A+DIM+F+SG
zeladorinhas	zelador+A+DIM+F+PL
zeladorzinho	zelador+A+DIM+M+SG
zeladorzinhos	zelador+A+DIM+M+PL
zelandesa	zelandês+A+F+SG
zelandesas	zelandês+A+F+PL
zelandesazinha	zelandês+A+DIM+F+SG
zelandesazinhas	zelandês+A+DIM+F+PL
zelandeses	zelandês+A+PL
zelandesezinhas	zelandês+A+DIM+F+PL
zelandesezinhos	zelandês+A+DIM+M+PL
zelandesinha	zelandês+A+DIM+F+SG
zelandesinhas	zelandês+A+DIM+F+PL
zelandesinho	zelandês+A+DIM+M+SG
zelandesinhos	zelandês+A+DIM+M+PL
zelandês	zelandês+A+SG
zelante	zelante+A+SG
zelantes	zelante+A+PL
zelantezinha	zelante+A+DIM+F+SG
zelantezinhas	zelante+A+DIM+F+PL
zelantezinho	zelante+A+DIM+M+SG
zelantezinhos	zelante+A+DIM+M+PL
zelantinha	zelante+A+DIM+F+SG
zelantinhas	zelante+A+DIM+F+PL
zelantinho	zelante+A+DIM+M+SG
zelantinhos	zelante+A+DIM+M+PL
zelosa	zeloso+A+F+SG
zelosas	zeloso+A+F+PL
zelosazinha	zeloso+A+DIM+F+SG
zelosazinhas	zeloso+A+DIM+F+PL
zelosinha	zeloso+A+DIM+F+SG
zelosinhas	zeloso+A+DIM+F+PL
zelosinho	zeloso+A+DIM+M+SG
zelosinhos	zeloso+A+DIM+M+PL
zeloso	zeloso+A+M+SG
zelosos	zeloso+A+M+PL
zelosozinho	zeloso+A+DIM+M+SG
zelosozinhos	zeloso+A+DIM+M+PL
zelota	zelota+A+SG
zelotas	zelota+A+PL
zelotazinha	zelota+A+DIM+F+SG
zelotazinhas	zelota+A+DIM+F+PL
zelotazinho	zelota+A+DIM+M+SG
zelotazinhos	zelota+A+DIM+M+PL
zelotinha	zelota+A+DIM+SG
zelotinhas	zelota+A+DIM+PL
zelote	zelote+A+SG
zelotes	zelote+A+PL
zelotezinha	zelote+A+DIM+F+SG
zelotezinhas	zelote+A+DIM+F+PL
zelotezinho	zelote+A+DIM+M+SG
zelotezinhos	zelote+A+DIM+M+PL
zelotinha	zelote+A+DIM+F+SG
zelotinhas	zelote+A+DIM+F+PL
zelotinho	zelote+A+DIM+M+SG
zelotinhos	zelote+A+DIM+M+PL
zelaveizinhas	zelável+A+DIM+F+PL
zelaveizinhos	zelável+A+DIM+M+PL
zelavelzinha	zelável+A+DIM+F+SG
zelavelzinho	zelável+A+DIM+M+SG
zeláveis	zelável+A+PL
zelável	zelável+A+SG
zembra	zembro+A+F+SG
zembras	zembro+A+F+PL
zembrazinha	zembro+A+DIM+F+SG
zembrazinhas	zembro+A+DIM+F+PL
zembrinha	zembro+A+DIM+F+SG
zembrinhas	zembro+A+DIM+F+PL
zembrinho	zembro+A+DIM+M+SG
zembrinhos	zembro+A+DIM+M+PL
zembro	zembro+A+M+SG
zembros	zembro+A+M+PL
zembrozinho	zembro+A+DIM+M+SG
zembrozinhos	zembro+A+DIM+M+PL
zen	zen+A+SG
zens	zen+A+PL
zenzinha	zen+A+DIM+F+SG
zenzinhas	zen+A+DIM+F+PL
zenzinho	zen+A+DIM+M+SG
zenzinhos	zen+A+DIM+M+PL
zen-budista	zen-budista+A+SG
zen-budistas	zen-budista+A+PL
zen-budistazinha	zen-budista+A+DIM+F+SG
zen-budistazinhas	zen-budista+A+DIM+F+PL
zen-budistazinho	zen-budista+A+DIM+M+SG
zen-budistazinhos	zen-budista+A+DIM+M+PL
zen-budistinha	zen-budista+A+DIM+SG
zen-budistinhas	zen-budista+A+DIM+PL
zenda	zenda+A+SG
zendas	zenda+A+PL
zendazinha	zenda+A+DIM+F+SG
zendazinhas	zenda+A+DIM+F+PL
zendazinho	zenda+A+DIM+M+SG
zendazinhos	zenda+A+DIM+M+PL
zendinha	zenda+A+DIM+SG
zendinhas	zenda+A+DIM+PL
zenitais	zenital+A+PL
zenitaizinhas	zenital+A+DIM+F+PL
zenitaizinhos	zenital+A+DIM+M+PL
zenital	zenital+A+SG
zenitalzinha	zenital+A+DIM+F+SG
zenitalzinho	zenital+A+DIM+M+SG
zenonicazinha	zenónico+A+DIM+F+SG
zenonicazinhas	zenónico+A+DIM+F+PL
zenonicozinho	zenónico+A+DIM+M+SG
zenonicozinhos	zenónico+A+DIM+M+PL
zenoniquinha	zenónico+A+DIM+F+SG
zenoniquinhas	zenónico+A+DIM+F+PL
zenoniquinho	zenónico+A+DIM+M+SG
zenoniquinhos	zenónico+A+DIM+M+PL
zenónica	zenónico+A+F+SG
zenónicas	zenónico+A+F+PL
zenónico	zenónico+A+M+SG
zenónicos	zenónico+A+M+PL
zenonicazinha	zenônico+A+DIM+F+SG
zenonicazinhas	zenônico+A+DIM+F+PL
zenonicozinho	zenônico+A+DIM+M+SG
zenonicozinhos	zenônico+A+DIM+M+PL
zenoniquinha	zenônico+A+DIM+F+SG
zenoniquinhas	zenônico+A+DIM+F+PL
zenoniquinho	zenônico+A+DIM+M+SG
zenoniquinhos	zenônico+A+DIM+M+PL
zenônica	zenônico+A+F+SG
zenônicas	zenônico+A+F+PL
zenônico	zenônico+A+M+SG
zenônicos	zenônico+A+M+PL
zeoliticozinho	zeolítico+A+DIM+M+SG
zeoliticozinhos	zeolítico+A+DIM+M+PL
zeolitiquinho	zeolítico+A+DIM+M+SG
zeolitiquinhos	zeolítico+A+DIM+M+PL
zeolítico	zeolítico+A+M+SG
zeolíticos	zeolítico+A+M+PL
zerada	zerado+A+F+SG
zeradas	zerado+A+F+PL
zeradazinha	zerado+A+DIM+F+SG
zeradazinhas	zerado+A+DIM+F+PL
zeradinha	zerado+A+DIM+F+SG
zeradinhas	zerado+A+DIM+F+PL
zeradinho	zerado+A+DIM+M+SG
zeradinhos	zerado+A+DIM+M+PL
zerado	zerado+A+M+SG
zerados	zerado+A+M+PL
zeradozinho	zerado+A+DIM+M+SG
zeradozinhos	zerado+A+DIM+M+PL
zero-quilometrinho	zero-quilómetro+A+DIM+SG
zero-quilometrinhos	zero-quilómetro+A+DIM+PL
zero-quilometrozinha	zero-quilómetro+A+DIM+F+SG
zero-quilometrozinhas	zero-quilómetro+A+DIM+F+PL
zero-quilometrozinho	zero-quilómetro+A+DIM+M+SG
zero-quilometrozinhos	zero-quilómetro+A+DIM+M+PL
zero-quilómetro	zero-quilómetro+A
zerezinha	zerê+A+DIM+F+SG
zerezinhas	zerê+A+DIM+F+PL
zerezinho	zerê+A+DIM+M+SG
zerezinhos	zerê+A+DIM+M+PL
zerê	zerê+A+SG
zerês	zerê+A+PL
zeteticazinha	zetético+A+DIM+F+SG
zeteticazinhas	zetético+A+DIM+F+PL
zeteticozinho	zetético+A+DIM+M+SG
zeteticozinhos	zetético+A+DIM+M+PL
zetetiquinha	zetético+A+DIM+F+SG
zetetiquinhas	zetético+A+DIM+F+PL
zetetiquinho	zetético+A+DIM+M+SG
zetetiquinhos	zetético+A+DIM+M+PL
zetética	zetético+A+F+SG
zetéticas	zetético+A+F+PL
zetético	zetético+A+M+SG
zetéticos	zetético+A+M+PL
zeugitana	zeugitano+A+F+SG
zeugitanas	zeugitano+A+F+PL
zeugitanazinha	zeugitano+A+DIM+F+SG
zeugitanazinhas	zeugitano+A+DIM+F+PL
zeugitaninha	zeugitano+A+DIM+F+SG
zeugitaninhas	zeugitano+A+DIM+F+PL
zeugitaninho	zeugitano+A+DIM+M+SG
zeugitaninhos	zeugitano+A+DIM+M+PL
zeugitano	zeugitano+A+M+SG
zeugitanos	zeugitano+A+M+PL
zeugitanozinho	zeugitano+A+DIM+M+SG
zeugitanozinhos	zeugitano+A+DIM+M+PL
zeugmaticazinha	zeugmático+A+DIM+F+SG
zeugmaticazinhas	zeugmático+A+DIM+F+PL
zeugmaticozinho	zeugmático+A+DIM+M+SG
zeugmaticozinhos	zeugmático+A+DIM+M+PL
zeugmatiquinha	zeugmático+A+DIM+F+SG
zeugmatiquinhas	zeugmático+A+DIM+F+PL
zeugmatiquinho	zeugmático+A+DIM+M+SG
zeugmatiquinhos	zeugmático+A+DIM+M+PL
zeugmática	zeugmático+A+F+SG
zeugmáticas	zeugmático+A+F+PL
zeugmático	zeugmático+A+M+SG
zeugmáticos	zeugmático+A+M+PL
zeogagazinha	zeógago+A+DIM+F+SG
zeogagazinhas	zeógago+A+DIM+F+PL
zeogagozinho	zeógago+A+DIM+M+SG
zeogagozinhos	zeógago+A+DIM+M+PL
zeogaguinha	zeógago+A+DIM+F+SG
zeogaguinhas	zeógago+A+DIM+F+PL
zeogaguinho	zeógago+A+DIM+M+SG
zeogaguinhos	zeógago+A+DIM+M+PL
zeógaga	zeógago+A+F+SG
zeógagas	zeógago+A+F+PL
zeógago	zeógago+A+M+SG
zeógagos	zeógago+A+M+PL
zibelina	zibelina+A+F+SG
zibelinas	zibelina+A+F+PL
zibelinazinha	zibelina+A+DIM+F+SG
zibelinazinhas	zibelina+A+DIM+F+PL
zibelininha	zibelina+A+DIM+F+SG
zibelininhas	zibelina+A+DIM+F+PL
zichaveizinhas	zichável+A+DIM+F+PL
zichaveizinhos	zichável+A+DIM+M+PL
zichavelzinha	zichável+A+DIM+F+SG
zichavelzinho	zichável+A+DIM+M+SG
zicháveis	zichável+A+PL
zichável	zichável+A+SG
zigobranquiazinha	zigobrânquio+A+DIM+F+SG
zigobranquiazinhas	zigobrânquio+A+DIM+F+PL
zigobranquinha	zigobrânquio+A+DIM+F+SG
zigobranquinhas	zigobrânquio+A+DIM+F+PL
zigobranquinho	zigobrânquio+A+DIM+M+SG
zigobranquinhos	zigobrânquio+A+DIM+M+PL
zigobranquiozinho	zigobrânquio+A+DIM+M+SG
zigobranquiozinhos	zigobrânquio+A+DIM+M+PL
zigobrânquia	zigobrânquio+A+F+SG
zigobrânquias	zigobrânquio+A+F+PL
zigobrânquio	zigobrânquio+A+M+SG
zigobrânquios	zigobrânquio+A+M+PL
zigocardiacazinha	zigocardíaco+A+DIM+F+SG
zigocardiacazinhas	zigocardíaco+A+DIM+F+PL
zigocardiacozinho	zigocardíaco+A+DIM+M+SG
zigocardiacozinhos	zigocardíaco+A+DIM+M+PL
zigocardiaquinha	zigocardíaco+A+DIM+F+SG
zigocardiaquinhas	zigocardíaco+A+DIM+F+PL
zigocardiaquinho	zigocardíaco+A+DIM+M+SG
zigocardiaquinhos	zigocardíaco+A+DIM+M+PL
zigocardíaca	zigocardíaco+A+F+SG
zigocardíacas	zigocardíaco+A+F+PL
zigocardíaco	zigocardíaco+A+M+SG
zigocardíacos	zigocardíaco+A+M+PL
zigodonte	zigodonte+A+SG
zigodontes	zigodonte+A+PL
zigodontezinha	zigodonte+A+DIM+F+SG
zigodontezinhas	zigodonte+A+DIM+F+PL
zigodontezinho	zigodonte+A+DIM+M+SG
zigodontezinhos	zigodonte+A+DIM+M+PL
zigodontinha	zigodonte+A+DIM+F+SG
zigodontinhas	zigodonte+A+DIM+F+PL
zigodontinho	zigodonte+A+DIM+M+SG
zigodontinhos	zigodonte+A+DIM+M+PL
zigodactilazinha	zigodáctilo+A+DIM+F+SG
zigodactilazinhas	zigodáctilo+A+DIM+F+PL
zigodactilinha	zigodáctilo+A+DIM+F+SG
zigodactilinhas	zigodáctilo+A+DIM+F+PL
zigodactilinho	zigodáctilo+A+DIM+M+SG
zigodactilinhos	zigodáctilo+A+DIM+M+PL
zigodactilozinho	zigodáctilo+A+DIM+M+SG
zigodactilozinhos	zigodáctilo+A+DIM+M+PL
zigodáctila	zigodáctilo+A+F+SG
zigodáctilas	zigodáctilo+A+F+PL
zigodáctilo	zigodáctilo+A+M+SG
zigodáctilos	zigodáctilo+A+M+PL
zigodatilazinha	zigodátilo+A+DIM+F+SG
zigodatilazinhas	zigodátilo+A+DIM+F+PL
zigodatilinha	zigodátilo+A+DIM+F+SG
zigodatilinhas	zigodátilo+A+DIM+F+PL
zigodatilinho	zigodátilo+A+DIM+M+SG
zigodatilinhos	zigodátilo+A+DIM+M+PL
zigodatilozinho	zigodátilo+A+DIM+M+SG
zigodatilozinhos	zigodátilo+A+DIM+M+PL
zigodátila	zigodátilo+A+F+SG
zigodátilas	zigodátilo+A+F+PL
zigodátilo	zigodátilo+A+M+SG
zigodátilos	zigodátilo+A+M+PL
zigofilaceazinha	zigofiláceo+A+DIM+F+SG
zigofilaceazinhas	zigofiláceo+A+DIM+F+PL
zigofilaceinha	zigofiláceo+A+DIM+F+SG
zigofilaceinhas	zigofiláceo+A+DIM+F+PL
zigofilaceinho	zigofiláceo+A+DIM+M+SG
zigofilaceinhos	zigofiláceo+A+DIM+M+PL
zigofilaceozinho	zigofiláceo+A+DIM+M+SG
zigofilaceozinhos	zigofiláceo+A+DIM+M+PL
zigofilácea	zigofiláceo+A+F+SG
zigofiláceas	zigofiláceo+A+F+PL
zigofiláceo	zigofiláceo+A+M+SG
zigofiláceos	zigofiláceo+A+M+PL
zigomatauricular	zigomatauricular+A+SG
zigomatauriculares	zigomatauricular+A+PL
zigomatauricularezinhas	zigomatauricular+A+DIM+F+PL
zigomatauricularezinhos	zigomatauricular+A+DIM+M+PL
zigomatauricularzinha	zigomatauricular+A+DIM+F+SG
zigomatauricularzinhas	zigomatauricular+A+DIM+F+PL
zigomatauricularzinho	zigomatauricular+A+DIM+M+SG
zigomatauricularzinhos	zigomatauricular+A+DIM+M+PL
zigomatolabiais	zigomatolabial+A+PL
zigomatolabiaizinhas	zigomatolabial+A+DIM+F+PL
zigomatolabiaizinhos	zigomatolabial+A+DIM+M+PL
zigomatolabial	zigomatolabial+A+SG
zigomatolabialzinha	zigomatolabial+A+DIM+F+SG
zigomatolabialzinho	zigomatolabial+A+DIM+M+SG
zigomatomaxilar	zigomatomaxilar+A+SG
zigomatomaxilares	zigomatomaxilar+A+PL
zigomatomaxilarezinhas	zigomatomaxilar+A+DIM+F+PL
zigomatomaxilarezinhos	zigomatomaxilar+A+DIM+M+PL
zigomatomaxilarzinha	zigomatomaxilar+A+DIM+F+SG
zigomatomaxilarzinhas	zigomatomaxilar+A+DIM+F+PL
zigomatomaxilarzinho	zigomatomaxilar+A+DIM+M+SG
zigomatomaxilarzinhos	zigomatomaxilar+A+DIM+M+PL
zigomorfa	zigomorfo+A+F+SG
zigomorfas	zigomorfo+A+F+PL
zigomorfazinha	zigomorfo+A+DIM+F+SG
zigomorfazinhas	zigomorfo+A+DIM+F+PL
zigomorfinha	zigomorfo+A+DIM+F+SG
zigomorfinhas	zigomorfo+A+DIM+F+PL
zigomorfinho	zigomorfo+A+DIM+M+SG
zigomorfinhos	zigomorfo+A+DIM+M+PL
zigomorfo	zigomorfo+A+M+SG
zigomorfos	zigomorfo+A+M+PL
zigomorfozinho	zigomorfo+A+DIM+M+SG
zigomorfozinhos	zigomorfo+A+DIM+M+PL
zigomaticazinha	zigomático+A+DIM+F+SG
zigomaticazinhas	zigomático+A+DIM+F+PL
zigomaticozinho	zigomático+A+DIM+M+SG
zigomaticozinhos	zigomático+A+DIM+M+PL
zigomatiquinha	zigomático+A+DIM+F+SG
zigomatiquinhas	zigomático+A+DIM+F+PL
zigomatiquinho	zigomático+A+DIM+M+SG
zigomatiquinhos	zigomático+A+DIM+M+PL
zigomática	zigomático+A+F+SG
zigomáticas	zigomático+A+F+PL
zigomático	zigomático+A+M+SG
zigomáticos	zigomático+A+M+PL
zigotena	zigoteno+A+F+SG
zigotenas	zigoteno+A+F+PL
zigotenazinha	zigoteno+A+DIM+F+SG
zigotenazinhas	zigoteno+A+DIM+F+PL
zigoteninha	zigoteno+A+DIM+F+SG
zigoteninhas	zigoteno+A+DIM+F+PL
zigoteninho	zigoteno+A+DIM+M+SG
zigoteninhos	zigoteno+A+DIM+M+PL
zigoteno	zigoteno+A+M+SG
zigotenos	zigoteno+A+M+PL
zigotenozinho	zigoteno+A+DIM+M+SG
zigotenozinhos	zigoteno+A+DIM+M+PL
zigotacticazinha	zigotáctico+A+DIM+F+SG
zigotacticazinhas	zigotáctico+A+DIM+F+PL
zigotacticozinho	zigotáctico+A+DIM+M+SG
zigotacticozinhos	zigotáctico+A+DIM+M+PL
zigotactiquinha	zigotáctico+A+DIM+F+SG
zigotactiquinhas	zigotáctico+A+DIM+F+PL
zigotactiquinho	zigotáctico+A+DIM+M+SG
zigotactiquinhos	zigotáctico+A+DIM+M+PL
zigotáctica	zigotáctico+A+F+SG
zigotácticas	zigotáctico+A+F+PL
zigotáctico	zigotáctico+A+M+SG
zigotácticos	zigotáctico+A+M+PL
zigotaticazinha	zigotático+A+DIM+F+SG
zigotaticazinhas	zigotático+A+DIM+F+PL
zigotaticozinho	zigotático+A+DIM+M+SG
zigotaticozinhos	zigotático+A+DIM+M+PL
zigotatiquinha	zigotático+A+DIM+F+SG
zigotatiquinhas	zigotático+A+DIM+F+PL
zigotatiquinho	zigotático+A+DIM+M+SG
zigotatiquinhos	zigotático+A+DIM+M+PL
zigotática	zigotático+A+F+SG
zigotáticas	zigotático+A+F+PL
zigotático	zigotático+A+M+SG
zigotáticos	zigotático+A+M+PL
ziguezagueante	ziguezagueante+A+SG
ziguezagueantes	ziguezagueante+A+PL
ziguezagueantezinha	ziguezagueante+A+DIM+F+SG
ziguezagueantezinhas	ziguezagueante+A+DIM+F+PL
ziguezagueantezinho	ziguezagueante+A+DIM+M+SG
ziguezagueantezinhos	ziguezagueante+A+DIM+M+PL
ziguezagueantinha	ziguezagueante+A+DIM+F+SG
ziguezagueantinhas	ziguezagueante+A+DIM+F+PL
ziguezagueantinho	ziguezagueante+A+DIM+M+SG
ziguezagueantinhos	ziguezagueante+A+DIM+M+PL
ziguezagueaveizinhas	ziguezagueável+A+DIM+F+PL
ziguezagueaveizinhos	ziguezagueável+A+DIM+M+PL
ziguezagueavelzinha	ziguezagueável+A+DIM+F+SG
ziguezagueavelzinho	ziguezagueável+A+DIM+M+SG
ziguezagueáveis	ziguezagueável+A+PL
ziguezagueável	ziguezagueável+A+SG
zimbabuana	zimbabuano+A+F+SG
zimbabuanas	zimbabuano+A+F+PL
zimbabuanazinha	zimbabuano+A+DIM+F+SG
zimbabuanazinhas	zimbabuano+A+DIM+F+PL
zimbabuaninha	zimbabuano+A+DIM+F+SG
zimbabuaninhas	zimbabuano+A+DIM+F+PL
zimbabuaninho	zimbabuano+A+DIM+M+SG
zimbabuaninhos	zimbabuano+A+DIM+M+PL
zimbabuano	zimbabuano+A+M+SG
zimbabuanos	zimbabuano+A+M+PL
zimbabuanozinho	zimbabuano+A+DIM+M+SG
zimbabuanozinhos	zimbabuano+A+DIM+M+PL
zimbabueana	zimbabueano+A+F+SG
zimbabueanas	zimbabueano+A+F+PL
zimbabueanazinha	zimbabueano+A+DIM+F+SG
zimbabueanazinhas	zimbabueano+A+DIM+F+PL
zimbabueaninha	zimbabueano+A+DIM+F+SG
zimbabueaninhas	zimbabueano+A+DIM+F+PL
zimbabueaninho	zimbabueano+A+DIM+M+SG
zimbabueaninhos	zimbabueano+A+DIM+M+PL
zimbabueano	zimbabueano+A+M+SG
zimbabueanos	zimbabueano+A+M+PL
zimbabueanozinho	zimbabueano+A+DIM+M+SG
zimbabueanozinhos	zimbabueano+A+DIM+M+PL
zimbabuense	zimbabuense+A+SG
zimbabuenses	zimbabuense+A+PL
zimbabuensezinha	zimbabuense+A+DIM+F+SG
zimbabuensezinhas	zimbabuense+A+DIM+F+PL
zimbabuensezinho	zimbabuense+A+DIM+M+SG
zimbabuensezinhos	zimbabuense+A+DIM+M+PL
zimbabuensinha	zimbabuense+A+DIM+F+SG
zimbabuensinhas	zimbabuense+A+DIM+F+PL
zimbabuensinho	zimbabuense+A+DIM+M+SG
zimbabuensinhos	zimbabuense+A+DIM+M+PL
zimbrada	zimbrado+A+F+SG
zimbradas	zimbrado+A+F+PL
zimbradazinha	zimbrado+A+DIM+F+SG
zimbradazinhas	zimbrado+A+DIM+F+PL
zimbradinha	zimbrado+A+DIM+F+SG
zimbradinhas	zimbrado+A+DIM+F+PL
zimbradinho	zimbrado+A+DIM+M+SG
zimbradinhos	zimbrado+A+DIM+M+PL
zimbrado	zimbrado+A+M+SG
zimbrados	zimbrado+A+M+PL
zimbradozinho	zimbrado+A+DIM+M+SG
zimbradozinhos	zimbrado+A+DIM+M+PL
zimbraveizinhas	zimbrável+A+DIM+F+PL
zimbraveizinhos	zimbrável+A+DIM+M+PL
zimbravelzinha	zimbrável+A+DIM+F+SG
zimbravelzinho	zimbrável+A+DIM+M+SG
zimbráveis	zimbrável+A+PL
zimbrável	zimbrável+A+SG
zimogenicazinha	zimogénico+A+DIM+F+SG
zimogenicazinhas	zimogénico+A+DIM+F+PL
zimogenicozinho	zimogénico+A+DIM+M+SG
zimogenicozinhos	zimogénico+A+DIM+M+PL
zimogeniquinha	zimogénico+A+DIM+F+SG
zimogeniquinhas	zimogénico+A+DIM+F+PL
zimogeniquinho	zimogénico+A+DIM+M+SG
zimogeniquinhos	zimogénico+A+DIM+M+PL
zimogénica	zimogénico+A+F+SG
zimogénicas	zimogénico+A+F+PL
zimogénico	zimogénico+A+M+SG
zimogénicos	zimogénico+A+M+PL
zimogenicazinha	zimogênico+A+DIM+F+SG
zimogenicazinhas	zimogênico+A+DIM+F+PL
zimogenicozinho	zimogênico+A+DIM+M+SG
zimogenicozinhos	zimogênico+A+DIM+M+PL
zimogeniquinha	zimogênico+A+DIM+F+SG
zimogeniquinhas	zimogênico+A+DIM+F+PL
zimogeniquinho	zimogênico+A+DIM+M+SG
zimogeniquinhos	zimogênico+A+DIM+M+PL
zimogênica	zimogênico+A+F+SG
zimogênicas	zimogênico+A+F+PL
zimogênico	zimogênico+A+M+SG
zimogênicos	zimogênico+A+M+PL
zimosimetricazinha	zimosimétrico+A+DIM+F+SG
zimosimetricazinhas	zimosimétrico+A+DIM+F+PL
zimosimetricozinho	zimosimétrico+A+DIM+M+SG
zimosimetricozinhos	zimosimétrico+A+DIM+M+PL
zimosimetriquinha	zimosimétrico+A+DIM+F+SG
zimosimetriquinhas	zimosimétrico+A+DIM+F+PL
zimosimetriquinho	zimosimétrico+A+DIM+M+SG
zimosimetriquinhos	zimosimétrico+A+DIM+M+PL
zimosimétrica	zimosimétrico+A+F+SG
zimosimétricas	zimosimétrico+A+F+PL
zimosimétrico	zimosimétrico+A+M+SG
zimosimétricos	zimosimétrico+A+M+PL
zimotecnicazinha	zimotécnico+A+DIM+F+SG
zimotecnicazinhas	zimotécnico+A+DIM+F+PL
zimotecnicozinho	zimotécnico+A+DIM+M+SG
zimotecnicozinhos	zimotécnico+A+DIM+M+PL
zimotecniquinha	zimotécnico+A+DIM+F+SG
zimotecniquinhas	zimotécnico+A+DIM+F+PL
zimotecniquinho	zimotécnico+A+DIM+M+SG
zimotecniquinhos	zimotécnico+A+DIM+M+PL
zimotécnica	zimotécnico+A+F+SG
zimotécnicas	zimotécnico+A+F+PL
zimotécnico	zimotécnico+A+M+SG
zimotécnicos	zimotécnico+A+M+PL
zimogenazinha	zimógeno+A+DIM+F+SG
zimogenazinhas	zimógeno+A+DIM+F+PL
zimogeninha	zimógeno+A+DIM+F+SG
zimogeninhas	zimógeno+A+DIM+F+PL
zimogeninho	zimógeno+A+DIM+M+SG
zimogeninhos	zimógeno+A+DIM+M+PL
zimogenozinho	zimógeno+A+DIM+M+SG
zimogenozinhos	zimógeno+A+DIM+M+PL
zimógena	zimógeno+A+F+SG
zimógenas	zimógeno+A+F+PL
zimógeno	zimógeno+A+M+SG
zimógenos	zimógeno+A+M+PL
zimoticazinha	zimótico+A+DIM+F+SG
zimoticazinhas	zimótico+A+DIM+F+PL
zimoticozinho	zimótico+A+DIM+M+SG
zimoticozinhos	zimótico+A+DIM+M+PL
zimotiquinha	zimótico+A+DIM+F+SG
zimotiquinhas	zimótico+A+DIM+F+PL
zimotiquinho	zimótico+A+DIM+M+SG
zimotiquinhos	zimótico+A+DIM+M+PL
zimótica	zimótico+A+F+SG
zimóticas	zimótico+A+F+PL
zimótico	zimótico+A+M+SG
zimóticos	zimótico+A+M+PL
zincada	zincado+A+F+SG
zincadas	zincado+A+F+PL
zincadazinha	zincado+A+DIM+F+SG
zincadazinhas	zincado+A+DIM+F+PL
zincadinha	zincado+A+DIM+F+SG
zincadinhas	zincado+A+DIM+F+PL
zincadinho	zincado+A+DIM+M+SG
zincadinhos	zincado+A+DIM+M+PL
zincado	zincado+A+M+SG
zincados	zincado+A+M+PL
zincadozinho	zincado+A+DIM+M+SG
zincadozinhos	zincado+A+DIM+M+PL
zincografaveizinhas	zincografável+A+DIM+F+PL
zincografaveizinhos	zincografável+A+DIM+M+PL
zincografavelzinha	zincografável+A+DIM+F+SG
zincografavelzinho	zincografável+A+DIM+M+SG
zincografáveis	zincografável+A+PL
zincografável	zincografável+A+SG
zincogravaveizinhas	zincogravável+A+DIM+F+PL
zincogravaveizinhos	zincogravável+A+DIM+M+PL
zincogravavelzinha	zincogravável+A+DIM+F+SG
zincogravavelzinho	zincogravável+A+DIM+M+SG
zincograváveis	zincogravável+A+PL
zincogravável	zincogravável+A+SG
zincograficazinha	zincográfico+A+DIM+F+SG
zincograficazinhas	zincográfico+A+DIM+F+PL
zincograficozinho	zincográfico+A+DIM+M+SG
zincograficozinhos	zincográfico+A+DIM+M+PL
zincografiquinha	zincográfico+A+DIM+F+SG
zincografiquinhas	zincográfico+A+DIM+F+PL
zincografiquinho	zincográfico+A+DIM+M+SG
zincografiquinhos	zincográfico+A+DIM+M+PL
zincográfica	zincográfico+A+F+SG
zincográficas	zincográfico+A+F+PL
zincográfico	zincográfico+A+M+SG
zincográficos	zincográfico+A+M+PL
zincaveizinhas	zincável+A+DIM+F+PL
zincaveizinhos	zincável+A+DIM+M+PL
zincavelzinha	zincável+A+DIM+F+SG
zincavelzinho	zincável+A+DIM+M+SG
zincáveis	zincável+A+PL
zincável	zincável+A+SG
zinciferazinha	zincífero+A+DIM+F+SG
zinciferazinhas	zincífero+A+DIM+F+PL
zinciferinha	zincífero+A+DIM+F+SG
zinciferinhas	zincífero+A+DIM+F+PL
zinciferinho	zincífero+A+DIM+M+SG
zinciferinhos	zincífero+A+DIM+M+PL
zinciferozinho	zincífero+A+DIM+M+SG
zinciferozinhos	zincífero+A+DIM+M+PL
zincífera	zincífero+A+F+SG
zincíferas	zincífero+A+F+PL
zincífero	zincífero+A+M+SG
zincíferos	zincífero+A+M+PL
zingador	zingador+A+M+SG
zingadora	zingador+A+F+SG
zingadoras	zingador+A+F+PL
zingadorazinha	zingador+A+DIM+F+SG
zingadorazinhas	zingador+A+DIM+F+PL
zingadores	zingador+A+M+PL
zingadorezinhos	zingador+A+DIM+M+PL
zingadorinha	zingador+A+DIM+F+SG
zingadorinhas	zingador+A+DIM+F+PL
zingadorzinho	zingador+A+DIM+M+SG
zingadorzinhos	zingador+A+DIM+M+PL
zingarelada	zingarelado+A+F+SG
zingareladas	zingarelado+A+F+PL
zingareladazinha	zingarelado+A+DIM+F+SG
zingareladazinhas	zingarelado+A+DIM+F+PL
zingareladinha	zingarelado+A+DIM+F+SG
zingareladinhas	zingarelado+A+DIM+F+PL
zingareladinho	zingarelado+A+DIM+M+SG
zingareladinhos	zingarelado+A+DIM+M+PL
zingarelado	zingarelado+A+M+SG
zingarelados	zingarelado+A+M+PL
zingareladozinho	zingarelado+A+DIM+M+SG
zingareladozinhos	zingarelado+A+DIM+M+PL
zingareaveizinhas	zingareável+A+DIM+F+PL
zingareaveizinhos	zingareável+A+DIM+M+PL
zingareavelzinha	zingareável+A+DIM+F+SG
zingareavelzinho	zingareável+A+DIM+M+SG
zingareáveis	zingareável+A+PL
zingareável	zingareável+A+SG
zingiberaceazinha	zingiberáceo+A+DIM+F+SG
zingiberaceazinhas	zingiberáceo+A+DIM+F+PL
zingiberaceinha	zingiberáceo+A+DIM+F+SG
zingiberaceinhas	zingiberáceo+A+DIM+F+PL
zingiberaceinho	zingiberáceo+A+DIM+M+SG
zingiberaceinhos	zingiberáceo+A+DIM+M+PL
zingiberaceozinho	zingiberáceo+A+DIM+M+SG
zingiberaceozinhos	zingiberáceo+A+DIM+M+PL
zingiberácea	zingiberáceo+A+F+SG
zingiberáceas	zingiberáceo+A+F+PL
zingiberáceo	zingiberáceo+A+M+SG
zingiberáceos	zingiberáceo+A+M+PL
zingraveizinhas	zingrável+A+DIM+F+PL
zingraveizinhos	zingrável+A+DIM+M+PL
zingravelzinha	zingrável+A+DIM+F+SG
zingravelzinho	zingrável+A+DIM+M+SG
zingráveis	zingrável+A+PL
zingrável	zingrável+A+SG
zinguerreaveizinhas	zinguerreável+A+DIM+F+PL
zinguerreaveizinhos	zinguerreável+A+DIM+M+PL
zinguerreavelzinha	zinguerreável+A+DIM+F+SG
zinguerreavelzinho	zinguerreável+A+DIM+M+SG
zinguerreáveis	zinguerreável+A+PL
zinguerreável	zinguerreável+A+SG
zingaveizinhas	zingável+A+DIM+F+PL
zingaveizinhos	zingável+A+DIM+M+PL
zingavelzinha	zingável+A+DIM+F+SG
zingavelzinho	zingável+A+DIM+M+SG
zingáveis	zingável+A+PL
zingável	zingável+A+SG
zinzilulaveizinhas	zinzilulável+A+DIM+F+PL
zinzilulaveizinhos	zinzilulável+A+DIM+M+PL
zinzilulavelzinha	zinzilulável+A+DIM+F+SG
zinzilulavelzinho	zinzilulável+A+DIM+M+SG
zinziluláveis	zinzilulável+A+PL
zinzilulável	zinzilulável+A+SG
zipaveizinhas	zipável+A+DIM+F+PL
zipaveizinhos	zipável+A+DIM+M+PL
zipavelzinha	zipável+A+DIM+F+SG
zipavelzinho	zipável+A+DIM+M+SG
zipáveis	zipável+A+PL
zipável	zipável+A+SG
zirbais	zirbal+A+PL
zirbaizinhas	zirbal+A+DIM+F+PL
zirbaizinhos	zirbal+A+DIM+M+PL
zirbal	zirbal+A+SG
zirbalzinha	zirbal+A+DIM+F+SG
zirbalzinho	zirbal+A+DIM+M+SG
zirconicazinha	zircónico+A+DIM+F+SG
zirconicazinhas	zircónico+A+DIM+F+PL
zirconicozinho	zircónico+A+DIM+M+SG
zirconicozinhos	zircónico+A+DIM+M+PL
zirconiquinha	zircónico+A+DIM+F+SG
zirconiquinhas	zircónico+A+DIM+F+PL
zirconiquinho	zircónico+A+DIM+M+SG
zirconiquinhos	zircónico+A+DIM+M+PL
zircónica	zircónico+A+F+SG
zircónicas	zircónico+A+F+PL
zircónico	zircónico+A+M+SG
zircónicos	zircónico+A+M+PL
zirconicazinha	zircônico+A+DIM+F+SG
zirconicazinhas	zircônico+A+DIM+F+PL
zirconicozinho	zircônico+A+DIM+M+SG
zirconicozinhos	zircônico+A+DIM+M+PL
zirconiquinha	zircônico+A+DIM+F+SG
zirconiquinhas	zircônico+A+DIM+F+PL
zirconiquinho	zircônico+A+DIM+M+SG
zirconiquinhos	zircônico+A+DIM+M+PL
zircônica	zircônico+A+F+SG
zircônicas	zircônico+A+F+PL
zircônico	zircônico+A+M+SG
zircônicos	zircônico+A+M+PL
zirraveizinhas	zirrável+A+DIM+F+PL
zirraveizinhos	zirrável+A+DIM+M+PL
zirravelzinha	zirrável+A+DIM+F+SG
zirravelzinho	zirrável+A+DIM+M+SG
zirráveis	zirrável+A+PL
zirrável	zirrável+A+SG
zizaniaveizinhas	zizaniável+A+DIM+F+PL
zizaniaveizinhos	zizaniável+A+DIM+M+PL
zizaniavelzinha	zizaniável+A+DIM+F+SG
zizaniavelzinho	zizaniável+A+DIM+M+SG
zizaniáveis	zizaniável+A+PL
zizaniável	zizaniável+A+SG
ziziaveizinhas	ziziável+A+DIM+F+PL
ziziaveizinhos	ziziável+A+DIM+M+PL
ziziavelzinha	ziziável+A+DIM+F+SG
ziziavelzinho	ziziável+A+DIM+M+SG
ziziáveis	ziziável+A+PL
ziziável	ziziável+A+SG
zodiacais	zodiacal+A+PL
zodiacaizinhas	zodiacal+A+DIM+F+PL
zodiacaizinhos	zodiacal+A+DIM+M+PL
zodiacal	zodiacal+A+SG
zodiacalzinha	zodiacal+A+DIM+F+SG
zodiacalzinho	zodiacal+A+DIM+M+SG
zoelectricazinha	zoeléctrico+A+DIM+F+SG
zoelectricazinhas	zoeléctrico+A+DIM+F+PL
zoelectricozinho	zoeléctrico+A+DIM+M+SG
zoelectricozinhos	zoeléctrico+A+DIM+M+PL
zoelectriquinha	zoeléctrico+A+DIM+F+SG
zoelectriquinhas	zoeléctrico+A+DIM+F+PL
zoelectriquinho	zoeléctrico+A+DIM+M+SG
zoelectriquinhos	zoeléctrico+A+DIM+M+PL
zoeléctrica	zoeléctrico+A+F+SG
zoeléctricas	zoeléctrico+A+F+PL
zoeléctrico	zoeléctrico+A+M+SG
zoeléctricos	zoeléctrico+A+M+PL
zoeletricazinha	zoelétrico+A+DIM+F+SG
zoeletricazinhas	zoelétrico+A+DIM+F+PL
zoeletricozinho	zoelétrico+A+DIM+M+SG
zoeletricozinhos	zoelétrico+A+DIM+M+PL
zoeletriquinha	zoelétrico+A+DIM+F+SG
zoeletriquinhas	zoelétrico+A+DIM+F+PL
zoeletriquinho	zoelétrico+A+DIM+M+SG
zoeletriquinhos	zoelétrico+A+DIM+M+PL
zoelétrica	zoelétrico+A+F+SG
zoelétricas	zoelétrico+A+F+PL
zoelétrico	zoelétrico+A+M+SG
zoelétricos	zoelétrico+A+M+PL
zoica	zoico+A+F+SG
zoicas	zoico+A+F+PL
zoicazinha	zoico+A+DIM+F+SG
zoicazinhas	zoico+A+DIM+F+PL
zoico	zoico+A+M+SG
zoicos	zoico+A+M+PL
zoicozinho	zoico+A+DIM+M+SG
zoicozinhos	zoico+A+DIM+M+PL
zoiquinha	zoico+A+DIM+F+SG
zoiquinhas	zoico+A+DIM+F+PL
zoiquinho	zoico+A+DIM+M+SG
zoiquinhos	zoico+A+DIM+M+PL
zoide	zoide+A+SG
zoides	zoide+A+PL
zoidezinha	zoide+A+DIM+F+SG
zoidezinhas	zoide+A+DIM+F+PL
zoidezinho	zoide+A+DIM+M+SG
zoidezinhos	zoide+A+DIM+M+PL
zoidinha	zoide+A+DIM+F+SG
zoidinhas	zoide+A+DIM+F+PL
zoidinho	zoide+A+DIM+M+SG
zoidinhos	zoide+A+DIM+M+PL
zoidiofilazinha	zoidiófilo+A+DIM+F+SG
zoidiofilazinhas	zoidiófilo+A+DIM+F+PL
zoidiofilinha	zoidiófilo+A+DIM+F+SG
zoidiofilinhas	zoidiófilo+A+DIM+F+PL
zoidiofilinho	zoidiófilo+A+DIM+M+SG
zoidiofilinhos	zoidiófilo+A+DIM+M+PL
zoidiofilozinho	zoidiófilo+A+DIM+M+SG
zoidiofilozinhos	zoidiófilo+A+DIM+M+PL
zoidiófila	zoidiófilo+A+F+SG
zoidiófilas	zoidiófilo+A+F+PL
zoidiófilo	zoidiófilo+A+M+SG
zoidiófilos	zoidiófilo+A+M+PL
zoidiogamazinha	zoidiógamo+A+DIM+F+SG
zoidiogamazinhas	zoidiógamo+A+DIM+F+PL
zoidiogaminha	zoidiógamo+A+DIM+F+SG
zoidiogaminhas	zoidiógamo+A+DIM+F+PL
zoidiogaminho	zoidiógamo+A+DIM+M+SG
zoidiogaminhos	zoidiógamo+A+DIM+M+PL
zoidiogamozinho	zoidiógamo+A+DIM+M+SG
zoidiogamozinhos	zoidiógamo+A+DIM+M+PL
zoidiógama	zoidiógamo+A+F+SG
zoidiógamas	zoidiógamo+A+F+PL
zoidiógamo	zoidiógamo+A+M+SG
zoidiógamos	zoidiógamo+A+M+PL
zoina	zoina+A+SG
zoinas	zoina+A+PL
zoinazinha	zoina+A+DIM+F+SG
zoinazinhas	zoina+A+DIM+F+PL
zoinazinho	zoina+A+DIM+M+SG
zoinazinhos	zoina+A+DIM+M+PL
zoininha	zoina+A+DIM+SG
zoininhas	zoina+A+DIM+PL
zolaica	zolaico+A+F+SG
zolaicas	zolaico+A+F+PL
zolaicazinha	zolaico+A+DIM+F+SG
zolaicazinhas	zolaico+A+DIM+F+PL
zolaico	zolaico+A+M+SG
zolaicos	zolaico+A+M+PL
zolaicozinho	zolaico+A+DIM+M+SG
zolaicozinhos	zolaico+A+DIM+M+PL
zolaiquinha	zolaico+A+DIM+F+SG
zolaiquinhas	zolaico+A+DIM+F+PL
zolaiquinho	zolaico+A+DIM+M+SG
zolaiquinhos	zolaico+A+DIM+M+PL
zolaistazinha	zolaísta+A+DIM+F+SG
zolaistazinhas	zolaísta+A+DIM+F+PL
zolaistazinho	zolaísta+A+DIM+M+SG
zolaistazinhos	zolaísta+A+DIM+M+PL
zolaistinha	zolaísta+A+DIM+SG
zolaistinhas	zolaísta+A+DIM+PL
zolaísta	zolaísta+A+SG
zolaístas	zolaísta+A+PL
zolesca	zolesco+A+F+SG
zolescas	zolesco+A+F+PL
zolescazinha	zolesco+A+DIM+F+SG
zolescazinhas	zolesco+A+DIM+F+PL
zolesco	zolesco+A+M+SG
zolescos	zolesco+A+M+PL
zolescozinho	zolesco+A+DIM+M+SG
zolescozinhos	zolesco+A+DIM+M+PL
zolesquinha	zolesco+A+DIM+F+SG
zolesquinhas	zolesco+A+DIM+F+PL
zolesquinho	zolesco+A+DIM+M+SG
zolesquinhos	zolesco+A+DIM+M+PL
zolista	zolista+A+SG
zolistas	zolista+A+PL
zolistazinha	zolista+A+DIM+F+SG
zolistazinhas	zolista+A+DIM+F+PL
zolistazinho	zolista+A+DIM+M+SG
zolistazinhos	zolista+A+DIM+M+PL
zolistinha	zolista+A+DIM+SG
zolistinhas	zolista+A+DIM+PL
zombador	zombador+A+M+SG
zombadora	zombador+A+F+SG
zombadoras	zombador+A+F+PL
zombadorazinha	zombador+A+DIM+F+SG
zombadorazinhas	zombador+A+DIM+F+PL
zombadores	zombador+A+M+PL
zombadorezinhos	zombador+A+DIM+M+PL
zombadorinha	zombador+A+DIM+F+SG
zombadorinhas	zombador+A+DIM+F+PL
zombadorzinho	zombador+A+DIM+M+SG
zombadorzinhos	zombador+A+DIM+M+PL
zombeirona	zombeirão+A+F+SG
zombeironas	zombeirão+A+F+PL
zombeironazinha	zombeirão+A+DIM+F+SG
zombeironazinhas	zombeirão+A+DIM+F+PL
zombeironinha	zombeirão+A+DIM+F+SG
zombeironinhas	zombeirão+A+DIM+F+PL
zombeirão	zombeirão+A+M+SG
zombeirãozinho	zombeirão+A+DIM+M+SG
zombeirões	zombeirão+A+M+PL
zombeirõezinhos	zombeirão+A+DIM+M+PL
zombeteira	zombeteiro+A+F+SG
zombeteiras	zombeteiro+A+F+PL
zombeteirazinha	zombeteiro+A+DIM+F+SG
zombeteirazinhas	zombeteiro+A+DIM+F+PL
zombeteirinha	zombeteiro+A+DIM+F+SG
zombeteirinhas	zombeteiro+A+DIM+F+PL
zombeteirinho	zombeteiro+A+DIM+M+SG
zombeteirinhos	zombeteiro+A+DIM+M+PL
zombeteiro	zombeteiro+A+M+SG
zombeteiros	zombeteiro+A+M+PL
zombeteirozinho	zombeteiro+A+DIM+M+SG
zombeteirozinhos	zombeteiro+A+DIM+M+PL
zombeteaveizinhas	zombeteável+A+DIM+F+PL
zombeteaveizinhos	zombeteável+A+DIM+M+PL
zombeteavelzinha	zombeteável+A+DIM+F+SG
zombeteavelzinho	zombeteável+A+DIM+M+SG
zombeteáveis	zombeteável+A+PL
zombeteável	zombeteável+A+SG
zombaveizinhas	zombável+A+DIM+F+PL
zombaveizinhos	zombável+A+DIM+M+PL
zombavelzinha	zombável+A+DIM+F+SG
zombavelzinho	zombável+A+DIM+M+SG
zombáveis	zombável+A+PL
zombável	zombável+A+SG
zompeira	zompeiro+A+F+SG
zompeiras	zompeiro+A+F+PL
zompeirazinha	zompeiro+A+DIM+F+SG
zompeirazinhas	zompeiro+A+DIM+F+PL
zompeirinha	zompeiro+A+DIM+F+SG
zompeirinhas	zompeiro+A+DIM+F+PL
zompeirinho	zompeiro+A+DIM+M+SG
zompeirinhos	zompeiro+A+DIM+M+PL
zompeiro	zompeiro+A+M+SG
zompeiros	zompeiro+A+M+PL
zompeirozinho	zompeiro+A+DIM+M+SG
zompeirozinhos	zompeiro+A+DIM+M+PL
zonada	zonado+A+F+SG
zonadas	zonado+A+F+PL
zonadazinha	zonado+A+DIM+F+SG
zonadazinhas	zonado+A+DIM+F+PL
zonadinha	zonado+A+DIM+F+SG
zonadinhas	zonado+A+DIM+F+PL
zonadinho	zonado+A+DIM+M+SG
zonadinhos	zonado+A+DIM+M+PL
zonado	zonado+A+M+SG
zonados	zonado+A+M+PL
zonadozinho	zonado+A+DIM+M+SG
zonadozinhos	zonado+A+DIM+M+PL
zonais	zonal+A+PL
zonaizinhas	zonal+A+DIM+F+PL
zonaizinhos	zonal+A+DIM+M+PL
zonal	zonal+A+SG
zonalzinha	zonal+A+DIM+F+SG
zonalzinho	zonal+A+DIM+M+SG
zonchaveizinhas	zonchável+A+DIM+F+PL
zonchaveizinhos	zonchável+A+DIM+M+PL
zonchavelzinha	zonchável+A+DIM+F+SG
zonchavelzinho	zonchável+A+DIM+M+SG
zoncháveis	zonchável+A+PL
zonchável	zonchável+A+SG
zoneaveizinhas	zoneável+A+DIM+F+PL
zoneaveizinhos	zoneável+A+DIM+M+PL
zoneavelzinha	zoneável+A+DIM+F+SG
zoneavelzinho	zoneável+A+DIM+M+SG
zoneáveis	zoneável+A+PL
zoneável	zoneável+A+SG
zoniforme	zoniforme+A+SG
zoniformes	zoniforme+A+PL
zoniformezinha	zoniforme+A+DIM+F+SG
zoniformezinhas	zoniforme+A+DIM+F+PL
zoniformezinho	zoniforme+A+DIM+M+SG
zoniformezinhos	zoniforme+A+DIM+M+PL
zoniforminha	zoniforme+A+DIM+F+SG
zoniforminhas	zoniforme+A+DIM+F+PL
zoniforminho	zoniforme+A+DIM+M+SG
zoniforminhos	zoniforme+A+DIM+M+PL
zonifuga	zonifugo+A+F+SG
zonifugas	zonifugo+A+F+PL
zonifugazinha	zonifugo+A+DIM+F+SG
zonifugazinhas	zonifugo+A+DIM+F+PL
zonifugo	zonifugo+A+M+SG
zonifugos	zonifugo+A+M+PL
zonifugozinho	zonifugo+A+DIM+M+SG
zonifugozinhos	zonifugo+A+DIM+M+PL
zonifuguinha	zonifugo+A+DIM+F+SG
zonifuguinhas	zonifugo+A+DIM+F+PL
zonifuguinho	zonifugo+A+DIM+M+SG
zonifuguinhos	zonifugo+A+DIM+M+PL
zonzeaveizinhas	zonzeável+A+DIM+F+PL
zonzeaveizinhos	zonzeável+A+DIM+M+PL
zonzeavelzinha	zonzeável+A+DIM+F+SG
zonzeavelzinho	zonzeável+A+DIM+M+SG
zonzeáveis	zonzeável+A+PL
zonzeável	zonzeável+A+SG
zonza	zonzo+A+F+SG
zonzas	zonzo+A+F+PL
zonzazinha	zonzo+A+DIM+F+SG
zonzazinhas	zonzo+A+DIM+F+PL
zonzinha	zonzo+A+DIM+F+SG
zonzinhas	zonzo+A+DIM+F+PL
zonzinho	zonzo+A+DIM+M+SG
zonzinhos	zonzo+A+DIM+M+PL
zonzo	zonzo+A+M+SG
zonzos	zonzo+A+M+PL
zonzozinho	zonzo+A+DIM+M+SG
zonzozinhos	zonzo+A+DIM+M+PL
zonzonaveizinhas	zonzonável+A+DIM+F+PL
zonzonaveizinhos	zonzonável+A+DIM+M+PL
zonzonavelzinha	zonzonável+A+DIM+F+SG
zonzonavelzinho	zonzonável+A+DIM+M+SG
zonzonáveis	zonzonável+A+PL
zonzonável	zonzonável+A+SG
zonzaveizinhas	zonzável+A+DIM+F+PL
zonzaveizinhos	zonzável+A+DIM+M+PL
zonzavelzinha	zonzável+A+DIM+F+SG
zonzavelzinho	zonzável+A+DIM+M+SG
zonzáveis	zonzável+A+PL
zonzável	zonzável+A+SG
zonariazinha	zonária+A+DIM+F+SG
zonariazinhas	zonária+A+DIM+F+PL
zonarinha	zonária+A+DIM+F+SG
zonarinhas	zonária+A+DIM+F+PL
zonária	zonária+A+F+SG
zonárias	zonária+A+F+PL
zonaveizinhas	zonável+A+DIM+F+PL
zonaveizinhos	zonável+A+DIM+M+PL
zonavelzinha	zonável+A+DIM+F+SG
zonavelzinho	zonável+A+DIM+M+SG
zonáveis	zonável+A+PL
zonável	zonável+A+SG
zonipetazinha	zonípeto+A+DIM+F+SG
zonipetazinhas	zonípeto+A+DIM+F+PL
zonipetinha	zonípeto+A+DIM+F+SG
zonipetinhas	zonípeto+A+DIM+F+PL
zonipetinho	zonípeto+A+DIM+M+SG
zonipetinhos	zonípeto+A+DIM+M+PL
zonipetozinho	zonípeto+A+DIM+M+SG
zonipetozinhos	zonípeto+A+DIM+M+PL
zonípeta	zonípeto+A+F+SG
zonípetas	zonípeto+A+F+PL
zonípeto	zonípeto+A+M+SG
zonípetos	zonípeto+A+M+PL
zoobioticazinha	zoobiótico+A+DIM+F+SG
zoobioticazinhas	zoobiótico+A+DIM+F+PL
zoobioticozinho	zoobiótico+A+DIM+M+SG
zoobioticozinhos	zoobiótico+A+DIM+M+PL
zoobiotiquinha	zoobiótico+A+DIM+F+SG
zoobiotiquinhas	zoobiótico+A+DIM+F+PL
zoobiotiquinho	zoobiótico+A+DIM+M+SG
zoobiotiquinhos	zoobiótico+A+DIM+M+PL
zoobiótica	zoobiótico+A+F+SG
zoobióticas	zoobiótico+A+F+PL
zoobiótico	zoobiótico+A+M+SG
zoobióticos	zoobiótico+A+M+PL
zooelectricazinha	zooeléctrico+A+DIM+F+SG
zooelectricazinhas	zooeléctrico+A+DIM+F+PL
zooelectricozinho	zooeléctrico+A+DIM+M+SG
zooelectricozinhos	zooeléctrico+A+DIM+M+PL
zooelectriquinha	zooeléctrico+A+DIM+F+SG
zooelectriquinhas	zooeléctrico+A+DIM+F+PL
zooelectriquinho	zooeléctrico+A+DIM+M+SG
zooelectriquinhos	zooeléctrico+A+DIM+M+PL
zooeléctrica	zooeléctrico+A+F+SG
zooeléctricas	zooeléctrico+A+F+PL
zooeléctrico	zooeléctrico+A+M+SG
zooeléctricos	zooeléctrico+A+M+PL
zooeletricazinha	zooelétrico+A+DIM+F+SG
zooeletricazinhas	zooelétrico+A+DIM+F+PL
zooeletricozinho	zooelétrico+A+DIM+M+SG
zooeletricozinhos	zooelétrico+A+DIM+M+PL
zooeletriquinha	zooelétrico+A+DIM+F+SG
zooeletriquinhas	zooelétrico+A+DIM+F+PL
zooeletriquinho	zooelétrico+A+DIM+M+SG
zooeletriquinhos	zooelétrico+A+DIM+M+PL
zooelétrica	zooelétrico+A+F+SG
zooelétricas	zooelétrico+A+F+PL
zooelétrico	zooelétrico+A+M+SG
zooelétricos	zooelétrico+A+M+PL
zoofitantraceazinha	zoofitantráceo+A+DIM+F+SG
zoofitantraceazinhas	zoofitantráceo+A+DIM+F+PL
zoofitantraceinha	zoofitantráceo+A+DIM+F+SG
zoofitantraceinhas	zoofitantráceo+A+DIM+F+PL
zoofitantraceinho	zoofitantráceo+A+DIM+M+SG
zoofitantraceinhos	zoofitantráceo+A+DIM+M+PL
zoofitantraceozinho	zoofitantráceo+A+DIM+M+SG
zoofitantraceozinhos	zoofitantráceo+A+DIM+M+PL
zoofitantrácea	zoofitantráceo+A+F+SG
zoofitantráceas	zoofitantráceo+A+F+PL
zoofitantráceo	zoofitantráceo+A+M+SG
zoofitantráceos	zoofitantráceo+A+M+PL
zoofitoide	zoofitoide+A+SG
zoofitoides	zoofitoide+A+PL
zoofitoidezinha	zoofitoide+A+DIM+F+SG
zoofitoidezinhas	zoofitoide+A+DIM+F+PL
zoofitoidezinho	zoofitoide+A+DIM+M+SG
zoofitoidezinhos	zoofitoide+A+DIM+M+PL
zoofitoidinha	zoofitoide+A+DIM+F+SG
zoofitoidinhas	zoofitoide+A+DIM+F+PL
zoofitoidinho	zoofitoide+A+DIM+M+SG
zoofitoidinhos	zoofitoide+A+DIM+M+PL
zoofitariazinha	zoofitário+A+DIM+F+SG
zoofitariazinhas	zoofitário+A+DIM+F+PL
zoofitarinha	zoofitário+A+DIM+F+SG
zoofitarinhas	zoofitário+A+DIM+F+PL
zoofitarinho	zoofitário+A+DIM+M+SG
zoofitarinhos	zoofitário+A+DIM+M+PL
zoofitariozinho	zoofitário+A+DIM+M+SG
zoofitariozinhos	zoofitário+A+DIM+M+PL
zoofitária	zoofitário+A+F+SG
zoofitárias	zoofitário+A+F+PL
zoofitário	zoofitário+A+M+SG
zoofitários	zoofitário+A+M+PL
zoofitoidezinha	zoofitóide+A+DIM+F+SG
zoofitoidezinhas	zoofitóide+A+DIM+F+PL
zoofitoidezinho	zoofitóide+A+DIM+M+SG
zoofitoidezinhos	zoofitóide+A+DIM+M+PL
zoofitoidinha	zoofitóide+A+DIM+F+SG
zoofitoidinhas	zoofitóide+A+DIM+F+PL
zoofitoidinho	zoofitóide+A+DIM+M+SG
zoofitoidinhos	zoofitóide+A+DIM+M+PL
zoofitóide	zoofitóide+A+SG
zoofitóides	zoofitóide+A+PL
zoofiticazinha	zoofítico+A+DIM+F+SG
zoofiticazinhas	zoofítico+A+DIM+F+PL
zoofiticozinho	zoofítico+A+DIM+M+SG
zoofiticozinhos	zoofítico+A+DIM+M+PL
zoofitiquinha	zoofítico+A+DIM+F+SG
zoofitiquinhas	zoofítico+A+DIM+F+PL
zoofitiquinho	zoofítico+A+DIM+M+SG
zoofitiquinhos	zoofítico+A+DIM+M+PL
zoofítica	zoofítico+A+F+SG
zoofíticas	zoofítico+A+F+PL
zoofítico	zoofítico+A+M+SG
zoofíticos	zoofítico+A+M+PL
zoografaveizinhas	zoografável+A+DIM+F+PL
zoografaveizinhos	zoografável+A+DIM+M+PL
zoografavelzinha	zoografável+A+DIM+F+SG
zoografavelzinho	zoografável+A+DIM+M+SG
zoografáveis	zoografável+A+PL
zoografável	zoografável+A+SG
zoograficazinha	zoográfico+A+DIM+F+SG
zoograficazinhas	zoográfico+A+DIM+F+PL
zoograficozinho	zoográfico+A+DIM+M+SG
zoograficozinhos	zoográfico+A+DIM+M+PL
zoografiquinha	zoográfico+A+DIM+F+SG
zoografiquinhas	zoográfico+A+DIM+F+PL
zoografiquinho	zoográfico+A+DIM+M+SG
zoografiquinhos	zoográfico+A+DIM+M+PL
zoográfica	zoográfico+A+F+SG
zoográficas	zoográfico+A+F+PL
zoográfico	zoográfico+A+M+SG
zoográficos	zoográfico+A+M+PL
zoogenicazinha	zoogénico+A+DIM+F+SG
zoogenicazinhas	zoogénico+A+DIM+F+PL
zoogenicozinho	zoogénico+A+DIM+M+SG
zoogenicozinhos	zoogénico+A+DIM+M+PL
zoogeniquinha	zoogénico+A+DIM+F+SG
zoogeniquinhas	zoogénico+A+DIM+F+PL
zoogeniquinho	zoogénico+A+DIM+M+SG
zoogeniquinhos	zoogénico+A+DIM+M+PL
zoogénica	zoogénico+A+F+SG
zoogénicas	zoogénico+A+F+PL
zoogénico	zoogénico+A+M+SG
zoogénicos	zoogénico+A+M+PL
zoogenicazinha	zoogênico+A+DIM+F+SG
zoogenicazinhas	zoogênico+A+DIM+F+PL
zoogenicozinho	zoogênico+A+DIM+M+SG
zoogenicozinhos	zoogênico+A+DIM+M+PL
zoogeniquinha	zoogênico+A+DIM+F+SG
zoogeniquinhas	zoogênico+A+DIM+F+PL
zoogeniquinho	zoogênico+A+DIM+M+SG
zoogeniquinhos	zoogênico+A+DIM+M+PL
zoogênica	zoogênico+A+F+SG
zoogênicas	zoogênico+A+F+PL
zoogênico	zoogênico+A+M+SG
zoogênicos	zoogênico+A+M+PL
zooide	zooide+A+SG
zooides	zooide+A+PL
zooidezinha	zooide+A+DIM+F+SG
zooidezinhas	zooide+A+DIM+F+PL
zooidezinho	zooide+A+DIM+M+SG
zooidezinhos	zooide+A+DIM+M+PL
zooidinha	zooide+A+DIM+F+SG
zooidinhas	zooide+A+DIM+F+PL
zooidinho	zooide+A+DIM+M+SG
zooidinhos	zooide+A+DIM+M+PL
zoolitiferazinha	zoolitífero+A+DIM+F+SG
zoolitiferazinhas	zoolitífero+A+DIM+F+PL
zoolitiferinha	zoolitífero+A+DIM+F+SG
zoolitiferinhas	zoolitífero+A+DIM+F+PL
zoolitiferinho	zoolitífero+A+DIM+M+SG
zoolitiferinhos	zoolitífero+A+DIM+M+PL
zoolitiferozinho	zoolitífero+A+DIM+M+SG
zoolitiferozinhos	zoolitífero+A+DIM+M+PL
zoolitífera	zoolitífero+A+F+SG
zoolitíferas	zoolitífero+A+F+PL
zoolitífero	zoolitífero+A+M+SG
zoolitíferos	zoolitífero+A+M+PL
zoolitoforazinha	zoolitóforo+A+DIM+F+SG
zoolitoforazinhas	zoolitóforo+A+DIM+F+PL
zoolitoforinha	zoolitóforo+A+DIM+F+SG
zoolitoforinhas	zoolitóforo+A+DIM+F+PL
zoolitoforinho	zoolitóforo+A+DIM+M+SG
zoolitoforinhos	zoolitóforo+A+DIM+M+PL
zoolitoforozinho	zoolitóforo+A+DIM+M+SG
zoolitoforozinhos	zoolitóforo+A+DIM+M+PL
zoolitófora	zoolitóforo+A+F+SG
zoolitóforas	zoolitóforo+A+F+PL
zoolitóforo	zoolitóforo+A+M+SG
zoolitóforos	zoolitóforo+A+M+PL
zoolatricazinha	zoolátrico+A+DIM+F+SG
zoolatricazinhas	zoolátrico+A+DIM+F+PL
zoolatricozinho	zoolátrico+A+DIM+M+SG
zoolatricozinhos	zoolátrico+A+DIM+M+PL
zoolatriquinha	zoolátrico+A+DIM+F+SG
zoolatriquinhas	zoolátrico+A+DIM+F+PL
zoolatriquinho	zoolátrico+A+DIM+M+SG
zoolatriquinhos	zoolátrico+A+DIM+M+PL
zoolátrica	zoolátrico+A+F+SG
zoolátricas	zoolátrico+A+F+PL
zoolátrico	zoolátrico+A+M+SG
zoolátricos	zoolátrico+A+M+PL
zooliticazinha	zoolítico+A+DIM+F+SG
zooliticazinhas	zoolítico+A+DIM+F+PL
zooliticozinho	zoolítico+A+DIM+M+SG
zooliticozinhos	zoolítico+A+DIM+M+PL
zoolitiquinha	zoolítico+A+DIM+F+SG
zoolitiquinhas	zoolítico+A+DIM+F+PL
zoolitiquinho	zoolítico+A+DIM+M+SG
zoolitiquinhos	zoolítico+A+DIM+M+PL
zoolítica	zoolítico+A+F+SG
zoolíticas	zoolítico+A+F+PL
zoolítico	zoolítico+A+M+SG
zoolíticos	zoolítico+A+M+PL
zoologicazinha	zoológico+A+DIM+F+SG
zoologicazinhas	zoológico+A+DIM+F+PL
zoologicozinho	zoológico+A+DIM+M+SG
zoologicozinhos	zoológico+A+DIM+M+PL
zoologiquinha	zoológico+A+DIM+F+SG
zoologiquinhas	zoológico+A+DIM+F+PL
zoologiquinho	zoológico+A+DIM+M+SG
zoologiquinhos	zoológico+A+DIM+M+PL
zoológica	zoológico+A+F+SG
zoológicas	zoológico+A+F+PL
zoológico	zoológico+A+M+SG
zoológicos	zoológico+A+M+PL
zoomagneticazinha	zoomagnético+A+DIM+F+SG
zoomagneticazinhas	zoomagnético+A+DIM+F+PL
zoomagneticozinho	zoomagnético+A+DIM+M+SG
zoomagneticozinhos	zoomagnético+A+DIM+M+PL
zoomagnetiquinha	zoomagnético+A+DIM+F+SG
zoomagnetiquinhas	zoomagnético+A+DIM+F+PL
zoomagnetiquinho	zoomagnético+A+DIM+M+SG
zoomagnetiquinhos	zoomagnético+A+DIM+M+PL
zoomagnética	zoomagnético+A+F+SG
zoomagnéticas	zoomagnético+A+F+PL
zoomagnético	zoomagnético+A+M+SG
zoomagnéticos	zoomagnético+A+M+PL
zoomaniacazinha	zoomaníaco+A+DIM+F+SG
zoomaniacazinhas	zoomaníaco+A+DIM+F+PL
zoomaniacozinho	zoomaníaco+A+DIM+M+SG
zoomaniacozinhos	zoomaníaco+A+DIM+M+PL
zoomaniaquinha	zoomaníaco+A+DIM+F+SG
zoomaniaquinhas	zoomaníaco+A+DIM+F+PL
zoomaniaquinho	zoomaníaco+A+DIM+M+SG
zoomaniaquinhos	zoomaníaco+A+DIM+M+PL
zoomaníaca	zoomaníaco+A+F+SG
zoomaníacas	zoomaníaco+A+F+PL
zoomaníaco	zoomaníaco+A+M+SG
zoomaníacos	zoomaníaco+A+M+PL
zoomorfa	zoomorfo+A+F+SG
zoomorfas	zoomorfo+A+F+PL
zoomorfazinha	zoomorfo+A+DIM+F+SG
zoomorfazinhas	zoomorfo+A+DIM+F+PL
zoomorfinha	zoomorfo+A+DIM+F+SG
zoomorfinhas	zoomorfo+A+DIM+F+PL
zoomorfinho	zoomorfo+A+DIM+M+SG
zoomorfinhos	zoomorfo+A+DIM+M+PL
zoomorfo	zoomorfo+A+M+SG
zoomorfos	zoomorfo+A+M+PL
zoomorfozinho	zoomorfo+A+DIM+M+SG
zoomorfozinhos	zoomorfo+A+DIM+M+PL
zoomorficazinha	zoomórfico+A+DIM+F+SG
zoomorficazinhas	zoomórfico+A+DIM+F+PL
zoomorficozinho	zoomórfico+A+DIM+M+SG
zoomorficozinhos	zoomórfico+A+DIM+M+PL
zoomorfiquinha	zoomórfico+A+DIM+F+SG
zoomorfiquinhas	zoomórfico+A+DIM+F+PL
zoomorfiquinho	zoomórfico+A+DIM+M+SG
zoomorfiquinhos	zoomórfico+A+DIM+M+PL
zoomórfica	zoomórfico+A+F+SG
zoomórficas	zoomórfico+A+F+PL
zoomórfico	zoomórfico+A+M+SG
zoomórficos	zoomórfico+A+M+PL
zoonosologicazinha	zoonosológico+A+DIM+F+SG
zoonosologicazinhas	zoonosológico+A+DIM+F+PL
zoonosologicozinho	zoonosológico+A+DIM+M+SG
zoonosologicozinhos	zoonosológico+A+DIM+M+PL
zoonosologiquinha	zoonosológico+A+DIM+F+SG
zoonosologiquinhas	zoonosológico+A+DIM+F+PL
zoonosologiquinho	zoonosológico+A+DIM+M+SG
zoonosologiquinhos	zoonosológico+A+DIM+M+PL
zoonosológica	zoonosológico+A+F+SG
zoonosológicas	zoonosológico+A+F+PL
zoonosológico	zoonosológico+A+M+SG
zoonosológicos	zoonosológico+A+M+PL
zoonomicazinha	zoonómico+A+DIM+F+SG
zoonomicazinhas	zoonómico+A+DIM+F+PL
zoonomicozinho	zoonómico+A+DIM+M+SG
zoonomicozinhos	zoonómico+A+DIM+M+PL
zoonomiquinha	zoonómico+A+DIM+F+SG
zoonomiquinhas	zoonómico+A+DIM+F+PL
zoonomiquinho	zoonómico+A+DIM+M+SG
zoonomiquinhos	zoonómico+A+DIM+M+PL
zoonómica	zoonómico+A+F+SG
zoonómicas	zoonómico+A+F+PL
zoonómico	zoonómico+A+M+SG
zoonómicos	zoonómico+A+M+PL
zoonomicazinha	zoonômico+A+DIM+F+SG
zoonomicazinhas	zoonômico+A+DIM+F+PL
zoonomicozinho	zoonômico+A+DIM+M+SG
zoonomicozinhos	zoonômico+A+DIM+M+PL
zoonomiquinha	zoonômico+A+DIM+F+SG
zoonomiquinhas	zoonômico+A+DIM+F+PL
zoonomiquinho	zoonômico+A+DIM+M+SG
zoonomiquinhos	zoonômico+A+DIM+M+PL
zoonômica	zoonômico+A+F+SG
zoonômicas	zoonômico+A+F+PL
zoonômico	zoonômico+A+M+SG
zoonômicos	zoonômico+A+M+PL
zoopatologicazinha	zoopatológico+A+DIM+F+SG
zoopatologicazinhas	zoopatológico+A+DIM+F+PL
zoopatologicozinho	zoopatológico+A+DIM+M+SG
zoopatologicozinhos	zoopatológico+A+DIM+M+PL
zoopatologiquinha	zoopatológico+A+DIM+F+SG
zoopatologiquinhas	zoopatológico+A+DIM+F+PL
zoopatologiquinho	zoopatológico+A+DIM+M+SG
zoopatologiquinhos	zoopatológico+A+DIM+M+PL
zoopatológica	zoopatológico+A+F+SG
zoopatológicas	zoopatológico+A+F+PL
zoopatológico	zoopatológico+A+M+SG
zoopatológicos	zoopatológico+A+M+PL
zoopolita	zoopolita+A+SG
zoopolitas	zoopolita+A+PL
zoopolitazinha	zoopolita+A+DIM+F+SG
zoopolitazinhas	zoopolita+A+DIM+F+PL
zoopolitazinho	zoopolita+A+DIM+M+SG
zoopolitazinhos	zoopolita+A+DIM+M+PL
zoopolitinha	zoopolita+A+DIM+SG
zoopolitinhas	zoopolita+A+DIM+PL
zooscopicazinha	zooscópico+A+DIM+F+SG
zooscopicazinhas	zooscópico+A+DIM+F+PL
zooscopicozinho	zooscópico+A+DIM+M+SG
zooscopicozinhos	zooscópico+A+DIM+M+PL
zooscopiquinha	zooscópico+A+DIM+F+SG
zooscopiquinhas	zooscópico+A+DIM+F+PL
zooscopiquinho	zooscópico+A+DIM+M+SG
zooscopiquinhos	zooscópico+A+DIM+M+PL
zooscópica	zooscópico+A+F+SG
zooscópicas	zooscópico+A+F+PL
zooscópico	zooscópico+A+M+SG
zooscópicos	zooscópico+A+M+PL
zoosporicazinha	zoospórico+A+DIM+F+SG
zoosporicazinhas	zoospórico+A+DIM+F+PL
zoosporicozinho	zoospórico+A+DIM+M+SG
zoosporicozinhos	zoospórico+A+DIM+M+PL
zoosporiquinha	zoospórico+A+DIM+F+SG
zoosporiquinhas	zoospórico+A+DIM+F+PL
zoosporiquinho	zoospórico+A+DIM+M+SG
zoosporiquinhos	zoospórico+A+DIM+M+PL
zoospórica	zoospórico+A+F+SG
zoospóricas	zoospórico+A+F+PL
zoospórico	zoospórico+A+M+SG
zoospóricos	zoospórico+A+M+PL
zooterapicazinha	zooterápico+A+DIM+F+SG
zooterapicazinhas	zooterápico+A+DIM+F+PL
zooterapicozinho	zooterápico+A+DIM+M+SG
zooterapicozinhos	zooterápico+A+DIM+M+PL
zooterapiquinha	zooterápico+A+DIM+F+SG
zooterapiquinhas	zooterápico+A+DIM+F+PL
zooterapiquinho	zooterápico+A+DIM+M+SG
zooterapiquinhos	zooterápico+A+DIM+M+PL
zooterápica	zooterápico+A+F+SG
zooterápicas	zooterápico+A+F+PL
zooterápico	zooterápico+A+M+SG
zooterápicos	zooterápico+A+M+PL
zootacticazinha	zootáctico+A+DIM+F+SG
zootacticazinhas	zootáctico+A+DIM+F+PL
zootacticozinho	zootáctico+A+DIM+M+SG
zootacticozinhos	zootáctico+A+DIM+M+PL
zootactiquinha	zootáctico+A+DIM+F+SG
zootactiquinhas	zootáctico+A+DIM+F+PL
zootactiquinho	zootáctico+A+DIM+M+SG
zootactiquinhos	zootáctico+A+DIM+M+PL
zootáctica	zootáctico+A+F+SG
zootácticas	zootáctico+A+F+PL
zootáctico	zootáctico+A+M+SG
zootácticos	zootáctico+A+M+PL
zootaticazinha	zootático+A+DIM+F+SG
zootaticazinhas	zootático+A+DIM+F+PL
zootaticozinho	zootático+A+DIM+M+SG
zootaticozinhos	zootático+A+DIM+M+PL
zootatiquinha	zootático+A+DIM+F+SG
zootatiquinhas	zootático+A+DIM+F+PL
zootatiquinho	zootático+A+DIM+M+SG
zootatiquinhos	zootático+A+DIM+M+PL
zootática	zootático+A+F+SG
zootáticas	zootático+A+F+PL
zootático	zootático+A+M+SG
zootáticos	zootático+A+M+PL
zootaxicazinha	zootáxico+A+DIM+F+SG
zootaxicazinhas	zootáxico+A+DIM+F+PL
zootaxicozinho	zootáxico+A+DIM+M+SG
zootaxicozinhos	zootáxico+A+DIM+M+PL
zootaxiquinha	zootáxico+A+DIM+F+SG
zootaxiquinhas	zootáxico+A+DIM+F+PL
zootaxiquinho	zootáxico+A+DIM+M+SG
zootaxiquinhos	zootáxico+A+DIM+M+PL
zootáxica	zootáxico+A+F+SG
zootáxicas	zootáxico+A+F+PL
zootáxico	zootáxico+A+M+SG
zootáxicos	zootáxico+A+M+PL
zootecnicazinha	zootécnico+A+DIM+F+SG
zootecnicazinhas	zootécnico+A+DIM+F+PL
zootecnicozinho	zootécnico+A+DIM+M+SG
zootecnicozinhos	zootécnico+A+DIM+M+PL
zootecniquinha	zootécnico+A+DIM+F+SG
zootecniquinhas	zootécnico+A+DIM+F+PL
zootecniquinho	zootécnico+A+DIM+M+SG
zootecniquinhos	zootécnico+A+DIM+M+PL
zootécnica	zootécnico+A+F+SG
zootécnicas	zootécnico+A+F+PL
zootécnico	zootécnico+A+M+SG
zootécnicos	zootécnico+A+M+PL
zootomicazinha	zootómico+A+DIM+F+SG
zootomicazinhas	zootómico+A+DIM+F+PL
zootomicozinho	zootómico+A+DIM+M+SG
zootomicozinhos	zootómico+A+DIM+M+PL
zootomiquinha	zootómico+A+DIM+F+SG
zootomiquinhas	zootómico+A+DIM+F+PL
zootomiquinho	zootómico+A+DIM+M+SG
zootomiquinhos	zootómico+A+DIM+M+PL
zootómica	zootómico+A+F+SG
zootómicas	zootómico+A+F+PL
zootómico	zootómico+A+M+SG
zootómicos	zootómico+A+M+PL
zootomicazinha	zootômico+A+DIM+F+SG
zootomicazinhas	zootômico+A+DIM+F+PL
zootomicozinho	zootômico+A+DIM+M+SG
zootomicozinhos	zootômico+A+DIM+M+PL
zootomiquinha	zootômico+A+DIM+F+SG
zootomiquinhas	zootômico+A+DIM+F+PL
zootomiquinho	zootômico+A+DIM+M+SG
zootomiquinhos	zootômico+A+DIM+M+PL
zootômica	zootômico+A+F+SG
zootômicas	zootômico+A+F+PL
zootômico	zootômico+A+M+SG
zootômicos	zootômico+A+M+PL
zopeira	zopeiro+A+F+SG
zopeiras	zopeiro+A+F+PL
zopeirazinha	zopeiro+A+DIM+F+SG
zopeirazinhas	zopeiro+A+DIM+F+PL
zopeirinha	zopeiro+A+DIM+F+SG
zopeirinhas	zopeiro+A+DIM+F+PL
zopeirinho	zopeiro+A+DIM+M+SG
zopeirinhos	zopeiro+A+DIM+M+PL
zopeiro	zopeiro+A+M+SG
zopeiros	zopeiro+A+M+PL
zopeirozinho	zopeiro+A+DIM+M+SG
zopeirozinhos	zopeiro+A+DIM+M+PL
zorate	zorate+A+SG
zorates	zorate+A+PL
zoratezinha	zorate+A+DIM+F+SG
zoratezinhas	zorate+A+DIM+F+PL
zoratezinho	zorate+A+DIM+M+SG
zoratezinhos	zorate+A+DIM+M+PL
zoratinha	zorate+A+DIM+F+SG
zoratinhas	zorate+A+DIM+F+PL
zoratinho	zorate+A+DIM+M+SG
zoratinhos	zorate+A+DIM+M+PL
zorata	zorato+A+F+SG
zoratas	zorato+A+F+PL
zoratazinha	zorato+A+DIM+F+SG
zoratazinhas	zorato+A+DIM+F+PL
zoratinha	zorato+A+DIM+F+SG
zoratinhas	zorato+A+DIM+F+PL
zoratinho	zorato+A+DIM+M+SG
zoratinhos	zorato+A+DIM+M+PL
zorato	zorato+A+M+SG
zoratos	zorato+A+M+PL
zoratozinho	zorato+A+DIM+M+SG
zoratozinhos	zorato+A+DIM+M+PL
zornaveizinhas	zornável+A+DIM+F+PL
zornaveizinhos	zornável+A+DIM+M+PL
zornavelzinha	zornável+A+DIM+F+SG
zornavelzinho	zornável+A+DIM+M+SG
zornáveis	zornável+A+PL
zornável	zornável+A+SG
zornão	zornão+A+M+SG
zornãozinho	zornão+A+DIM+M+SG
zornões	zornão+A+M+PL
zornõezinhos	zornão+A+DIM+M+PL
zoroastriana	zoroastriano+A+F+SG
zoroastrianas	zoroastriano+A+F+PL
zoroastrianazinha	zoroastriano+A+DIM+F+SG
zoroastrianazinhas	zoroastriano+A+DIM+F+PL
zoroastrianinha	zoroastriano+A+DIM+F+SG
zoroastrianinhas	zoroastriano+A+DIM+F+PL
zoroastrianinho	zoroastriano+A+DIM+M+SG
zoroastrianinhos	zoroastriano+A+DIM+M+PL
zoroastriano	zoroastriano+A+M+SG
zoroastrianos	zoroastriano+A+M+PL
zoroastrianozinho	zoroastriano+A+DIM+M+SG
zoroastrianozinhos	zoroastriano+A+DIM+M+PL
zoroastrista	zoroastrista+A+SG
zoroastristas	zoroastrista+A+PL
zoroastristazinha	zoroastrista+A+DIM+F+SG
zoroastristazinhas	zoroastrista+A+DIM+F+PL
zoroastristazinho	zoroastrista+A+DIM+M+SG
zoroastristazinhos	zoroastrista+A+DIM+M+PL
zoroastristinha	zoroastrista+A+DIM+SG
zoroastristinhas	zoroastrista+A+DIM+PL
zoroastricazinha	zoroástrico+A+DIM+F+SG
zoroastricazinhas	zoroástrico+A+DIM+F+PL
zoroastricozinho	zoroástrico+A+DIM+M+SG
zoroastricozinhos	zoroástrico+A+DIM+M+PL
zoroastriquinha	zoroástrico+A+DIM+F+SG
zoroastriquinhas	zoroástrico+A+DIM+F+PL
zoroastriquinho	zoroástrico+A+DIM+M+SG
zoroastriquinhos	zoroástrico+A+DIM+M+PL
zoroástrica	zoroástrico+A+F+SG
zoroástricas	zoroástrico+A+F+PL
zoroástrico	zoroástrico+A+M+SG
zoroástricos	zoroástrico+A+M+PL
zorragaveizinhas	zorragável+A+DIM+F+PL
zorragaveizinhos	zorragável+A+DIM+M+PL
zorragavelzinha	zorragável+A+DIM+F+SG
zorragavelzinho	zorragável+A+DIM+M+SG
zorragáveis	zorragável+A+PL
zorragável	zorragável+A+SG
zorreira	zorreiro+A+F+SG
zorreiras	zorreiro+A+F+PL
zorreirazinha	zorreiro+A+DIM+F+SG
zorreirazinhas	zorreiro+A+DIM+F+PL
zorreirinha	zorreiro+A+DIM+F+SG
zorreirinhas	zorreiro+A+DIM+F+PL
zorreirinho	zorreiro+A+DIM+M+SG
zorreirinhos	zorreiro+A+DIM+M+PL
zorreiro	zorreiro+A+M+SG
zorreiros	zorreiro+A+M+PL
zorreirozinho	zorreiro+A+DIM+M+SG
zorreirozinhos	zorreiro+A+DIM+M+PL
zorra	zorro+A+F+SG
zorras	zorro+A+F+PL
zorrazinha	zorro+A+DIM+F+SG
zorrazinhas	zorro+A+DIM+F+PL
zorrinha	zorro+A+DIM+F+SG
zorrinhas	zorro+A+DIM+F+PL
zorrinho	zorro+A+DIM+M+SG
zorrinhos	zorro+A+DIM+M+PL
zorro	zorro+A+M+SG
zorros	zorro+A+M+PL
zorrozinho	zorro+A+DIM+M+SG
zorrozinhos	zorro+A+DIM+M+PL
zorrona	zorrão+A+F+SG
zorronas	zorrão+A+F+PL
zorronazinha	zorrão+A+DIM+F+SG
zorronazinhas	zorrão+A+DIM+F+PL
zorroninha	zorrão+A+DIM+F+SG
zorroninhas	zorrão+A+DIM+F+PL
zorrão	zorrão+A+M+SG
zorrãozinho	zorrão+A+DIM+M+SG
zorrões	zorrão+A+M+PL
zorrõezinhos	zorrão+A+DIM+M+PL
zortaveizinhas	zortável+A+DIM+F+PL
zortaveizinhos	zortável+A+DIM+M+PL
zortavelzinha	zortável+A+DIM+F+SG
zortavelzinho	zortável+A+DIM+M+SG
zortáveis	zortável+A+PL
zortável	zortável+A+SG
zorzaleira	zorzaleiro+A+F+SG
zorzaleiras	zorzaleiro+A+F+PL
zorzaleirazinha	zorzaleiro+A+DIM+F+SG
zorzaleirazinhas	zorzaleiro+A+DIM+F+PL
zorzaleirinha	zorzaleiro+A+DIM+F+SG
zorzaleirinhas	zorzaleiro+A+DIM+F+PL
zorzaleirinho	zorzaleiro+A+DIM+M+SG
zorzaleirinhos	zorzaleiro+A+DIM+M+PL
zorzaleiro	zorzaleiro+A+M+SG
zorzaleiros	zorzaleiro+A+M+PL
zorzaleirozinho	zorzaleiro+A+DIM+M+SG
zorzaleirozinhos	zorzaleiro+A+DIM+M+PL
zote	zote+A+SG
zotes	zote+A+PL
zotezinha	zote+A+DIM+F+SG
zotezinhas	zote+A+DIM+F+PL
zotezinho	zote+A+DIM+M+SG
zotezinhos	zote+A+DIM+M+PL
zotinha	zote+A+DIM+F+SG
zotinhas	zote+A+DIM+F+PL
zotinho	zote+A+DIM+M+SG
zotinhos	zote+A+DIM+M+PL
zoupeira	zoupeiro+A+F+SG
zoupeiras	zoupeiro+A+F+PL
zoupeirazinha	zoupeiro+A+DIM+F+SG
zoupeirazinhas	zoupeiro+A+DIM+F+PL
zoupeirinha	zoupeiro+A+DIM+F+SG
zoupeirinhas	zoupeiro+A+DIM+F+PL
zoupeirinho	zoupeiro+A+DIM+M+SG
zoupeirinhos	zoupeiro+A+DIM+M+PL
zoupeiro	zoupeiro+A+M+SG
zoupeiros	zoupeiro+A+M+PL
zoupeirozinho	zoupeiro+A+DIM+M+SG
zoupeirozinhos	zoupeiro+A+DIM+M+PL
zouvineira	zouvineiro+A+F+SG
zouvineiras	zouvineiro+A+F+PL
zouvineirazinha	zouvineiro+A+DIM+F+SG
zouvineirazinhas	zouvineiro+A+DIM+F+PL
zouvineirinha	zouvineiro+A+DIM+F+SG
zouvineirinhas	zouvineiro+A+DIM+F+PL
zouvineirinho	zouvineiro+A+DIM+M+SG
zouvineirinhos	zouvineiro+A+DIM+M+PL
zouvineiro	zouvineiro+A+M+SG
zouvineiros	zouvineiro+A+M+PL
zouvineirozinho	zouvineiro+A+DIM+M+SG
zouvineirozinhos	zouvineiro+A+DIM+M+PL
zoaveizinhas	zoável+A+DIM+F+PL
zoaveizinhos	zoável+A+DIM+M+PL
zoavelzinha	zoável+A+DIM+F+SG
zoavelzinho	zoável+A+DIM+M+SG
zoáveis	zoável+A+PL
zoável	zoável+A+SG
zoobiazinha	zoóbio+A+DIM+F+SG
zoobiazinhas	zoóbio+A+DIM+F+PL
zoobinha	zoóbio+A+DIM+F+SG
zoobinhas	zoóbio+A+DIM+F+PL
zoobinho	zoóbio+A+DIM+M+SG
zoobinhos	zoóbio+A+DIM+M+PL
zoobiozinho	zoóbio+A+DIM+M+SG
zoobiozinhos	zoóbio+A+DIM+M+PL
zoóbia	zoóbio+A+F+SG
zoóbias	zoóbio+A+F+PL
zoóbio	zoóbio+A+M+SG
zoóbios	zoóbio+A+M+PL
zoocorazinha	zoócoro+A+DIM+F+SG
zoocorazinhas	zoócoro+A+DIM+F+PL
zoocorinha	zoócoro+A+DIM+F+SG
zoocorinhas	zoócoro+A+DIM+F+PL
zoocorinho	zoócoro+A+DIM+M+SG
zoocorinhos	zoócoro+A+DIM+M+PL
zoocorozinho	zoócoro+A+DIM+M+SG
zoocorozinhos	zoócoro+A+DIM+M+PL
zoócora	zoócoro+A+F+SG
zoócoras	zoócoro+A+F+PL
zoócoro	zoócoro+A+M+SG
zoócoros	zoócoro+A+M+PL
zoofagazinha	zoófago+A+DIM+F+SG
zoofagazinhas	zoófago+A+DIM+F+PL
zoofagozinho	zoófago+A+DIM+M+SG
zoofagozinhos	zoófago+A+DIM+M+PL
zoofaguinha	zoófago+A+DIM+F+SG
zoofaguinhas	zoófago+A+DIM+F+PL
zoofaguinho	zoófago+A+DIM+M+SG
zoofaguinhos	zoófago+A+DIM+M+PL
zoófaga	zoófago+A+F+SG
zoófagas	zoófago+A+F+PL
zoófago	zoófago+A+M+SG
zoófagos	zoófago+A+M+PL
zoofilazinha	zoófilo+A+DIM+F+SG
zoofilazinhas	zoófilo+A+DIM+F+PL
zoofilinha	zoófilo+A+DIM+F+SG
zoofilinhas	zoófilo+A+DIM+F+PL
zoofilinho	zoófilo+A+DIM+M+SG
zoofilinhos	zoófilo+A+DIM+M+PL
zoofilozinho	zoófilo+A+DIM+M+SG
zoofilozinhos	zoófilo+A+DIM+M+PL
zoófila	zoófilo+A+F+SG
zoófilas	zoófilo+A+F+PL
zoófilo	zoófilo+A+M+SG
zoófilos	zoófilo+A+M+PL
zoofobazinha	zoófobo+A+DIM+F+SG
zoofobazinhas	zoófobo+A+DIM+F+PL
zoofobinha	zoófobo+A+DIM+F+SG
zoofobinhas	zoófobo+A+DIM+F+PL
zoofobinho	zoófobo+A+DIM+M+SG
zoofobinhos	zoófobo+A+DIM+M+PL
zoofobozinho	zoófobo+A+DIM+M+SG
zoofobozinhos	zoófobo+A+DIM+M+PL
zoófoba	zoófobo+A+F+SG
zoófobas	zoófobo+A+F+PL
zoófobo	zoófobo+A+M+SG
zoófobos	zoófobo+A+M+PL
zoogamazinha	zoógamo+A+DIM+F+SG
zoogamazinhas	zoógamo+A+DIM+F+PL
zoogaminha	zoógamo+A+DIM+F+SG
zoogaminhas	zoógamo+A+DIM+F+PL
zoogaminho	zoógamo+A+DIM+M+SG
zoogaminhos	zoógamo+A+DIM+M+PL
zoogamozinho	zoógamo+A+DIM+M+SG
zoogamozinhos	zoógamo+A+DIM+M+PL
zoógama	zoógamo+A+F+SG
zoógamas	zoógamo+A+F+PL
zoógamo	zoógamo+A+M+SG
zoógamos	zoógamo+A+M+PL
zoogonazinha	zoógono+A+DIM+F+SG
zoogonazinhas	zoógono+A+DIM+F+PL
zoogoninha	zoógono+A+DIM+F+SG
zoogoninhas	zoógono+A+DIM+F+PL
zoogoninho	zoógono+A+DIM+M+SG
zoogoninhos	zoógono+A+DIM+M+PL
zoogonozinho	zoógono+A+DIM+M+SG
zoogonozinhos	zoógono+A+DIM+M+PL
zoógona	zoógono+A+F+SG
zoógonas	zoógono+A+F+PL
zoógono	zoógono+A+M+SG
zoógonos	zoógono+A+M+PL
zooidezinha	zoóide+A+DIM+F+SG
zooidezinhas	zoóide+A+DIM+F+PL
zooidezinho	zoóide+A+DIM+M+SG
zooidezinhos	zoóide+A+DIM+M+PL
zooidinha	zoóide+A+DIM+F+SG
zooidinhas	zoóide+A+DIM+F+PL
zooidinho	zoóide+A+DIM+M+SG
zooidinhos	zoóide+A+DIM+M+PL
zoóide	zoóide+A+SG
zoóides	zoóide+A+PL
zoolatrazinha	zoólatra+A+DIM+F+SG
zoolatrazinhas	zoólatra+A+DIM+F+PL
zoolatrazinho	zoólatra+A+DIM+M+SG
zoolatrazinhos	zoólatra+A+DIM+M+PL
zoolatrinha	zoólatra+A+DIM+SG
zoolatrinhas	zoólatra+A+DIM+PL
zoólatra	zoólatra+A+SG
zoólatras	zoólatra+A+PL
zoonicazinha	zoónico+A+DIM+F+SG
zoonicazinhas	zoónico+A+DIM+F+PL
zoonicozinho	zoónico+A+DIM+M+SG
zoonicozinhos	zoónico+A+DIM+M+PL
zooniquinha	zoónico+A+DIM+F+SG
zooniquinhas	zoónico+A+DIM+F+PL
zooniquinho	zoónico+A+DIM+M+SG
zooniquinhos	zoónico+A+DIM+M+PL
zoónica	zoónico+A+F+SG
zoónicas	zoónico+A+F+PL
zoónico	zoónico+A+M+SG
zoónicos	zoónico+A+M+PL
zoopticazinha	zoóptico+A+DIM+F+SG
zoopticazinhas	zoóptico+A+DIM+F+PL
zoopticozinho	zoóptico+A+DIM+M+SG
zoopticozinhos	zoóptico+A+DIM+M+PL
zooptiquinha	zoóptico+A+DIM+F+SG
zooptiquinhas	zoóptico+A+DIM+F+PL
zooptiquinho	zoóptico+A+DIM+M+SG
zooptiquinhos	zoóptico+A+DIM+M+PL
zoóptica	zoóptico+A+F+SG
zoópticas	zoóptico+A+F+PL
zoóptico	zoóptico+A+M+SG
zoópticos	zoóptico+A+M+PL
zooticazinha	zoótico+A+DIM+F+SG
zooticazinhas	zoótico+A+DIM+F+PL
zooticozinho	zoótico+A+DIM+M+SG
zooticozinhos	zoótico+A+DIM+M+PL
zootiquinha	zoótico+A+DIM+F+SG
zootiquinhas	zoótico+A+DIM+F+PL
zootiquinho	zoótico+A+DIM+M+SG
zootiquinhos	zoótico+A+DIM+M+PL
zoótica	zoótico+A+F+SG
zoóticas	zoótico+A+F+PL
zoótico	zoótico+A+M+SG
zoóticos	zoótico+A+M+PL
zoonicazinha	zoônico+A+DIM+F+SG
zoonicazinhas	zoônico+A+DIM+F+PL
zoonicozinho	zoônico+A+DIM+M+SG
zoonicozinhos	zoônico+A+DIM+M+PL
zooniquinha	zoônico+A+DIM+F+SG
zooniquinhas	zoônico+A+DIM+F+PL
zooniquinho	zoônico+A+DIM+M+SG
zooniquinhos	zoônico+A+DIM+M+PL
zoônica	zoônico+A+F+SG
zoônicas	zoônico+A+F+PL
zoônico	zoônico+A+M+SG
zoônicos	zoônico+A+M+PL
zuca	zuco+A+F+SG
zucas	zuco+A+F+PL
zucazinha	zuco+A+DIM+F+SG
zucazinhas	zuco+A+DIM+F+PL
zuco	zuco+A+M+SG
zucos	zuco+A+M+PL
zucozinho	zuco+A+DIM+M+SG
zucozinhos	zuco+A+DIM+M+PL
zuquinha	zuco+A+DIM+F+SG
zuquinhas	zuco+A+DIM+F+PL
zuquinho	zuco+A+DIM+M+SG
zuquinhos	zuco+A+DIM+M+PL
zucaveizinhas	zucável+A+DIM+F+PL
zucaveizinhos	zucável+A+DIM+M+PL
zucavelzinha	zucável+A+DIM+F+SG
zucavelzinho	zucável+A+DIM+M+SG
zucáveis	zucável+A+PL
zucável	zucável+A+SG
zulinho	zulo+A+DIM+SG
zulinhos	zulo+A+DIM+PL
zulo	zulo+A+SG
zulos	zulo+A+PL
zulozinha	zulo+A+DIM+F+SG
zulozinhas	zulo+A+DIM+F+PL
zulozinho	zulo+A+DIM+M+SG
zulozinhos	zulo+A+DIM+M+PL
zulu	zulu+A+SG
zulus	zulu+A+PL
zuluzinha	zulu+A+DIM+F+SG
zuluzinhas	zulu+A+DIM+F+PL
zuluzinho	zulu+A+DIM+M+SG
zuluzinhos	zulu+A+DIM+M+PL
zulaveizinhas	zulável+A+DIM+F+PL
zulaveizinhos	zulável+A+DIM+M+PL
zulavelzinha	zulável+A+DIM+F+SG
zulavelzinho	zulável+A+DIM+M+SG
zuláveis	zulável+A+PL
zulável	zulável+A+SG
zumbaiaveizinhas	zumbaiável+A+DIM+F+PL
zumbaiaveizinhos	zumbaiável+A+DIM+M+PL
zumbaiavelzinha	zumbaiável+A+DIM+F+SG
zumbaiavelzinho	zumbaiável+A+DIM+M+SG
zumbaiáveis	zumbaiável+A+PL
zumbaiável	zumbaiável+A+SG
zumbeiraveizinhas	zumbeirável+A+DIM+F+PL
zumbeiraveizinhos	zumbeirável+A+DIM+M+PL
zumbeiravelzinha	zumbeirável+A+DIM+F+SG
zumbeiravelzinho	zumbeirável+A+DIM+M+SG
zumbeiráveis	zumbeirável+A+PL
zumbeirável	zumbeirável+A+SG
zumbidor	zumbidor+A+M+SG
zumbidora	zumbidor+A+F+SG
zumbidoras	zumbidor+A+F+PL
zumbidorazinha	zumbidor+A+DIM+F+SG
zumbidorazinhas	zumbidor+A+DIM+F+PL
zumbidores	zumbidor+A+M+PL
zumbidorezinhos	zumbidor+A+DIM+M+PL
zumbidorinha	zumbidor+A+DIM+F+SG
zumbidorinhas	zumbidor+A+DIM+F+PL
zumbidorzinho	zumbidor+A+DIM+M+SG
zumbidorzinhos	zumbidor+A+DIM+M+PL
zumbaveizinhas	zumbável+A+DIM+F+PL
zumbaveizinhos	zumbável+A+DIM+M+PL
zumbavelzinha	zumbável+A+DIM+F+SG
zumbavelzinho	zumbável+A+DIM+M+SG
zumbáveis	zumbável+A+PL
zumbável	zumbável+A+SG
zungaveizinhas	zungável+A+DIM+F+PL
zungaveizinhos	zungável+A+DIM+M+PL
zungavelzinha	zungável+A+DIM+F+SG
zungavelzinho	zungável+A+DIM+M+SG
zungáveis	zungável+A+PL
zungável	zungável+A+SG
zunida	zunido+A+F+SG
zunidas	zunido+A+F+PL
zunidazinha	zunido+A+DIM+F+SG
zunidazinhas	zunido+A+DIM+F+PL
zunidinha	zunido+A+DIM+F+SG
zunidinhas	zunido+A+DIM+F+PL
zunidinho	zunido+A+DIM+M+SG
zunidinhos	zunido+A+DIM+M+PL
zunido	zunido+A+M+SG
zunidos	zunido+A+M+PL
zunidozinho	zunido+A+DIM+M+SG
zunidozinhos	zunido+A+DIM+M+PL
zunidor	zunidor+A+M+SG
zunidora	zunidor+A+F+SG
zunidoras	zunidor+A+F+PL
zunidorazinha	zunidor+A+DIM+F+SG
zunidorazinhas	zunidor+A+DIM+F+PL
zunidores	zunidor+A+M+PL
zunidorezinhos	zunidor+A+DIM+M+PL
zunidorinha	zunidor+A+DIM+F+SG
zunidorinhas	zunidor+A+DIM+F+PL
zunidorzinho	zunidor+A+DIM+M+SG
zunidorzinhos	zunidor+A+DIM+M+PL
zunzunaveizinhas	zunzunável+A+DIM+F+PL
zunzunaveizinhos	zunzunável+A+DIM+M+PL
zunzunavelzinha	zunzunável+A+DIM+F+SG
zunzunavelzinho	zunzunável+A+DIM+M+SG
zunzunáveis	zunzunável+A+PL
zunzunável	zunzunável+A+SG
zupador	zupador+A+M+SG
zupadora	zupador+A+F+SG
zupadoras	zupador+A+F+PL
zupadorazinha	zupador+A+DIM+F+SG
zupadorazinhas	zupador+A+DIM+F+PL
zupadores	zupador+A+M+PL
zupadorezinhos	zupador+A+DIM+M+PL
zupadorinha	zupador+A+DIM+F+SG
zupadorinhas	zupador+A+DIM+F+PL
zupadorzinho	zupador+A+DIM+M+SG
zupadorzinhos	zupador+A+DIM+M+PL
zupaveizinhas	zupável+A+DIM+F+PL
zupaveizinhos	zupável+A+DIM+M+PL
zupavelzinha	zupável+A+DIM+F+SG
zupavelzinho	zupável+A+DIM+M+SG
zupáveis	zupável+A+PL
zupável	zupável+A+SG
zurrador	zurrador+A+M+SG
zurradora	zurrador+A+F+SG
zurradoras	zurrador+A+F+PL
zurradorazinha	zurrador+A+DIM+F+SG
zurradorazinhas	zurrador+A+DIM+F+PL
zurradores	zurrador+A+M+PL
zurradorezinhos	zurrador+A+DIM+M+PL
zurradorinha	zurrador+A+DIM+F+SG
zurradorinhas	zurrador+A+DIM+F+PL
zurradorzinho	zurrador+A+DIM+M+SG
zurradorzinhos	zurrador+A+DIM+M+PL
zurraveizinhas	zurrável+A+DIM+F+PL
zurraveizinhos	zurrável+A+DIM+M+PL
zurravelzinha	zurrável+A+DIM+F+SG
zurravelzinho	zurrável+A+DIM+M+SG
zurráveis	zurrável+A+PL
zurrável	zurrável+A+SG
zurupaveizinhas	zurupável+A+DIM+F+PL
zurupaveizinhos	zurupável+A+DIM+M+PL
zurupavelzinha	zurupável+A+DIM+F+SG
zurupavelzinho	zurupável+A+DIM+M+SG
zurupáveis	zurupável+A+PL
zurupável	zurupável+A+SG
zurzida	zurzido+A+F+SG
zurzidas	zurzido+A+F+PL
zurzidazinha	zurzido+A+DIM+F+SG
zurzidazinhas	zurzido+A+DIM+F+PL
zurzidinha	zurzido+A+DIM+F+SG
zurzidinhas	zurzido+A+DIM+F+PL
zurzidinho	zurzido+A+DIM+M+SG
zurzidinhos	zurzido+A+DIM+M+PL
zurzido	zurzido+A+M+SG
zurzidos	zurzido+A+M+PL
zurzidozinho	zurzido+A+DIM+M+SG
zurzidozinhos	zurzido+A+DIM+M+PL
zurzidor	zurzidor+A+M+SG
zurzidora	zurzidor+A+F+SG
zurzidoras	zurzidor+A+F+PL
zurzidorazinha	zurzidor+A+DIM+F+SG
zurzidorazinhas	zurzidor+A+DIM+F+PL
zurzidores	zurzidor+A+M+PL
zurzidorezinhos	zurzidor+A+DIM+M+PL
zurzidorinha	zurzidor+A+DIM+F+SG
zurzidorinhas	zurzidor+A+DIM+F+PL
zurzidorzinho	zurzidor+A+DIM+M+SG
zurzidorzinhos	zurzidor+A+DIM+M+PL
zaimbazinha	zâimbo+A+DIM+F+SG
zaimbazinhas	zâimbo+A+DIM+F+PL
zaimbinha	zâimbo+A+DIM+F+SG
zaimbinhas	zâimbo+A+DIM+F+PL
zaimbinho	zâimbo+A+DIM+M+SG
zaimbinhos	zâimbo+A+DIM+M+PL
zaimbozinho	zâimbo+A+DIM+M+SG
zaimbozinhos	zâimbo+A+DIM+M+PL
zâimba	zâimbo+A+F+SG
zâimbas	zâimbo+A+F+PL
zâimbo	zâimbo+A+M+SG
zâimbos	zâimbo+A+M+PL
zambiazinha	zâmbio+A+DIM+F+SG
zambiazinhas	zâmbio+A+DIM+F+PL
zambinha	zâmbio+A+DIM+F+SG
zambinhas	zâmbio+A+DIM+F+PL
zambinho	zâmbio+A+DIM+M+SG
zambinhos	zâmbio+A+DIM+M+PL
zambiozinho	zâmbio+A+DIM+M+SG
zambiozinhos	zâmbio+A+DIM+M+PL
zâmbia	zâmbio+A+F+SG
zâmbias	zâmbio+A+F+PL
zâmbio	zâmbio+A+M+SG
zâmbios	zâmbio+A+M+PL
zanclidazinha	zânclida+A+DIM+F+SG
zanclidazinhas	zânclida+A+DIM+F+PL
zanclidazinho	zânclida+A+DIM+M+SG
zanclidazinhos	zânclida+A+DIM+M+PL
zanclidinha	zânclida+A+DIM+SG
zanclidinhas	zânclida+A+DIM+PL
zânclida	zânclida+A+SG
zânclidas	zânclida+A+PL
zãiba	zãibo+A+F+SG
zãibas	zãibo+A+F+PL
zãibazinha	zãibo+A+DIM+F+SG
zãibazinhas	zãibo+A+DIM+F+PL
zãibinha	zãibo+A+DIM+F+SG
zãibinhas	zãibo+A+DIM+F+PL
zãibinho	zãibo+A+DIM+M+SG
zãibinhos	zãibo+A+DIM+M+PL
zãibo	zãibo+A+M+SG
zãibos	zãibo+A+M+PL
zãibozinho	zãibo+A+DIM+M+SG
zãibozinhos	zãibo+A+DIM+M+PL
zimicazinha	zímico+A+DIM+F+SG
zimicazinhas	zímico+A+DIM+F+PL
zimicozinho	zímico+A+DIM+M+SG
zimicozinhos	zímico+A+DIM+M+PL
zimiquinha	zímico+A+DIM+F+SG
zimiquinhas	zímico+A+DIM+F+PL
zimiquinho	zímico+A+DIM+M+SG
zimiquinhos	zímico+A+DIM+M+PL
zímica	zímico+A+F+SG
zímicas	zímico+A+F+PL
zímico	zímico+A+M+SG
zímicos	zímico+A+M+PL
zincicazinha	zíncico+A+DIM+F+SG
zincicazinhas	zíncico+A+DIM+F+PL
zincicozinho	zíncico+A+DIM+M+SG
zincicozinhos	zíncico+A+DIM+M+PL
zinciquinha	zíncico+A+DIM+F+SG
zinciquinhas	zíncico+A+DIM+F+PL
zinciquinho	zíncico+A+DIM+M+SG
zinciquinhos	zíncico+A+DIM+M+PL
zíncica	zíncico+A+F+SG
zíncicas	zíncico+A+F+PL
zíncico	zíncico+A+M+SG
zíncicos	zíncico+A+M+PL
zoicazinha	zóico+A+DIM+F+SG
zoicazinhas	zóico+A+DIM+F+PL
zoicozinho	zóico+A+DIM+M+SG
zoicozinhos	zóico+A+DIM+M+PL
zoiquinha	zóico+A+DIM+F+SG
zoiquinhas	zóico+A+DIM+F+PL
zoiquinho	zóico+A+DIM+M+SG
zoiquinhos	zóico+A+DIM+M+PL
zóica	zóico+A+F+SG
zóicas	zóico+A+F+PL
zóico	zóico+A+M+SG
zóicos	zóico+A+M+PL
