jacente	jacente+A+SG
jacentes	jacente+A+PL
jacentezinha	jacente+A+DIM+F+SG
jacentezinhas	jacente+A+DIM+F+PL
jacentezinho	jacente+A+DIM+M+SG
jacentezinhos	jacente+A+DIM+M+PL
jacentinha	jacente+A+DIM+F+SG
jacentinhas	jacente+A+DIM+F+PL
jacentinho	jacente+A+DIM+M+SG
jacentinhos	jacente+A+DIM+M+PL
jacintina	jacintino+A+F+SG
jacintinas	jacintino+A+F+PL
jacintinazinha	jacintino+A+DIM+F+SG
jacintinazinhas	jacintino+A+DIM+F+PL
jacintininha	jacintino+A+DIM+F+SG
jacintininhas	jacintino+A+DIM+F+PL
jacintininho	jacintino+A+DIM+M+SG
jacintininhos	jacintino+A+DIM+M+PL
jacintino	jacintino+A+M+SG
jacintinos	jacintino+A+M+PL
jacintinozinho	jacintino+A+DIM+M+SG
jacintinozinhos	jacintino+A+DIM+M+PL
jacksoniana	jacksoniano+A+F+SG
jacksonianas	jacksoniano+A+F+PL
jacksonianazinha	jacksoniano+A+DIM+F+SG
jacksonianazinhas	jacksoniano+A+DIM+F+PL
jacksonianinha	jacksoniano+A+DIM+F+SG
jacksonianinhas	jacksoniano+A+DIM+F+PL
jacksonianinho	jacksoniano+A+DIM+M+SG
jacksonianinhos	jacksoniano+A+DIM+M+PL
jacksoniano	jacksoniano+A+M+SG
jacksonianos	jacksoniano+A+M+PL
jacksonianozinho	jacksoniano+A+DIM+M+SG
jacksonianozinhos	jacksoniano+A+DIM+M+PL
jacobinizaveizinhas	jacobinizável+A+DIM+F+PL
jacobinizaveizinhos	jacobinizável+A+DIM+M+PL
jacobinizavelzinha	jacobinizável+A+DIM+F+SG
jacobinizavelzinho	jacobinizável+A+DIM+M+SG
jacobinizáveis	jacobinizável+A+PL
jacobinizável	jacobinizável+A+SG
jacobina	jacobino+A+F+SG
jacobinas	jacobino+A+F+PL
jacobinazinha	jacobino+A+DIM+F+SG
jacobinazinhas	jacobino+A+DIM+F+PL
jacobininha	jacobino+A+DIM+F+SG
jacobininhas	jacobino+A+DIM+F+PL
jacobininho	jacobino+A+DIM+M+SG
jacobininhos	jacobino+A+DIM+M+PL
jacobino	jacobino+A+M+SG
jacobinos	jacobino+A+M+PL
jacobinozinho	jacobino+A+DIM+M+SG
jacobinozinhos	jacobino+A+DIM+M+PL
jacorais	jacoral+A+PL
jacoraizinhas	jacoral+A+DIM+F+PL
jacoraizinhos	jacoral+A+DIM+M+PL
jacoral	jacoral+A+SG
jacoralzinha	jacoral+A+DIM+F+SG
jacoralzinho	jacoral+A+DIM+M+SG
jacorariazinha	jacorário+A+DIM+F+SG
jacorariazinhas	jacorário+A+DIM+F+PL
jacorarinha	jacorário+A+DIM+F+SG
jacorarinhas	jacorário+A+DIM+F+PL
jacorarinho	jacorário+A+DIM+M+SG
jacorarinhos	jacorário+A+DIM+M+PL
jacorariozinho	jacorário+A+DIM+M+SG
jacorariozinhos	jacorário+A+DIM+M+PL
jacorária	jacorário+A+F+SG
jacorárias	jacorário+A+F+PL
jacorário	jacorário+A+M+SG
jacorários	jacorário+A+M+PL
jactanciosa	jactancioso+A+F+SG
jactanciosas	jactancioso+A+F+PL
jactanciosazinha	jactancioso+A+DIM+F+SG
jactanciosazinhas	jactancioso+A+DIM+F+PL
jactanciosinha	jactancioso+A+DIM+F+SG
jactanciosinhas	jactancioso+A+DIM+F+PL
jactanciosinho	jactancioso+A+DIM+M+SG
jactanciosinhos	jactancioso+A+DIM+M+PL
jactancioso	jactancioso+A+M+SG
jactanciosos	jactancioso+A+M+PL
jactanciosozinho	jactancioso+A+DIM+M+SG
jactanciosozinhos	jactancioso+A+DIM+M+PL
jactanciaveizinhas	jactanciável+A+DIM+F+PL
jactanciaveizinhos	jactanciável+A+DIM+M+PL
jactanciavelzinha	jactanciável+A+DIM+F+SG
jactanciavelzinho	jactanciável+A+DIM+M+SG
jactanciáveis	jactanciável+A+PL
jactanciável	jactanciável+A+SG
jactante	jactante+A+SG
jactantes	jactante+A+PL
jactantezinha	jactante+A+DIM+F+SG
jactantezinhas	jactante+A+DIM+F+PL
jactantezinho	jactante+A+DIM+M+SG
jactantezinhos	jactante+A+DIM+M+PL
jactantinha	jactante+A+DIM+F+SG
jactantinhas	jactante+A+DIM+F+PL
jactantinho	jactante+A+DIM+M+SG
jactantinhos	jactante+A+DIM+M+PL
jactaveizinhas	jactável+A+DIM+F+PL
jactaveizinhos	jactável+A+DIM+M+PL
jactavelzinha	jactável+A+DIM+F+SG
jactavelzinho	jactável+A+DIM+M+SG
jactáveis	jactável+A+PL
jactável	jactável+A+SG
jaculador	jaculador+A+M+SG
jaculadora	jaculador+A+F+SG
jaculadoras	jaculador+A+F+PL
jaculadorazinha	jaculador+A+DIM+F+SG
jaculadorazinhas	jaculador+A+DIM+F+PL
jaculadores	jaculador+A+M+PL
jaculadorezinhos	jaculador+A+DIM+M+PL
jaculadorinha	jaculador+A+DIM+F+SG
jaculadorinhas	jaculador+A+DIM+F+PL
jaculadorzinho	jaculador+A+DIM+M+SG
jaculadorzinhos	jaculador+A+DIM+M+PL
jaculatoriazinha	jaculatório+A+DIM+F+SG
jaculatoriazinhas	jaculatório+A+DIM+F+PL
jaculatorinha	jaculatório+A+DIM+F+SG
jaculatorinhas	jaculatório+A+DIM+F+PL
jaculatorinho	jaculatório+A+DIM+M+SG
jaculatorinhos	jaculatório+A+DIM+M+PL
jaculatoriozinho	jaculatório+A+DIM+M+SG
jaculatoriozinhos	jaculatório+A+DIM+M+PL
jaculatória	jaculatório+A+F+SG
jaculatórias	jaculatório+A+F+PL
jaculatório	jaculatório+A+M+SG
jaculatórios	jaculatório+A+M+PL
jaculaveizinhas	jaculável+A+DIM+F+PL
jaculaveizinhos	jaculável+A+DIM+M+PL
jaculavelzinha	jaculável+A+DIM+F+SG
jaculavelzinho	jaculável+A+DIM+M+SG
jaculáveis	jaculável+A+PL
jaculável	jaculável+A+SG
jaezaveizinhas	jaezável+A+DIM+F+PL
jaezaveizinhos	jaezável+A+DIM+M+PL
jaezavelzinha	jaezável+A+DIM+F+SG
jaezavelzinho	jaezável+A+DIM+M+SG
jaezáveis	jaezável+A+PL
jaezável	jaezável+A+SG
jafeticazinha	jafético+A+DIM+F+SG
jafeticazinhas	jafético+A+DIM+F+PL
jafeticozinho	jafético+A+DIM+M+SG
jafeticozinhos	jafético+A+DIM+M+PL
jafetiquinha	jafético+A+DIM+F+SG
jafetiquinhas	jafético+A+DIM+F+PL
jafetiquinho	jafético+A+DIM+M+SG
jafetiquinhos	jafético+A+DIM+M+PL
jafética	jafético+A+F+SG
jaféticas	jafético+A+F+PL
jafético	jafético+A+M+SG
jaféticos	jafético+A+M+PL
jaguanezinha	jaguané+A+DIM+F+SG
jaguanezinhas	jaguané+A+DIM+F+PL
jaguanezinho	jaguané+A+DIM+M+SG
jaguanezinhos	jaguané+A+DIM+M+PL
jaguané	jaguané+A+SG
jaguanés	jaguané+A+PL
jaguaretezinho	jaguaretê+A+DIM+M+SG
jaguaretezinhos	jaguaretê+A+DIM+M+PL
jaguaretê	jaguaretê+A+M+SG
jaguaretês	jaguaretê+A+M+PL
jalde	jalde+A+SG
jaldes	jalde+A+PL
jaldezinha	jalde+A+DIM+F+SG
jaldezinhas	jalde+A+DIM+F+PL
jaldezinho	jalde+A+DIM+M+SG
jaldezinhos	jalde+A+DIM+M+PL
jaldinha	jalde+A+DIM+F+SG
jaldinhas	jalde+A+DIM+F+PL
jaldinho	jalde+A+DIM+M+SG
jaldinhos	jalde+A+DIM+M+PL
jaldinina	jaldinino+A+F+SG
jaldininas	jaldinino+A+F+PL
jaldininazinha	jaldinino+A+DIM+F+SG
jaldininazinhas	jaldinino+A+DIM+F+PL
jaldinininha	jaldinino+A+DIM+F+SG
jaldinininhas	jaldinino+A+DIM+F+PL
jaldinininho	jaldinino+A+DIM+M+SG
jaldinininhos	jaldinino+A+DIM+M+PL
jaldinino	jaldinino+A+M+SG
jaldininos	jaldinino+A+M+PL
jaldininozinho	jaldinino+A+DIM+M+SG
jaldininozinhos	jaldinino+A+DIM+M+PL
jalne	jalne+A+SG
jalnes	jalne+A+PL
jalnezinha	jalne+A+DIM+F+SG
jalnezinhas	jalne+A+DIM+F+PL
jalnezinho	jalne+A+DIM+M+SG
jalnezinhos	jalne+A+DIM+M+PL
jalninha	jalne+A+DIM+F+SG
jalninhas	jalne+A+DIM+F+PL
jalninho	jalne+A+DIM+M+SG
jalninhos	jalne+A+DIM+M+PL
jalofa	jalofo+A+F+SG
jalofas	jalofo+A+F+PL
jalofazinha	jalofo+A+DIM+F+SG
jalofazinhas	jalofo+A+DIM+F+PL
jalofinha	jalofo+A+DIM+F+SG
jalofinhas	jalofo+A+DIM+F+PL
jalofinho	jalofo+A+DIM+M+SG
jalofinhos	jalofo+A+DIM+M+PL
jalofo	jalofo+A+M+SG
jalofos	jalofo+A+M+PL
jalofozinho	jalofo+A+DIM+M+SG
jalofozinhos	jalofo+A+DIM+M+PL
jamaicana	jamaicano+A+F+SG
jamaicanas	jamaicano+A+F+PL
jamaicanazinha	jamaicano+A+DIM+F+SG
jamaicanazinhas	jamaicano+A+DIM+F+PL
jamaicaninha	jamaicano+A+DIM+F+SG
jamaicaninhas	jamaicano+A+DIM+F+PL
jamaicaninho	jamaicano+A+DIM+M+SG
jamaicaninhos	jamaicano+A+DIM+M+PL
jamaicano	jamaicano+A+M+SG
jamaicanos	jamaicano+A+M+PL
jamaicanozinho	jamaicano+A+DIM+M+SG
jamaicanozinhos	jamaicano+A+DIM+M+PL
janeanes	janeanes+A
janeanesinha	janeanes+A+DIM+F+SG
janeanesinhas	janeanes+A+DIM+F+PL
janeanesinho	janeanes+A+DIM+M+SG
janeanesinhos	janeanes+A+DIM+M+PL
janeireira	janeireiro+A+F+SG
janeireiras	janeireiro+A+F+PL
janeireirazinha	janeireiro+A+DIM+F+SG
janeireirazinhas	janeireiro+A+DIM+F+PL
janeireirinha	janeireiro+A+DIM+F+SG
janeireirinhas	janeireiro+A+DIM+F+PL
janeireirinho	janeireiro+A+DIM+M+SG
janeireirinhos	janeireiro+A+DIM+M+PL
janeireiro	janeireiro+A+M+SG
janeireiros	janeireiro+A+M+PL
janeireirozinho	janeireiro+A+DIM+M+SG
janeireirozinhos	janeireiro+A+DIM+M+PL
janeirenta	janeirento+A+F+SG
janeirentas	janeirento+A+F+PL
janeirentazinha	janeirento+A+DIM+F+SG
janeirentazinhas	janeirento+A+DIM+F+PL
janeirentinha	janeirento+A+DIM+F+SG
janeirentinhas	janeirento+A+DIM+F+PL
janeirentinho	janeirento+A+DIM+M+SG
janeirentinhos	janeirento+A+DIM+M+PL
janeirento	janeirento+A+M+SG
janeirentos	janeirento+A+M+PL
janeirentozinho	janeirento+A+DIM+M+SG
janeirentozinhos	janeirento+A+DIM+M+PL
janeirinha	janeirinho+A+F+SG
janeirinhas	janeirinho+A+F+PL
janeirinhazinha	janeirinho+A+DIM+F+SG
janeirinhazinhas	janeirinho+A+DIM+F+PL
janeirinhinha	janeirinho+A+DIM+F+SG
janeirinhinhas	janeirinho+A+DIM+F+PL
janeirinhinho	janeirinho+A+DIM+M+SG
janeirinhinhos	janeirinho+A+DIM+M+PL
janeirinho	janeirinho+A+M+SG
janeirinhos	janeirinho+A+M+PL
janeirinhozinho	janeirinho+A+DIM+M+SG
janeirinhozinhos	janeirinho+A+DIM+M+PL
janeleira	janeleiro+A+F+SG
janeleiras	janeleiro+A+F+PL
janeleirazinha	janeleiro+A+DIM+F+SG
janeleirazinhas	janeleiro+A+DIM+F+PL
janeleirinha	janeleiro+A+DIM+F+SG
janeleirinhas	janeleiro+A+DIM+F+PL
janeleirinho	janeleiro+A+DIM+M+SG
janeleirinhos	janeleiro+A+DIM+M+PL
janeleiro	janeleiro+A+M+SG
janeleiros	janeleiro+A+M+PL
janeleirozinho	janeleiro+A+DIM+M+SG
janeleirozinhos	janeleiro+A+DIM+M+PL
janelaveizinhas	janelável+A+DIM+F+PL
janelaveizinhos	janelável+A+DIM+M+PL
janelavelzinha	janelável+A+DIM+F+SG
janelavelzinho	janelável+A+DIM+M+SG
janeláveis	janelável+A+PL
janelável	janelável+A+SG
janguista	janguista+A+SG
janguistas	janguista+A+PL
janguistazinha	janguista+A+DIM+F+SG
janguistazinhas	janguista+A+DIM+F+PL
janguistazinho	janguista+A+DIM+M+SG
janguistazinhos	janguista+A+DIM+M+PL
janguistinha	janguista+A+DIM+SG
janguistinhas	janguista+A+DIM+PL
janista	janista+A+SG
janistas	janista+A+PL
janistazinha	janista+A+DIM+F+SG
janistazinhas	janista+A+DIM+F+PL
janistazinho	janista+A+DIM+M+SG
janistazinhos	janista+A+DIM+M+PL
janistinha	janista+A+DIM+SG
janistinhas	janista+A+DIM+PL
janota	janota+A+SG
janotas	janota+A+PL
janotazinha	janota+A+DIM+F+SG
janotazinhas	janota+A+DIM+F+PL
janotazinho	janota+A+DIM+M+SG
janotazinhos	janota+A+DIM+M+PL
janotinha	janota+A+DIM+SG
janotinhas	janota+A+DIM+PL
janoteaveizinhas	janoteável+A+DIM+F+PL
janoteaveizinhos	janoteável+A+DIM+M+PL
janoteavelzinha	janoteável+A+DIM+F+SG
janoteavelzinho	janoteável+A+DIM+M+SG
janoteáveis	janoteável+A+PL
janoteável	janoteável+A+SG
janotaveizinhas	janotável+A+DIM+F+PL
janotaveizinhos	janotável+A+DIM+M+PL
janotavelzinha	janotável+A+DIM+F+SG
janotavelzinho	janotável+A+DIM+M+SG
janotáveis	janotável+A+PL
janotável	janotável+A+SG
jantada	jantado+A+F+SG
jantadas	jantado+A+F+PL
jantadazinha	jantado+A+DIM+F+SG
jantadazinhas	jantado+A+DIM+F+PL
jantadinha	jantado+A+DIM+F+SG
jantadinhas	jantado+A+DIM+F+PL
jantadinho	jantado+A+DIM+M+SG
jantadinhos	jantado+A+DIM+M+PL
jantado	jantado+A+M+SG
jantados	jantado+A+M+PL
jantadozinho	jantado+A+DIM+M+SG
jantadozinhos	jantado+A+DIM+M+PL
jantaveizinhas	jantável+A+DIM+F+PL
jantaveizinhos	jantável+A+DIM+M+PL
jantavelzinha	jantável+A+DIM+F+SG
jantavelzinho	jantável+A+DIM+M+SG
jantáveis	jantável+A+PL
jantável	jantável+A+SG
japonense	japonense+A+SG
japonenses	japonense+A+PL
japonensezinha	japonense+A+DIM+F+SG
japonensezinhas	japonense+A+DIM+F+PL
japonensezinho	japonense+A+DIM+M+SG
japonensezinhos	japonense+A+DIM+M+PL
japonensinha	japonense+A+DIM+F+SG
japonensinhas	japonense+A+DIM+F+PL
japonensinho	japonense+A+DIM+M+SG
japonensinhos	japonense+A+DIM+M+PL
japonesaveizinhas	japonesável+A+DIM+F+PL
japonesaveizinhos	japonesável+A+DIM+M+PL
japonesavelzinha	japonesável+A+DIM+F+SG
japonesavelzinho	japonesável+A+DIM+M+SG
japonesáveis	japonesável+A+PL
japonesável	japonesável+A+SG
japonezaveizinhas	japonezável+A+DIM+F+PL
japonezaveizinhos	japonezável+A+DIM+M+PL
japonezavelzinha	japonezável+A+DIM+F+SG
japonezavelzinho	japonezável+A+DIM+M+SG
japonezáveis	japonezável+A+PL
japonezável	japonezável+A+SG
japonizaveizinhas	japonizável+A+DIM+F+PL
japonizaveizinhos	japonizável+A+DIM+M+PL
japonizavelzinha	japonizável+A+DIM+F+SG
japonizavelzinho	japonizável+A+DIM+M+SG
japonizáveis	japonizável+A+PL
japonizável	japonizável+A+SG
japonesa	japonês+A+F+SG
japonesas	japonês+A+F+PL
japonesazinha	japonês+A+DIM+F+SG
japonesazinhas	japonês+A+DIM+F+PL
japoneses	japonês+A+M+PL
japonesezinhos	japonês+A+DIM+M+PL
japonesinha	japonês+A+DIM+F+SG
japonesinhas	japonês+A+DIM+F+PL
japonesinho	japonês+A+DIM+M+SG
japonesinhos	japonês+A+DIM+M+PL
japonês	japonês+A+M+SG
japonesa-portuguesa	japonês-português+A+F+SG
japonesa-portuguesazinha	japonês-português+A+DIM+F+SG
japonesa-portuguesinha	japonês-português+A+DIM+F+SG
japonesa-portuguesinhas	japonês-português+A+DIM+F+PL
japonesas-portuguesas	japonês-português+A+F+PL
japonesas-portuguesazinhas	japonês-português+A+DIM+F+PL
japoneses-portugueses	japonês-português+A+M+PL
japoneses-portuguesezinhos	japonês-português+A+DIM+M+PL
japoneses-portuguesinhos	japonês-português+A+DIM+M+PL
japonês-portuguesinho	japonês-português+A+DIM+M+SG
japonês-português	japonês-português+A+M+SG
japonicazinha	japónico+A+DIM+F+SG
japonicazinhas	japónico+A+DIM+F+PL
japonicozinho	japónico+A+DIM+M+SG
japonicozinhos	japónico+A+DIM+M+PL
japoniquinha	japónico+A+DIM+F+SG
japoniquinhas	japónico+A+DIM+F+PL
japoniquinho	japónico+A+DIM+M+SG
japoniquinhos	japónico+A+DIM+M+PL
japónica	japónico+A+F+SG
japónicas	japónico+A+F+PL
japónico	japónico+A+M+SG
japónicos	japónico+A+M+PL
japonicazinha	japônico+A+DIM+F+SG
japonicazinhas	japônico+A+DIM+F+PL
japonicozinho	japônico+A+DIM+M+SG
japonicozinhos	japônico+A+DIM+M+PL
japoniquinha	japônico+A+DIM+F+SG
japoniquinhas	japônico+A+DIM+F+PL
japoniquinho	japônico+A+DIM+M+SG
japoniquinhos	japônico+A+DIM+M+PL
japônica	japônico+A+F+SG
japônicas	japônico+A+F+PL
japônico	japônico+A+M+SG
japônicos	japônico+A+M+PL
jardinada	jardinado+A+F+SG
jardinadas	jardinado+A+F+PL
jardinadazinha	jardinado+A+DIM+F+SG
jardinadazinhas	jardinado+A+DIM+F+PL
jardinadinha	jardinado+A+DIM+F+SG
jardinadinhas	jardinado+A+DIM+F+PL
jardinadinho	jardinado+A+DIM+M+SG
jardinadinhos	jardinado+A+DIM+M+PL
jardinado	jardinado+A+M+SG
jardinados	jardinado+A+M+PL
jardinadozinho	jardinado+A+DIM+M+SG
jardinadozinhos	jardinado+A+DIM+M+PL
jardinaveizinhas	jardinável+A+DIM+F+PL
jardinaveizinhos	jardinável+A+DIM+M+PL
jardinavelzinha	jardinável+A+DIM+F+SG
jardinavelzinho	jardinável+A+DIM+M+SG
jardináveis	jardinável+A+PL
jardinável	jardinável+A+SG
jarreteaveizinhas	jarreteável+A+DIM+F+PL
jarreteaveizinhos	jarreteável+A+DIM+M+PL
jarreteavelzinha	jarreteável+A+DIM+F+SG
jarreteavelzinho	jarreteável+A+DIM+M+SG
jarreteáveis	jarreteável+A+PL
jarreteável	jarreteável+A+SG
jarretaveizinhas	jarretável+A+DIM+F+PL
jarretaveizinhos	jarretável+A+DIM+M+PL
jarretavelzinha	jarretável+A+DIM+F+SG
jarretavelzinho	jarretável+A+DIM+M+SG
jarretáveis	jarretável+A+PL
jarretável	jarretável+A+SG
jarreaveizinhas	jarreável+A+DIM+F+PL
jarreaveizinhos	jarreável+A+DIM+M+PL
jarreavelzinha	jarreável+A+DIM+F+SG
jarreavelzinho	jarreável+A+DIM+M+SG
jarreáveis	jarreável+A+PL
jarreável	jarreável+A+SG
jasminaceazinha	jasmináceo+A+DIM+F+SG
jasminaceazinhas	jasmináceo+A+DIM+F+PL
jasminaceinha	jasmináceo+A+DIM+F+SG
jasminaceinhas	jasmináceo+A+DIM+F+PL
jasminaceinho	jasmináceo+A+DIM+M+SG
jasminaceinhos	jasmináceo+A+DIM+M+PL
jasminaceozinho	jasmináceo+A+DIM+M+SG
jasminaceozinhos	jasmináceo+A+DIM+M+PL
jasminácea	jasmináceo+A+F+SG
jasmináceas	jasmináceo+A+F+PL
jasmináceo	jasmináceo+A+M+SG
jasmináceos	jasmináceo+A+M+PL
jasmineazinha	jasmíneo+A+DIM+F+SG
jasmineazinhas	jasmíneo+A+DIM+F+PL
jasmineinha	jasmíneo+A+DIM+F+SG
jasmineinhas	jasmíneo+A+DIM+F+PL
jasmineinho	jasmíneo+A+DIM+M+SG
jasmineinhos	jasmíneo+A+DIM+M+PL
jasmineozinho	jasmíneo+A+DIM+M+SG
jasmineozinhos	jasmíneo+A+DIM+M+PL
jasmínea	jasmíneo+A+F+SG
jasmíneas	jasmíneo+A+F+PL
jasmíneo	jasmíneo+A+M+SG
jasmíneos	jasmíneo+A+M+PL
jaspeaveizinhas	jaspeável+A+DIM+F+PL
jaspeaveizinhos	jaspeável+A+DIM+M+PL
jaspeavelzinha	jaspeável+A+DIM+F+SG
jaspeavelzinho	jaspeável+A+DIM+M+SG
jaspeáveis	jaspeável+A+PL
jaspeável	jaspeável+A+SG
jaspoide	jaspoide+A+SG
jaspoides	jaspoide+A+PL
jaspoidezinha	jaspoide+A+DIM+F+SG
jaspoidezinhas	jaspoide+A+DIM+F+PL
jaspoidezinho	jaspoide+A+DIM+M+SG
jaspoidezinhos	jaspoide+A+DIM+M+PL
jaspoidinha	jaspoide+A+DIM+F+SG
jaspoidinhas	jaspoide+A+DIM+F+PL
jaspoidinho	jaspoide+A+DIM+M+SG
jaspoidinhos	jaspoide+A+DIM+M+PL
jaspoidezinha	jaspóide+A+DIM+F+SG
jaspoidezinhas	jaspóide+A+DIM+F+PL
jaspoidezinho	jaspóide+A+DIM+M+SG
jaspoidezinhos	jaspóide+A+DIM+M+PL
jaspoidinha	jaspóide+A+DIM+F+SG
jaspoidinhas	jaspóide+A+DIM+F+PL
jaspoidinho	jaspóide+A+DIM+M+SG
jaspoidinhos	jaspóide+A+DIM+M+PL
jaspóide	jaspóide+A+SG
jaspóides	jaspóide+A+PL
jatanciosa	jatancioso+A+F+SG
jatanciosas	jatancioso+A+F+PL
jatanciosazinha	jatancioso+A+DIM+F+SG
jatanciosazinhas	jatancioso+A+DIM+F+PL
jatanciosinha	jatancioso+A+DIM+F+SG
jatanciosinhas	jatancioso+A+DIM+F+PL
jatanciosinho	jatancioso+A+DIM+M+SG
jatanciosinhos	jatancioso+A+DIM+M+PL
jatancioso	jatancioso+A+M+SG
jatanciosos	jatancioso+A+M+PL
jatanciosozinho	jatancioso+A+DIM+M+SG
jatanciosozinhos	jatancioso+A+DIM+M+PL
jatanciaveizinhas	jatanciável+A+DIM+F+PL
jatanciaveizinhos	jatanciável+A+DIM+M+PL
jatanciavelzinha	jatanciável+A+DIM+F+SG
jatanciavelzinho	jatanciável+A+DIM+M+SG
jatanciáveis	jatanciável+A+PL
jatanciável	jatanciável+A+SG
jatante	jatante+A+SG
jatantes	jatante+A+PL
jatantezinha	jatante+A+DIM+F+SG
jatantezinhas	jatante+A+DIM+F+PL
jatantezinho	jatante+A+DIM+M+SG
jatantezinhos	jatante+A+DIM+M+PL
jatantinha	jatante+A+DIM+F+SG
jatantinhas	jatante+A+DIM+F+PL
jatantinho	jatante+A+DIM+M+SG
jatantinhos	jatante+A+DIM+M+PL
jataveizinhas	jatável+A+DIM+F+PL
jataveizinhos	jatável+A+DIM+M+PL
jatavelzinha	jatável+A+DIM+F+SG
jatavelzinho	jatável+A+DIM+M+SG
jatáveis	jatável+A+PL
jatável	jatável+A+SG
jau	jau+A+SG
jaus	jau+A+PL
jauzinha	jau+A+DIM+F+SG
jauzinhas	jau+A+DIM+F+PL
jauzinho	jau+A+DIM+M+SG
jauzinhos	jau+A+DIM+M+PL
javalina	javalina+A+F+SG
javalinas	javalina+A+F+PL
javalinazinha	javalina+A+DIM+F+SG
javalinazinhas	javalina+A+DIM+F+PL
javalininha	javalina+A+DIM+F+SG
javalininhas	javalina+A+DIM+F+PL
javalina	javalino+A+F+SG
javalinas	javalino+A+F+PL
javalinazinha	javalino+A+DIM+F+SG
javalinazinhas	javalino+A+DIM+F+PL
javalininha	javalino+A+DIM+F+SG
javalininhas	javalino+A+DIM+F+PL
javalininho	javalino+A+DIM+M+SG
javalininhos	javalino+A+DIM+M+PL
javalino	javalino+A+M+SG
javalinos	javalino+A+M+PL
javalinozinho	javalino+A+DIM+M+SG
javalinozinhos	javalino+A+DIM+M+PL
javanesa	javanês+A+F+SG
javanesas	javanês+A+F+PL
javanesazinha	javanês+A+DIM+F+SG
javanesazinhas	javanês+A+DIM+F+PL
javaneses	javanês+A+M+PL
javanesezinhos	javanês+A+DIM+M+PL
javanesinha	javanês+A+DIM+F+SG
javanesinhas	javanês+A+DIM+F+PL
javanesinho	javanês+A+DIM+M+SG
javanesinhos	javanês+A+DIM+M+PL
javanês	javanês+A+M+SG
javarda	javardo+A+F+SG
javardas	javardo+A+F+PL
javardazinha	javardo+A+DIM+F+SG
javardazinhas	javardo+A+DIM+F+PL
javardinha	javardo+A+DIM+F+SG
javardinhas	javardo+A+DIM+F+PL
javardinho	javardo+A+DIM+M+SG
javardinhos	javardo+A+DIM+M+PL
javardo	javardo+A+M+SG
javardos	javardo+A+M+PL
javardozinho	javardo+A+DIM+M+SG
javardozinhos	javardo+A+DIM+M+PL
javel	javel+A
javelzinha	javel+A+DIM+F+SG
javelzinhas	javel+A+DIM+F+PL
javelzinho	javel+A+DIM+M+SG
javelzinhos	javel+A+DIM+M+PL
javraveizinhas	javrável+A+DIM+F+PL
javraveizinhos	javrável+A+DIM+M+PL
javravelzinha	javrável+A+DIM+F+SG
javravelzinho	javrável+A+DIM+M+SG
javráveis	javrável+A+PL
javrável	javrável+A+SG
jazerina	jazerino+A+F+SG
jazerinas	jazerino+A+F+PL
jazerinazinha	jazerino+A+DIM+F+SG
jazerinazinhas	jazerino+A+DIM+F+PL
jazerininha	jazerino+A+DIM+F+SG
jazerininhas	jazerino+A+DIM+F+PL
jazerininho	jazerino+A+DIM+M+SG
jazerininhos	jazerino+A+DIM+M+PL
jazerino	jazerino+A+M+SG
jazerinos	jazerino+A+M+PL
jazerinozinho	jazerino+A+DIM+M+SG
jazerinozinhos	jazerino+A+DIM+M+PL
jazida	jazido+A+F+SG
jazidas	jazido+A+F+PL
jazidazinha	jazido+A+DIM+F+SG
jazidazinhas	jazido+A+DIM+F+PL
jazidinha	jazido+A+DIM+F+SG
jazidinhas	jazido+A+DIM+F+PL
jazidinho	jazido+A+DIM+M+SG
jazidinhos	jazido+A+DIM+M+PL
jazido	jazido+A+M+SG
jazidos	jazido+A+M+PL
jazidozinho	jazido+A+DIM+M+SG
jazidozinhos	jazido+A+DIM+M+PL
jazz-funk	jazz-funk+A
jazz-funkzinha	jazz-funk+A+DIM+F+SG
jazz-funkzinhas	jazz-funk+A+DIM+F+PL
jazz-funkzinho	jazz-funk+A+DIM+M+SG
jazz-funkzinhos	jazz-funk+A+DIM+M+PL
jazz-rock	jazz-rock+A
jazz-rockzinha	jazz-rock+A+DIM+F+SG
jazz-rockzinhas	jazz-rock+A+DIM+F+PL
jazz-rockzinho	jazz-rock+A+DIM+M+SG
jazz-rockzinhos	jazz-rock+A+DIM+M+PL
jazzista	jazzista+A+SG
jazzistas	jazzista+A+PL
jazzistazinha	jazzista+A+DIM+F+SG
jazzistazinhas	jazzista+A+DIM+F+PL
jazzistazinho	jazzista+A+DIM+M+SG
jazzistazinhos	jazzista+A+DIM+M+PL
jazzistinha	jazzista+A+DIM+SG
jazzistinhas	jazzista+A+DIM+PL
jazzisticazinha	jazzístico+A+DIM+F+SG
jazzisticazinhas	jazzístico+A+DIM+F+PL
jazzisticozinho	jazzístico+A+DIM+M+SG
jazzisticozinhos	jazzístico+A+DIM+M+PL
jazzistiquinha	jazzístico+A+DIM+F+SG
jazzistiquinhas	jazzístico+A+DIM+F+PL
jazzistiquinho	jazzístico+A+DIM+M+SG
jazzistiquinhos	jazzístico+A+DIM+M+PL
jazzística	jazzístico+A+F+SG
jazzísticas	jazzístico+A+F+PL
jazzístico	jazzístico+A+M+SG
jazzísticos	jazzístico+A+M+PL
jeans	jeans+A
jeansinha	jeans+A+DIM+F+SG
jeansinhas	jeans+A+DIM+F+PL
jeansinho	jeans+A+DIM+M+SG
jeansinhos	jeans+A+DIM+M+PL
jeca	jeca+A+SG
jecas	jeca+A+PL
jecazinha	jeca+A+DIM+F+SG
jecazinhas	jeca+A+DIM+F+PL
jecazinho	jeca+A+DIM+M+SG
jecazinhos	jeca+A+DIM+M+PL
jequinha	jeca+A+DIM+SG
jequinhas	jeca+A+DIM+PL
jecorais	jecoral+A+PL
jecoraizinhas	jecoral+A+DIM+F+PL
jecoraizinhos	jecoral+A+DIM+M+PL
jecoral	jecoral+A+SG
jecoralzinha	jecoral+A+DIM+F+SG
jecoralzinho	jecoral+A+DIM+M+SG
jeitosa	jeitoso+A+F+SG
jeitosas	jeitoso+A+F+PL
jeitosazinha	jeitoso+A+DIM+F+SG
jeitosazinhas	jeitoso+A+DIM+F+PL
jeitosinha	jeitoso+A+DIM+F+SG
jeitosinhas	jeitoso+A+DIM+F+PL
jeitosinho	jeitoso+A+DIM+M+SG
jeitosinhos	jeitoso+A+DIM+M+PL
jeitoso	jeitoso+A+M+SG
jeitosos	jeitoso+A+M+PL
jeitosozinho	jeitoso+A+DIM+M+SG
jeitosozinhos	jeitoso+A+DIM+M+PL
jejuador	jejuador+A+M+SG
jejuadora	jejuador+A+F+SG
jejuadoras	jejuador+A+F+PL
jejuadorazinha	jejuador+A+DIM+F+SG
jejuadorazinhas	jejuador+A+DIM+F+PL
jejuadores	jejuador+A+M+PL
jejuadorezinhos	jejuador+A+DIM+M+PL
jejuadorinha	jejuador+A+DIM+F+SG
jejuadorinhas	jejuador+A+DIM+F+PL
jejuadorzinho	jejuador+A+DIM+M+SG
jejuadorzinhos	jejuador+A+DIM+M+PL
jejunais	jejunal+A+PL
jejunaizinhas	jejunal+A+DIM+F+PL
jejunaizinhos	jejunal+A+DIM+M+PL
jejunal	jejunal+A+SG
jejunalzinha	jejunal+A+DIM+F+SG
jejunalzinho	jejunal+A+DIM+M+SG
jejuna	jejuno+A+F+SG
jejunas	jejuno+A+F+PL
jejunazinha	jejuno+A+DIM+F+SG
jejunazinhas	jejuno+A+DIM+F+PL
jejuninha	jejuno+A+DIM+F+SG
jejuninhas	jejuno+A+DIM+F+PL
jejuninho	jejuno+A+DIM+M+SG
jejuninhos	jejuno+A+DIM+M+PL
jejuno	jejuno+A+M+SG
jejunos	jejuno+A+M+PL
jejunozinho	jejuno+A+DIM+M+SG
jejunozinhos	jejuno+A+DIM+M+PL
jejunostomicazinha	jejunostómico+A+DIM+F+SG
jejunostomicazinhas	jejunostómico+A+DIM+F+PL
jejunostomicozinho	jejunostómico+A+DIM+M+SG
jejunostomicozinhos	jejunostómico+A+DIM+M+PL
jejunostomiquinha	jejunostómico+A+DIM+F+SG
jejunostomiquinhas	jejunostómico+A+DIM+F+PL
jejunostomiquinho	jejunostómico+A+DIM+M+SG
jejunostomiquinhos	jejunostómico+A+DIM+M+PL
jejunostómica	jejunostómico+A+F+SG
jejunostómicas	jejunostómico+A+F+PL
jejunostómico	jejunostómico+A+M+SG
jejunostómicos	jejunostómico+A+M+PL
jejunostomicazinha	jejunostômico+A+DIM+F+SG
jejunostomicazinhas	jejunostômico+A+DIM+F+PL
jejunostomicozinho	jejunostômico+A+DIM+M+SG
jejunostomicozinhos	jejunostômico+A+DIM+M+PL
jejunostomiquinha	jejunostômico+A+DIM+F+SG
jejunostomiquinhas	jejunostômico+A+DIM+F+PL
jejunostomiquinho	jejunostômico+A+DIM+M+SG
jejunostomiquinhos	jejunostômico+A+DIM+M+PL
jejunostômica	jejunostômico+A+F+SG
jejunostômicas	jejunostômico+A+F+PL
jejunostômico	jejunostômico+A+M+SG
jejunostômicos	jejunostômico+A+M+PL
jejuaveizinhas	jejuável+A+DIM+F+PL
jejuaveizinhos	jejuável+A+DIM+M+PL
jejuavelzinha	jejuável+A+DIM+F+SG
jejuavelzinho	jejuável+A+DIM+M+SG
jejuáveis	jejuável+A+PL
jejuável	jejuável+A+SG
jequi	jequi+A+SG
jequis	jequi+A+PL
jequizinha	jequi+A+DIM+F+SG
jequizinhas	jequi+A+DIM+F+PL
jequizinho	jequi+A+DIM+M+SG
jequizinhos	jequi+A+DIM+M+PL
jequiricense	jequiricense+A+SG
jequiricenses	jequiricense+A+PL
jequiricensezinha	jequiricense+A+DIM+F+SG
jequiricensezinhas	jequiricense+A+DIM+F+PL
jequiricensezinho	jequiricense+A+DIM+M+SG
jequiricensezinhos	jequiricense+A+DIM+M+PL
jequiricensinha	jequiricense+A+DIM+F+SG
jequiricensinhas	jequiricense+A+DIM+F+PL
jequiricensinho	jequiricense+A+DIM+M+SG
jequiricensinhos	jequiricense+A+DIM+M+PL
jequiriçaense	jequiriçaense+A+SG
jequiriçaenses	jequiriçaense+A+PL
jequiriçaensezinha	jequiriçaense+A+DIM+F+SG
jequiriçaensezinhas	jequiriçaense+A+DIM+F+PL
jequiriçaensezinho	jequiriçaense+A+DIM+M+SG
jequiriçaensezinhos	jequiriçaense+A+DIM+M+PL
jequiriçaensinha	jequiriçaense+A+DIM+F+SG
jequiriçaensinhas	jequiriçaense+A+DIM+F+PL
jequiriçaensinho	jequiriçaense+A+DIM+M+SG
jequiriçaensinhos	jequiriçaense+A+DIM+M+PL
jeremias	jeremias+A
jeremiasinha	jeremias+A+DIM+F+SG
jeremiasinhas	jeremias+A+DIM+F+PL
jeremiasinho	jeremias+A+DIM+M+SG
jeremiasinhos	jeremias+A+DIM+M+PL
jeremiaveizinhas	jeremiável+A+DIM+F+PL
jeremiaveizinhos	jeremiável+A+DIM+M+PL
jeremiavelzinha	jeremiável+A+DIM+F+SG
jeremiavelzinho	jeremiável+A+DIM+M+SG
jeremiáveis	jeremiável+A+PL
jeremiável	jeremiável+A+SG
jericais	jerical+A+PL
jericaizinhas	jerical+A+DIM+F+PL
jericaizinhos	jerical+A+DIM+M+PL
jerical	jerical+A+SG
jericalzinha	jerical+A+DIM+F+SG
jericalzinho	jerical+A+DIM+M+SG
jeroglificazinha	jeroglífico+A+DIM+F+SG
jeroglificazinhas	jeroglífico+A+DIM+F+PL
jeroglificozinho	jeroglífico+A+DIM+M+SG
jeroglificozinhos	jeroglífico+A+DIM+M+PL
jeroglifiquinha	jeroglífico+A+DIM+F+SG
jeroglifiquinhas	jeroglífico+A+DIM+F+PL
jeroglifiquinho	jeroglífico+A+DIM+M+SG
jeroglifiquinhos	jeroglífico+A+DIM+M+PL
jeroglífica	jeroglífico+A+F+SG
jeroglíficas	jeroglífico+A+F+PL
jeroglífico	jeroglífico+A+M+SG
jeroglíficos	jeroglífico+A+M+PL
jeronimita	jeronimita+A+SG
jeronimitas	jeronimita+A+PL
jeronimitazinha	jeronimita+A+DIM+F+SG
jeronimitazinhas	jeronimita+A+DIM+F+PL
jeronimitazinho	jeronimita+A+DIM+M+SG
jeronimitazinhos	jeronimita+A+DIM+M+PL
jeronimitinha	jeronimita+A+DIM+SG
jeronimitinhas	jeronimita+A+DIM+PL
jerosolimitana	jerosolimitano+A+F+SG
jerosolimitanas	jerosolimitano+A+F+PL
jerosolimitanazinha	jerosolimitano+A+DIM+F+SG
jerosolimitanazinhas	jerosolimitano+A+DIM+F+PL
jerosolimitaninha	jerosolimitano+A+DIM+F+SG
jerosolimitaninhas	jerosolimitano+A+DIM+F+PL
jerosolimitaninho	jerosolimitano+A+DIM+M+SG
jerosolimitaninhos	jerosolimitano+A+DIM+M+PL
jerosolimitano	jerosolimitano+A+M+SG
jerosolimitanos	jerosolimitano+A+M+PL
jerosolimitanozinho	jerosolimitano+A+DIM+M+SG
jerosolimitanozinhos	jerosolimitano+A+DIM+M+PL
jerarquicazinha	jerárquico+A+DIM+F+SG
jerarquicazinhas	jerárquico+A+DIM+F+PL
jerarquicozinho	jerárquico+A+DIM+M+SG
jerarquicozinhos	jerárquico+A+DIM+M+PL
jerarquiquinha	jerárquico+A+DIM+F+SG
jerarquiquinhas	jerárquico+A+DIM+F+PL
jerarquiquinho	jerárquico+A+DIM+M+SG
jerarquiquinhos	jerárquico+A+DIM+M+PL
jerárquica	jerárquico+A+F+SG
jerárquicas	jerárquico+A+F+PL
jerárquico	jerárquico+A+M+SG
jerárquicos	jerárquico+A+M+PL
jeronimazinha	jerónimo+A+DIM+F+SG
jeronimazinhas	jerónimo+A+DIM+F+PL
jeroniminha	jerónimo+A+DIM+F+SG
jeroniminhas	jerónimo+A+DIM+F+PL
jeroniminho	jerónimo+A+DIM+M+SG
jeroniminhos	jerónimo+A+DIM+M+PL
jeronimozinho	jerónimo+A+DIM+M+SG
jeronimozinhos	jerónimo+A+DIM+M+PL
jerónima	jerónimo+A+F+SG
jerónimas	jerónimo+A+F+PL
jerónimo	jerónimo+A+M+SG
jerónimos	jerónimo+A+M+PL
jeronimazinha	jerônimo+A+DIM+F+SG
jeronimazinhas	jerônimo+A+DIM+F+PL
jeroniminha	jerônimo+A+DIM+F+SG
jeroniminhas	jerônimo+A+DIM+F+PL
jeroniminho	jerônimo+A+DIM+M+SG
jeroniminhos	jerônimo+A+DIM+M+PL
jeronimozinho	jerônimo+A+DIM+M+SG
jeronimozinhos	jerônimo+A+DIM+M+PL
jerônima	jerônimo+A+F+SG
jerônimas	jerônimo+A+F+PL
jerônimo	jerônimo+A+M+SG
jerônimos	jerônimo+A+M+PL
jesuitizaveizinhas	jesuitizável+A+DIM+F+PL
jesuitizaveizinhos	jesuitizável+A+DIM+M+PL
jesuitizavelzinha	jesuitizável+A+DIM+F+SG
jesuitizavelzinho	jesuitizável+A+DIM+M+SG
jesuitizáveis	jesuitizável+A+PL
jesuitizável	jesuitizável+A+SG
jesuiticazinha	jesuítico+A+DIM+F+SG
jesuiticazinhas	jesuítico+A+DIM+F+PL
jesuiticozinho	jesuítico+A+DIM+M+SG
jesuiticozinhos	jesuítico+A+DIM+M+PL
jesuitiquinha	jesuítico+A+DIM+F+SG
jesuitiquinhas	jesuítico+A+DIM+F+PL
jesuitiquinho	jesuítico+A+DIM+M+SG
jesuitiquinhos	jesuítico+A+DIM+M+PL
jesuítica	jesuítico+A+F+SG
jesuíticas	jesuítico+A+F+PL
jesuítico	jesuítico+A+M+SG
jesuíticos	jesuítico+A+M+PL
jiboiaveizinhas	jiboiável+A+DIM+F+PL
jiboiaveizinhos	jiboiável+A+DIM+M+PL
jiboiavelzinha	jiboiável+A+DIM+F+SG
jiboiavelzinho	jiboiável+A+DIM+M+SG
jiboiáveis	jiboiável+A+PL
jiboiável	jiboiável+A+SG
jinga	jinga+A+SG
jingas	jinga+A+PL
jingazinha	jinga+A+DIM+F+SG
jingazinhas	jinga+A+DIM+F+PL
jingazinho	jinga+A+DIM+M+SG
jingazinhos	jinga+A+DIM+M+PL
jinguinha	jinga+A+DIM+SG
jinguinhas	jinga+A+DIM+PL
jingoistazinha	jingoísta+A+DIM+F+SG
jingoistazinhas	jingoísta+A+DIM+F+PL
jingoistazinho	jingoísta+A+DIM+M+SG
jingoistazinhos	jingoísta+A+DIM+M+PL
jingoistinha	jingoísta+A+DIM+SG
jingoistinhas	jingoísta+A+DIM+PL
jingoísta	jingoísta+A+SG
jingoístas	jingoísta+A+PL
jiquiriçaense	jiquiriçaense+A+SG
jiquiriçaenses	jiquiriçaense+A+PL
jiquiriçaensezinha	jiquiriçaense+A+DIM+F+SG
jiquiriçaensezinhas	jiquiriçaense+A+DIM+F+PL
jiquiriçaensezinho	jiquiriçaense+A+DIM+M+SG
jiquiriçaensezinhos	jiquiriçaense+A+DIM+M+PL
jiquiriçaensinha	jiquiriçaense+A+DIM+F+SG
jiquiriçaensinhas	jiquiriçaense+A+DIM+F+PL
jiquiriçaensinho	jiquiriçaense+A+DIM+M+SG
jiquiriçaensinhos	jiquiriçaense+A+DIM+M+PL
joalheira	joalheiro+A+F+SG
joalheiras	joalheiro+A+F+PL
joalheirazinha	joalheiro+A+DIM+F+SG
joalheirazinhas	joalheiro+A+DIM+F+PL
joalheirazita	joalheiro+A+DIM+F+SG
joalheirazitas	joalheiro+A+DIM+F+PL
joalheirinha	joalheiro+A+DIM+F+SG
joalheirinhas	joalheiro+A+DIM+F+PL
joalheirinho	joalheiro+A+DIM+M+SG
joalheirinhos	joalheiro+A+DIM+M+PL
joalheiro	joalheiro+A+M+SG
joalheiros	joalheiro+A+M+PL
joalheirozinho	joalheiro+A+DIM+M+SG
joalheirozinhos	joalheiro+A+DIM+M+PL
joalheirozito	joalheiro+A+DIM+M+SG
joalheirozitos	joalheiro+A+DIM+M+PL
joanina	joanino+A+F+SG
joaninas	joanino+A+F+PL
joaninazinha	joanino+A+DIM+F+SG
joaninazinhas	joanino+A+DIM+F+PL
joanininha	joanino+A+DIM+F+SG
joanininhas	joanino+A+DIM+F+PL
joanininho	joanino+A+DIM+M+SG
joanininhos	joanino+A+DIM+M+PL
joanino	joanino+A+M+SG
joaninos	joanino+A+M+PL
joaninozinho	joanino+A+DIM+M+SG
joaninozinhos	joanino+A+DIM+M+PL
jocosa	jocoso+A+F+SG
jocosas	jocoso+A+F+PL
jocosazinha	jocoso+A+DIM+F+SG
jocosazinhas	jocoso+A+DIM+F+PL
jocosinha	jocoso+A+DIM+F+SG
jocosinhas	jocoso+A+DIM+F+PL
jocosinho	jocoso+A+DIM+M+SG
jocosinhos	jocoso+A+DIM+M+PL
jocoso	jocoso+A+M+SG
jocosos	jocoso+A+M+PL
jocosozinho	jocoso+A+DIM+M+SG
jocosozinhos	jocoso+A+DIM+M+PL
joeiraveizinhas	joeirável+A+DIM+F+PL
joeiraveizinhos	joeirável+A+DIM+M+PL
joeiravelzinha	joeirável+A+DIM+F+SG
joeiravelzinho	joeirável+A+DIM+M+SG
joeiráveis	joeirável+A+PL
joeirável	joeirável+A+SG
joelheira	joelheiro+A+F+SG
joelheiras	joelheiro+A+F+PL
joelheirazinha	joelheiro+A+DIM+F+SG
joelheirazinhas	joelheiro+A+DIM+F+PL
joelheirinha	joelheiro+A+DIM+F+SG
joelheirinhas	joelheiro+A+DIM+F+PL
joelheirinho	joelheiro+A+DIM+M+SG
joelheirinhos	joelheiro+A+DIM+M+PL
joelheiro	joelheiro+A+M+SG
joelheiros	joelheiro+A+M+PL
joelheirozinho	joelheiro+A+DIM+M+SG
joelheirozinhos	joelheiro+A+DIM+M+PL
joelhuda	joelhudo+A+F+SG
joelhudas	joelhudo+A+F+PL
joelhudazinha	joelhudo+A+DIM+F+SG
joelhudazinhas	joelhudo+A+DIM+F+PL
joelhudinha	joelhudo+A+DIM+F+SG
joelhudinhas	joelhudo+A+DIM+F+PL
joelhudinho	joelhudo+A+DIM+M+SG
joelhudinhos	joelhudo+A+DIM+M+PL
joelhudo	joelhudo+A+M+SG
joelhudos	joelhudo+A+M+PL
joelhudozinho	joelhudo+A+DIM+M+SG
joelhudozinhos	joelhudo+A+DIM+M+PL
joelhaveizinhas	joelhável+A+DIM+F+PL
joelhaveizinhos	joelhável+A+DIM+M+PL
joelhavelzinha	joelhável+A+DIM+F+SG
joelhavelzinho	joelhável+A+DIM+M+SG
joelháveis	joelhável+A+PL
joelhável	joelhável+A+SG
jogada	jogado+A+F+SG
jogadas	jogado+A+F+PL
jogadazinha	jogado+A+DIM+F+SG
jogadazinhas	jogado+A+DIM+F+PL
jogadinha	jogado+A+DIM+F+SG
jogadinhas	jogado+A+DIM+F+PL
jogadinho	jogado+A+DIM+M+SG
jogadinhos	jogado+A+DIM+M+PL
jogado	jogado+A+M+SG
jogados	jogado+A+M+PL
jogadozinho	jogado+A+DIM+M+SG
jogadozinhos	jogado+A+DIM+M+PL
jogador	jogador+A+M+SG
jogadora	jogador+A+F+SG
jogadoras	jogador+A+F+PL
jogadorazinha	jogador+A+DIM+F+SG
jogadorazinhas	jogador+A+DIM+F+PL
jogadores	jogador+A+M+PL
jogadorezinhos	jogador+A+DIM+M+PL
jogadorinha	jogador+A+DIM+F+SG
jogadorinhas	jogador+A+DIM+F+PL
jogadorzinho	jogador+A+DIM+M+SG
jogadorzinhos	jogador+A+DIM+M+PL
jogataveizinhas	jogatável+A+DIM+F+PL
jogataveizinhos	jogatável+A+DIM+M+PL
jogatavelzinha	jogatável+A+DIM+F+SG
jogatavelzinho	jogatável+A+DIM+M+SG
jogatáveis	jogatável+A+PL
jogatável	jogatável+A+SG
jogueteaveizinhas	jogueteável+A+DIM+F+PL
jogueteaveizinhos	jogueteável+A+DIM+M+PL
jogueteavelzinha	jogueteável+A+DIM+F+SG
jogueteavelzinho	jogueteável+A+DIM+M+SG
jogueteáveis	jogueteável+A+PL
jogueteável	jogueteável+A+SG
joguetaveizinhas	joguetável+A+DIM+F+PL
joguetaveizinhos	joguetável+A+DIM+M+PL
joguetavelzinha	joguetável+A+DIM+F+SG
joguetavelzinho	joguetável+A+DIM+M+SG
joguetáveis	joguetável+A+PL
joguetável	joguetável+A+SG
jogaveizinhas	jogável+A+DIM+F+PL
jogaveizinhos	jogável+A+DIM+M+PL
jogavelzinha	jogável+A+DIM+F+SG
jogavelzinho	jogável+A+DIM+M+SG
jogáveis	jogável+A+PL
jogável	jogável+A+SG
joia	joia+A+SG
joias	joia+A+PL
joiazinha	joia+A+DIM+F+SG
joiazinhas	joia+A+DIM+F+PL
joiazinho	joia+A+DIM+M+SG
joiazinhos	joia+A+DIM+M+PL
joinha	joia+A+DIM+SG
joinhas	joia+A+DIM+PL
joint	joint+A
jointzinha	joint+A+DIM+F+SG
jointzinhas	joint+A+DIM+F+PL
jointzinho	joint+A+DIM+M+SG
jointzinhos	joint+A+DIM+M+PL
joldeira	joldeiro+A+F+SG
joldeiras	joldeiro+A+F+PL
joldeirazinha	joldeiro+A+DIM+F+SG
joldeirazinhas	joldeiro+A+DIM+F+PL
joldeirinha	joldeiro+A+DIM+F+SG
joldeirinhas	joldeiro+A+DIM+F+PL
joldeirinho	joldeiro+A+DIM+M+SG
joldeirinhos	joldeiro+A+DIM+M+PL
joldeiro	joldeiro+A+M+SG
joldeiros	joldeiro+A+M+PL
joldeirozinho	joldeiro+A+DIM+M+SG
joldeirozinhos	joldeiro+A+DIM+M+PL
jongaveizinhas	jongável+A+DIM+F+PL
jongaveizinhos	jongável+A+DIM+M+PL
jongavelzinha	jongável+A+DIM+F+SG
jongavelzinho	jongável+A+DIM+M+SG
jongáveis	jongável+A+PL
jongável	jongável+A+SG
jordaniana	jordaniano+A+F+SG
jordanianas	jordaniano+A+F+PL
jordanianazinha	jordaniano+A+DIM+F+SG
jordanianazinhas	jordaniano+A+DIM+F+PL
jordanianinha	jordaniano+A+DIM+F+SG
jordanianinhas	jordaniano+A+DIM+F+PL
jordanianinho	jordaniano+A+DIM+M+SG
jordanianinhos	jordaniano+A+DIM+M+PL
jordaniano	jordaniano+A+M+SG
jordanianos	jordaniano+A+M+PL
jordanianozinho	jordaniano+A+DIM+M+SG
jordanianozinhos	jordaniano+A+DIM+M+PL
jordana	jordano+A+F+SG
jordanas	jordano+A+F+PL
jordanazinha	jordano+A+DIM+F+SG
jordanazinhas	jordano+A+DIM+F+PL
jordaninha	jordano+A+DIM+F+SG
jordaninhas	jordano+A+DIM+F+PL
jordaninho	jordano+A+DIM+M+SG
jordaninhos	jordano+A+DIM+M+PL
jordano	jordano+A+M+SG
jordanos	jordano+A+M+PL
jordanozinho	jordano+A+DIM+M+SG
jordanozinhos	jordano+A+DIM+M+PL
jordano-palestiniana	jordano-palestiniano+A+F+SG
jordano-palestinianas	jordano-palestiniano+A+F+PL
jordano-palestinianazinha	jordano-palestiniano+A+DIM+F+SG
jordano-palestinianazinhas	jordano-palestiniano+A+DIM+F+PL
jordano-palestinianinha	jordano-palestiniano+A+DIM+F+SG
jordano-palestinianinhas	jordano-palestiniano+A+DIM+F+PL
jordano-palestinianinho	jordano-palestiniano+A+DIM+M+SG
jordano-palestinianinhos	jordano-palestiniano+A+DIM+M+PL
jordano-palestiniano	jordano-palestiniano+A+M+SG
jordano-palestinianos	jordano-palestiniano+A+M+PL
jordano-palestinianozinho	jordano-palestiniano+A+DIM+M+SG
jordano-palestinianozinhos	jordano-palestiniano+A+DIM+M+PL
jornadeaveizinhas	jornadeável+A+DIM+F+PL
jornadeaveizinhos	jornadeável+A+DIM+M+PL
jornadeavelzinha	jornadeável+A+DIM+F+SG
jornadeavelzinho	jornadeável+A+DIM+M+SG
jornadeáveis	jornadeável+A+PL
jornadeável	jornadeável+A+SG
jornaleira	jornaleiro+A+F+SG
jornaleiras	jornaleiro+A+F+PL
jornaleirazinha	jornaleiro+A+DIM+F+SG
jornaleirazinhas	jornaleiro+A+DIM+F+PL
jornaleirinha	jornaleiro+A+DIM+F+SG
jornaleirinhas	jornaleiro+A+DIM+F+PL
jornaleirinho	jornaleiro+A+DIM+M+SG
jornaleirinhos	jornaleiro+A+DIM+M+PL
jornaleiro	jornaleiro+A+M+SG
jornaleiros	jornaleiro+A+M+PL
jornaleirozinho	jornaleiro+A+DIM+M+SG
jornaleirozinhos	jornaleiro+A+DIM+M+PL
jornalizaveizinhas	jornalizável+A+DIM+F+PL
jornalizaveizinhos	jornalizável+A+DIM+M+PL
jornalizavelzinha	jornalizável+A+DIM+F+SG
jornalizavelzinho	jornalizável+A+DIM+M+SG
jornalizáveis	jornalizável+A+PL
jornalizável	jornalizável+A+SG
jornalisticazinha	jornalístico+A+DIM+F+SG
jornalisticazinhas	jornalístico+A+DIM+F+PL
jornalisticozinho	jornalístico+A+DIM+M+SG
jornalisticozinhos	jornalístico+A+DIM+M+PL
jornalistiquinha	jornalístico+A+DIM+F+SG
jornalistiquinhas	jornalístico+A+DIM+F+PL
jornalistiquinho	jornalístico+A+DIM+M+SG
jornalistiquinhos	jornalístico+A+DIM+M+PL
jornalística	jornalístico+A+F+SG
jornalísticas	jornalístico+A+F+PL
jornalístico	jornalístico+A+M+SG
jornalísticos	jornalístico+A+M+PL
jorraveizinhas	jorrável+A+DIM+F+PL
jorraveizinhos	jorrável+A+DIM+M+PL
jorravelzinha	jorrável+A+DIM+F+SG
jorravelzinho	jorrável+A+DIM+M+SG
jorráveis	jorrável+A+PL
jorrável	jorrável+A+SG
josefina	josefino+A+F+SG
josefinas	josefino+A+F+PL
josefinazinha	josefino+A+DIM+F+SG
josefinazinhas	josefino+A+DIM+F+PL
josefininha	josefino+A+DIM+F+SG
josefininhas	josefino+A+DIM+F+PL
josefininho	josefino+A+DIM+M+SG
josefininhos	josefino+A+DIM+M+PL
josefino	josefino+A+M+SG
josefinos	josefino+A+M+PL
josefinozinho	josefino+A+DIM+M+SG
josefinozinhos	josefino+A+DIM+M+PL
jovem	jovem+A+SG
jovens	jovem+A+PL
jovenzinha	jovem+A+DIM+F+SG
jovenzinhas	jovem+A+DIM+F+PL
jovenzinho	jovem+A+DIM+M+SG
jovenzinhos	jovem+A+DIM+M+PL
jovenzita	jovem+A+DIM+F+SG
jovenzitas	jovem+A+DIM+F+PL
jovenzito	jovem+A+DIM+M+SG
jovenzitos	jovem+A+DIM+M+PL
juveníssima	jovem+A+SUPER+F+SG
juveníssimas	jovem+A+SUPER+F+PL
juveníssimo	jovem+A+SUPER+M+SG
juveníssimos	jovem+A+SUPER+M+PL
joviais	jovial+A+PL
joviaizinhas	jovial+A+DIM+F+PL
joviaizinhos	jovial+A+DIM+M+PL
jovial	jovial+A+SG
jovialzinha	jovial+A+DIM+F+SG
jovialzinho	jovial+A+DIM+M+SG
jovializaveizinhas	jovializável+A+DIM+F+PL
jovializaveizinhos	jovializável+A+DIM+M+PL
jovializavelzinha	jovializável+A+DIM+F+SG
jovializavelzinho	jovializável+A+DIM+M+SG
jovializáveis	jovializável+A+PL
jovializável	jovializável+A+SG
jubada	jubado+A+F+SG
jubadas	jubado+A+F+PL
jubadazinha	jubado+A+DIM+F+SG
jubadazinhas	jubado+A+DIM+F+PL
jubadinha	jubado+A+DIM+F+SG
jubadinhas	jubado+A+DIM+F+PL
jubadinho	jubado+A+DIM+M+SG
jubadinhos	jubado+A+DIM+M+PL
jubado	jubado+A+M+SG
jubados	jubado+A+M+PL
jubadozinho	jubado+A+DIM+M+SG
jubadozinhos	jubado+A+DIM+M+PL
jubilada	jubilado+A+F+SG
jubiladas	jubilado+A+F+PL
jubiladazinha	jubilado+A+DIM+F+SG
jubiladazinhas	jubilado+A+DIM+F+PL
jubiladinha	jubilado+A+DIM+F+SG
jubiladinhas	jubilado+A+DIM+F+PL
jubiladinho	jubilado+A+DIM+M+SG
jubiladinhos	jubilado+A+DIM+M+PL
jubilado	jubilado+A+M+SG
jubilados	jubilado+A+M+PL
jubiladozinho	jubilado+A+DIM+M+SG
jubiladozinhos	jubilado+A+DIM+M+PL
jubilar	jubilar+A+SG
jubilares	jubilar+A+PL
jubilarezinhas	jubilar+A+DIM+F+PL
jubilarezinhos	jubilar+A+DIM+M+PL
jubilarzinha	jubilar+A+DIM+F+SG
jubilarzinhas	jubilar+A+DIM+F+PL
jubilarzinho	jubilar+A+DIM+M+SG
jubilarzinhos	jubilar+A+DIM+M+PL
jubilatoriazinha	jubilatório+A+DIM+F+SG
jubilatoriazinhas	jubilatório+A+DIM+F+PL
jubilatorinha	jubilatório+A+DIM+F+SG
jubilatorinhas	jubilatório+A+DIM+F+PL
jubilatorinho	jubilatório+A+DIM+M+SG
jubilatorinhos	jubilatório+A+DIM+M+PL
jubilatoriozinho	jubilatório+A+DIM+M+SG
jubilatoriozinhos	jubilatório+A+DIM+M+PL
jubilatória	jubilatório+A+F+SG
jubilatórias	jubilatório+A+F+PL
jubilatório	jubilatório+A+M+SG
jubilatórios	jubilatório+A+M+PL
jubilosa	jubiloso+A+F+SG
jubilosas	jubiloso+A+F+PL
jubilosazinha	jubiloso+A+DIM+F+SG
jubilosazinhas	jubiloso+A+DIM+F+PL
jubilosinha	jubiloso+A+DIM+F+SG
jubilosinhas	jubiloso+A+DIM+F+PL
jubilosinho	jubiloso+A+DIM+M+SG
jubilosinhos	jubiloso+A+DIM+M+PL
jubiloso	jubiloso+A+M+SG
jubilosos	jubiloso+A+M+PL
jubilosozinho	jubiloso+A+DIM+M+SG
jubilosozinhos	jubiloso+A+DIM+M+PL
jubilaveizinhas	jubilável+A+DIM+F+PL
jubilaveizinhos	jubilável+A+DIM+M+PL
jubilavelzinha	jubilável+A+DIM+F+SG
jubilavelzinho	jubilável+A+DIM+M+SG
jubiláveis	jubilável+A+PL
jubilável	jubilável+A+SG
jucunda	jucundo+A+F+SG
jucundas	jucundo+A+F+PL
jucundazinha	jucundo+A+DIM+F+SG
jucundazinhas	jucundo+A+DIM+F+PL
jucundinha	jucundo+A+DIM+F+SG
jucundinhas	jucundo+A+DIM+F+PL
jucundinho	jucundo+A+DIM+M+SG
jucundinhos	jucundo+A+DIM+M+PL
jucundo	jucundo+A+M+SG
jucundos	jucundo+A+M+PL
jucundozinho	jucundo+A+DIM+M+SG
jucundozinhos	jucundo+A+DIM+M+PL
jucazinha	jucá+A+DIM+F+SG
jucazinhas	jucá+A+DIM+F+PL
jucazinho	jucá+A+DIM+M+SG
jucazinhos	jucá+A+DIM+M+PL
jucá	jucá+A+SG
jucás	jucá+A+PL
judaica	judaico+A+F+SG
judaicas	judaico+A+F+PL
judaicazinha	judaico+A+DIM+F+SG
judaicazinhas	judaico+A+DIM+F+PL
judaico	judaico+A+M+SG
judaicos	judaico+A+M+PL
judaicozinho	judaico+A+DIM+M+SG
judaicozinhos	judaico+A+DIM+M+PL
judaiquinha	judaico+A+DIM+F+SG
judaiquinhas	judaico+A+DIM+F+PL
judaiquinho	judaico+A+DIM+M+SG
judaiquinhos	judaico+A+DIM+M+PL
judaico-cristã	judaico-cristão+A+F+SG
judaico-cristão	judaico-cristão+A+M+SG
judaico-cristãos	judaico-cristão+A+M+PL
judaico-cristãozinho	judaico-cristão+A+DIM+M+SG
judaico-cristãozinhos	judaico-cristão+A+DIM+M+PL
judaico-cristãs	judaico-cristão+A+F+PL
judaico-cristãzinha	judaico-cristão+A+DIM+F+SG
judaico-cristãzinhas	judaico-cristão+A+DIM+F+PL
judaizante	judaizante+A+SG
judaizantes	judaizante+A+PL
judaizantezinha	judaizante+A+DIM+F+SG
judaizantezinhas	judaizante+A+DIM+F+PL
judaizantezinho	judaizante+A+DIM+M+SG
judaizantezinhos	judaizante+A+DIM+M+PL
judaizantinha	judaizante+A+DIM+F+SG
judaizantinhas	judaizante+A+DIM+F+PL
judaizantinho	judaizante+A+DIM+M+SG
judaizantinhos	judaizante+A+DIM+M+PL
judaizaveizinhas	judaizável+A+DIM+F+PL
judaizaveizinhos	judaizável+A+DIM+M+PL
judaizavelzinha	judaizável+A+DIM+F+SG
judaizavelzinho	judaizável+A+DIM+M+SG
judaizáveis	judaizável+A+PL
judaizável	judaizável+A+SG
judeu	judeu+A+M+SG
judeus	judeu+A+M+PL
judeuzinho	judeu+A+DIM+M+SG
judeuzinhos	judeu+A+DIM+M+PL
judia	judeu+A+F+SG
judias	judeu+A+F+PL
judiazinha	judeu+A+DIM+F+SG
judiazinhas	judeu+A+DIM+F+PL
judinha	judeu+A+DIM+F+SG
judinhas	judeu+A+DIM+F+PL
judeu-cristã	judeu-cristão+A+F+SG
judeu-cristão	judeu-cristão+A+M+SG
judeu-cristãos	judeu-cristão+A+M+PL
judeu-cristãozinho	judeu-cristão+A+DIM+M+SG
judeu-cristãozinhos	judeu-cristão+A+DIM+M+PL
judeu-cristãs	judeu-cristão+A+F+PL
judeu-cristãzinha	judeu-cristão+A+DIM+F+SG
judeu-cristãzinhas	judeu-cristão+A+DIM+F+PL
judicante	judicante+A+SG
judicantes	judicante+A+PL
judicantezinha	judicante+A+DIM+F+SG
judicantezinhas	judicante+A+DIM+F+PL
judicantezinho	judicante+A+DIM+M+SG
judicantezinhos	judicante+A+DIM+M+PL
judicantinha	judicante+A+DIM+F+SG
judicantinhas	judicante+A+DIM+F+PL
judicantinho	judicante+A+DIM+M+SG
judicantinhos	judicante+A+DIM+M+PL
judicativa	judicativo+A+F+SG
judicativas	judicativo+A+F+PL
judicativazinha	judicativo+A+DIM+F+SG
judicativazinhas	judicativo+A+DIM+F+PL
judicativinha	judicativo+A+DIM+F+SG
judicativinhas	judicativo+A+DIM+F+PL
judicativinho	judicativo+A+DIM+M+SG
judicativinhos	judicativo+A+DIM+M+PL
judicativo	judicativo+A+M+SG
judicativos	judicativo+A+M+PL
judicativozinho	judicativo+A+DIM+M+SG
judicativozinhos	judicativo+A+DIM+M+PL
judicatoriazinha	judicatório+A+DIM+F+SG
judicatoriazinhas	judicatório+A+DIM+F+PL
judicatorinha	judicatório+A+DIM+F+SG
judicatorinhas	judicatório+A+DIM+F+PL
judicatorinho	judicatório+A+DIM+M+SG
judicatorinhos	judicatório+A+DIM+M+PL
judicatoriozinho	judicatório+A+DIM+M+SG
judicatoriozinhos	judicatório+A+DIM+M+PL
judicatória	judicatório+A+F+SG
judicatórias	judicatório+A+F+PL
judicatório	judicatório+A+M+SG
judicatórios	judicatório+A+M+PL
judiciais	judicial+A+PL
judiciaizinhas	judicial+A+DIM+F+PL
judiciaizinhos	judicial+A+DIM+M+PL
judicial	judicial+A+SG
judicialzinha	judicial+A+DIM+F+SG
judicialzinho	judicial+A+DIM+M+SG
judiciosa	judicioso+A+F+SG
judiciosas	judicioso+A+F+PL
judiciosazinha	judicioso+A+DIM+F+SG
judiciosazinhas	judicioso+A+DIM+F+PL
judiciosinha	judicioso+A+DIM+F+SG
judiciosinhas	judicioso+A+DIM+F+PL
judiciosinho	judicioso+A+DIM+M+SG
judiciosinhos	judicioso+A+DIM+M+PL
judicioso	judicioso+A+M+SG
judiciosos	judicioso+A+M+PL
judiciosozinho	judicioso+A+DIM+M+SG
judiciosozinhos	judicioso+A+DIM+M+PL
judiciariazinha	judiciário+A+DIM+F+SG
judiciariazinhas	judiciário+A+DIM+F+PL
judiciarinha	judiciário+A+DIM+F+SG
judiciarinhas	judiciário+A+DIM+F+PL
judiciarinho	judiciário+A+DIM+M+SG
judiciarinhos	judiciário+A+DIM+M+PL
judiciariozinho	judiciário+A+DIM+M+SG
judiciariozinhos	judiciário+A+DIM+M+PL
judiciária	judiciário+A+F+SG
judiciárias	judiciário+A+F+PL
judiciário	judiciário+A+M+SG
judiciários	judiciário+A+M+PL
judiciaveizinhas	judiciável+A+DIM+F+PL
judiciaveizinhos	judiciável+A+DIM+M+PL
judiciavelzinha	judiciável+A+DIM+F+SG
judiciavelzinho	judiciável+A+DIM+M+SG
judiciáveis	judiciável+A+PL
judiciável	judiciável+A+SG
judia	judio+A+F+SG
judias	judio+A+F+PL
judiazinha	judio+A+DIM+F+SG
judiazinhas	judio+A+DIM+F+PL
judinha	judio+A+DIM+F+SG
judinhas	judio+A+DIM+F+PL
judinho	judio+A+DIM+M+SG
judinhos	judio+A+DIM+M+PL
judio	judio+A+M+SG
judios	judio+A+M+PL
judiozinho	judio+A+DIM+M+SG
judiozinhos	judio+A+DIM+M+PL
judiaveizinhas	judiável+A+DIM+F+PL
judiaveizinhos	judiável+A+DIM+M+PL
judiavelzinha	judiável+A+DIM+F+SG
judiavelzinho	judiável+A+DIM+M+SG
judiáveis	judiável+A+PL
judiável	judiável+A+SG
jugadeira	jugadeiro+A+F+SG
jugadeiras	jugadeiro+A+F+PL
jugadeirazinha	jugadeiro+A+DIM+F+SG
jugadeirazinhas	jugadeiro+A+DIM+F+PL
jugadeirinha	jugadeiro+A+DIM+F+SG
jugadeirinhas	jugadeiro+A+DIM+F+PL
jugadeirinho	jugadeiro+A+DIM+M+SG
jugadeirinhos	jugadeiro+A+DIM+M+PL
jugadeiro	jugadeiro+A+M+SG
jugadeiros	jugadeiro+A+M+PL
jugadeirozinho	jugadeiro+A+DIM+M+SG
jugadeirozinhos	jugadeiro+A+DIM+M+PL
jugadaveizinhas	jugadável+A+DIM+F+PL
jugadaveizinhos	jugadável+A+DIM+M+PL
jugadavelzinha	jugadável+A+DIM+F+SG
jugadavelzinho	jugadável+A+DIM+M+SG
jugadáveis	jugadável+A+PL
jugadável	jugadável+A+SG
jugais	jugal+A+PL
jugaizinhas	jugal+A+DIM+F+PL
jugaizinhos	jugal+A+DIM+M+PL
jugal	jugal+A+SG
jugalzinha	jugal+A+DIM+F+SG
jugalzinho	jugal+A+DIM+M+SG
juglandaceazinha	juglandáceo+A+DIM+F+SG
juglandaceazinhas	juglandáceo+A+DIM+F+PL
juglandaceinha	juglandáceo+A+DIM+F+SG
juglandaceinhas	juglandáceo+A+DIM+F+PL
juglandaceinho	juglandáceo+A+DIM+M+SG
juglandaceinhos	juglandáceo+A+DIM+M+PL
juglandaceozinho	juglandáceo+A+DIM+M+SG
juglandaceozinhos	juglandáceo+A+DIM+M+PL
juglandácea	juglandáceo+A+F+SG
juglandáceas	juglandáceo+A+F+PL
juglandáceo	juglandáceo+A+M+SG
juglandáceos	juglandáceo+A+M+PL
jugoslava	jugoslavo+A+F+SG
jugoslavas	jugoslavo+A+F+PL
jugoslavazinha	jugoslavo+A+DIM+F+SG
jugoslavazinhas	jugoslavo+A+DIM+F+PL
jugoslavinha	jugoslavo+A+DIM+F+SG
jugoslavinhas	jugoslavo+A+DIM+F+PL
jugoslavinho	jugoslavo+A+DIM+M+SG
jugoslavinhos	jugoslavo+A+DIM+M+PL
jugoslavo	jugoslavo+A+M+SG
jugoslavos	jugoslavo+A+M+PL
jugoslavozinho	jugoslavo+A+DIM+M+SG
jugoslavozinhos	jugoslavo+A+DIM+M+PL
jugueira	jugueiro+A+F+SG
jugueiras	jugueiro+A+F+PL
jugueirazinha	jugueiro+A+DIM+F+SG
jugueirazinhas	jugueiro+A+DIM+F+PL
jugueirinha	jugueiro+A+DIM+F+SG
jugueirinhas	jugueiro+A+DIM+F+PL
jugueirinho	jugueiro+A+DIM+M+SG
jugueirinhos	jugueiro+A+DIM+M+PL
jugueiro	jugueiro+A+M+SG
jugueiros	jugueiro+A+M+PL
jugueirozinho	jugueiro+A+DIM+M+SG
jugueirozinhos	jugueiro+A+DIM+M+PL
jugulante	jugulante+A+SG
jugulantes	jugulante+A+PL
jugulantezinha	jugulante+A+DIM+F+SG
jugulantezinhas	jugulante+A+DIM+F+PL
jugulantezinho	jugulante+A+DIM+M+SG
jugulantezinhos	jugulante+A+DIM+M+PL
jugulantinha	jugulante+A+DIM+F+SG
jugulantinhas	jugulante+A+DIM+F+PL
jugulantinho	jugulante+A+DIM+M+SG
jugulantinhos	jugulante+A+DIM+M+PL
jugular	jugular+A+SG
jugulares	jugular+A+PL
jugularezinhas	jugular+A+DIM+F+PL
jugularezinhos	jugular+A+DIM+M+PL
jugularzinha	jugular+A+DIM+F+SG
jugularzinhas	jugular+A+DIM+F+PL
jugularzinho	jugular+A+DIM+M+SG
jugularzinhos	jugular+A+DIM+M+PL
jugulaveizinhas	jugulável+A+DIM+F+PL
jugulaveizinhos	jugulável+A+DIM+M+PL
jugulavelzinha	jugulável+A+DIM+F+SG
jugulavelzinho	jugulável+A+DIM+M+SG
juguláveis	jugulável+A+PL
jugulável	jugulável+A+SG
jugaveizinhas	jugável+A+DIM+F+PL
jugaveizinhos	jugável+A+DIM+M+PL
jugavelzinha	jugável+A+DIM+F+SG
jugavelzinho	jugável+A+DIM+M+SG
jugáveis	jugável+A+PL
jugável	jugável+A+SG
juiz-foraninho	juiz-forano+A+DIM+M+SG
juiz-foraninhos	juiz-forano+A+DIM+M+PL
juiz-forano	juiz-forano+A+M+SG
juiz-foranos	juiz-forano+A+M+PL
juiz-foranozinho	juiz-forano+A+DIM+M+SG
juiz-foranozinhos	juiz-forano+A+DIM+M+PL
julgada	julgado+A+F+SG
julgadas	julgado+A+F+PL
julgadazinha	julgado+A+DIM+F+SG
julgadazinhas	julgado+A+DIM+F+PL
julgadinha	julgado+A+DIM+F+SG
julgadinhas	julgado+A+DIM+F+PL
julgadinho	julgado+A+DIM+M+SG
julgadinhos	julgado+A+DIM+M+PL
julgado	julgado+A+M+SG
julgados	julgado+A+M+PL
julgadozinho	julgado+A+DIM+M+SG
julgadozinhos	julgado+A+DIM+M+PL
julgador	julgador+A+M+SG
julgadora	julgador+A+F+SG
julgadoras	julgador+A+F+PL
julgadorazinha	julgador+A+DIM+F+SG
julgadorazinhas	julgador+A+DIM+F+PL
julgadores	julgador+A+M+PL
julgadorezinhos	julgador+A+DIM+M+PL
julgadorinha	julgador+A+DIM+F+SG
julgadorinhas	julgador+A+DIM+F+PL
julgadorzinho	julgador+A+DIM+M+SG
julgadorzinhos	julgador+A+DIM+M+PL
julgaveizinhas	julgável+A+DIM+F+PL
julgaveizinhos	julgável+A+DIM+M+PL
julgavelzinha	julgável+A+DIM+F+SG
julgavelzinho	julgável+A+DIM+M+SG
julgáveis	julgável+A+PL
julgável	julgável+A+SG
juliana	juliano+A+F+SG
julianas	juliano+A+F+PL
julianazinha	juliano+A+DIM+F+SG
julianazinhas	juliano+A+DIM+F+PL
julianinha	juliano+A+DIM+F+SG
julianinhas	juliano+A+DIM+F+PL
julianinho	juliano+A+DIM+M+SG
julianinhos	juliano+A+DIM+M+PL
juliano	juliano+A+M+SG
julianos	juliano+A+M+PL
julianozinho	juliano+A+DIM+M+SG
julianozinhos	juliano+A+DIM+M+PL
julianaceazinha	julianáceo+A+DIM+F+SG
julianaceazinhas	julianáceo+A+DIM+F+PL
julianaceinha	julianáceo+A+DIM+F+SG
julianaceinhas	julianáceo+A+DIM+F+PL
julianaceinho	julianáceo+A+DIM+M+SG
julianaceinhos	julianáceo+A+DIM+M+PL
julianaceozinho	julianáceo+A+DIM+M+SG
julianaceozinhos	julianáceo+A+DIM+M+PL
julianácea	julianáceo+A+F+SG
julianáceas	julianáceo+A+F+PL
julianáceo	julianáceo+A+M+SG
julianáceos	julianáceo+A+M+PL
juma	juma+A+SG
jumas	juma+A+PL
jumazinha	juma+A+DIM+F+SG
jumazinhas	juma+A+DIM+F+PL
jumazinho	juma+A+DIM+M+SG
jumazinhos	juma+A+DIM+M+PL
juminha	juma+A+DIM+SG
juminhas	juma+A+DIM+PL
jumentais	jumental+A+PL
jumentaizinhas	jumental+A+DIM+F+PL
jumentaizinhos	jumental+A+DIM+M+PL
jumental	jumental+A+SG
jumentalzinha	jumental+A+DIM+F+SG
jumentalzinho	jumental+A+DIM+M+SG
jumentil	jumentil+A+SG
jumentilzinha	jumentil+A+DIM+F+SG
jumentilzinho	jumentil+A+DIM+M+SG
jumentis	jumentil+A+PL
jumentizinhas	jumentil+A+DIM+F+PL
jumentizinhos	jumentil+A+DIM+M+PL
jumenta	jumento+A+F+SG
jumentas	jumento+A+F+PL
jumentazinha	jumento+A+DIM+F+SG
jumentazinhas	jumento+A+DIM+F+PL
jumentinha	jumento+A+DIM+F+SG
jumentinhas	jumento+A+DIM+F+PL
jumentinho	jumento+A+DIM+M+SG
jumentinhos	jumento+A+DIM+M+PL
jumento	jumento+A+M+SG
jumentos	jumento+A+M+PL
jumentozinho	jumento+A+DIM+M+SG
jumentozinhos	jumento+A+DIM+M+PL
juncada	juncada+A+F+SG
juncadas	juncada+A+F+PL
juncadazinha	juncada+A+DIM+F+SG
juncadazinhas	juncada+A+DIM+F+PL
juncadinha	juncada+A+DIM+F+SG
juncadinhas	juncada+A+DIM+F+PL
juncada	juncado+A+F+SG
juncadas	juncado+A+F+PL
juncadazinha	juncado+A+DIM+F+SG
juncadazinhas	juncado+A+DIM+F+PL
juncadinha	juncado+A+DIM+F+SG
juncadinhas	juncado+A+DIM+F+PL
juncadinho	juncado+A+DIM+M+SG
juncadinhos	juncado+A+DIM+M+PL
juncado	juncado+A+M+SG
juncados	juncado+A+M+PL
juncadozinho	juncado+A+DIM+M+SG
juncadozinhos	juncado+A+DIM+M+PL
juncosa	juncoso+A+F+SG
juncosas	juncoso+A+F+PL
juncosazinha	juncoso+A+DIM+F+SG
juncosazinhas	juncoso+A+DIM+F+PL
juncosinha	juncoso+A+DIM+F+SG
juncosinhas	juncoso+A+DIM+F+PL
juncosinho	juncoso+A+DIM+M+SG
juncosinhos	juncoso+A+DIM+M+PL
juncoso	juncoso+A+M+SG
juncosos	juncoso+A+M+PL
juncosozinho	juncoso+A+DIM+M+SG
juncosozinhos	juncoso+A+DIM+M+PL
juncaceazinha	juncácea+A+DIM+F+SG
juncaceazinhas	juncácea+A+DIM+F+PL
juncaceinha	juncácea+A+DIM+F+SG
juncaceinhas	juncácea+A+DIM+F+PL
juncácea	juncácea+A+F+SG
juncáceas	juncácea+A+F+PL
juncaceazinha	juncáceo+A+DIM+F+SG
juncaceazinhas	juncáceo+A+DIM+F+PL
juncaceinha	juncáceo+A+DIM+F+SG
juncaceinhas	juncáceo+A+DIM+F+PL
juncaceinho	juncáceo+A+DIM+M+SG
juncaceinhos	juncáceo+A+DIM+M+PL
juncaceozinho	juncáceo+A+DIM+M+SG
juncaceozinhos	juncáceo+A+DIM+M+PL
juncácea	juncáceo+A+F+SG
juncáceas	juncáceo+A+F+PL
juncáceo	juncáceo+A+M+SG
juncáceos	juncáceo+A+M+PL
juncaveizinhas	juncável+A+DIM+F+PL
juncaveizinhos	juncável+A+DIM+M+PL
juncavelzinha	juncável+A+DIM+F+SG
juncavelzinho	juncável+A+DIM+M+SG
juncáveis	juncável+A+PL
juncável	juncável+A+SG
jungida	jungido+A+F+SG
jungidas	jungido+A+F+PL
jungidazinha	jungido+A+DIM+F+SG
jungidazinhas	jungido+A+DIM+F+PL
jungidinha	jungido+A+DIM+F+SG
jungidinhas	jungido+A+DIM+F+PL
jungidinho	jungido+A+DIM+M+SG
jungidinhos	jungido+A+DIM+M+PL
jungido	jungido+A+M+SG
jungidos	jungido+A+M+PL
jungidozinho	jungido+A+DIM+M+SG
jungidozinhos	jungido+A+DIM+M+PL
junina	junino+A+F+SG
juninas	junino+A+F+PL
juninazinha	junino+A+DIM+F+SG
juninazinhas	junino+A+DIM+F+PL
junininha	junino+A+DIM+F+SG
junininhas	junino+A+DIM+F+PL
junininho	junino+A+DIM+M+SG
junininhos	junino+A+DIM+M+PL
junino	junino+A+M+SG
juninos	junino+A+M+PL
juninozinho	junino+A+DIM+M+SG
juninozinhos	junino+A+DIM+M+PL
juniperaceazinha	juniperáceo+A+DIM+F+SG
juniperaceazinhas	juniperáceo+A+DIM+F+PL
juniperaceinha	juniperáceo+A+DIM+F+SG
juniperaceinhas	juniperáceo+A+DIM+F+PL
juniperaceinho	juniperáceo+A+DIM+M+SG
juniperaceinhos	juniperáceo+A+DIM+M+PL
juniperaceozinho	juniperáceo+A+DIM+M+SG
juniperaceozinhos	juniperáceo+A+DIM+M+PL
juniperácea	juniperáceo+A+F+SG
juniperáceas	juniperáceo+A+F+PL
juniperáceo	juniperáceo+A+M+SG
juniperáceos	juniperáceo+A+M+PL
juntada	juntada+A+F+SG
juntadas	juntada+A+F+PL
juntadazinha	juntada+A+DIM+F+SG
juntadazinhas	juntada+A+DIM+F+PL
juntadinha	juntada+A+DIM+F+SG
juntadinhas	juntada+A+DIM+F+PL
juntada	juntado+A+F+SG
juntadas	juntado+A+F+PL
juntadazinha	juntado+A+DIM+F+SG
juntadazinhas	juntado+A+DIM+F+PL
juntadinha	juntado+A+DIM+F+SG
juntadinhas	juntado+A+DIM+F+PL
juntadinho	juntado+A+DIM+M+SG
juntadinhos	juntado+A+DIM+M+PL
juntado	juntado+A+M+SG
juntados	juntado+A+M+PL
juntadozinho	juntado+A+DIM+M+SG
juntadozinhos	juntado+A+DIM+M+PL
juntador	juntador+A+M+SG
juntadora	juntador+A+F+SG
juntadoras	juntador+A+F+PL
juntadorazinha	juntador+A+DIM+F+SG
juntadorazinhas	juntador+A+DIM+F+PL
juntadores	juntador+A+M+PL
juntadorezinhos	juntador+A+DIM+M+PL
juntadorinha	juntador+A+DIM+F+SG
juntadorinhas	juntador+A+DIM+F+PL
juntadorzinho	juntador+A+DIM+M+SG
juntadorzinhos	juntador+A+DIM+M+PL
junta	junto+A+F+SG
juntas	junto+A+F+PL
juntazinha	junto+A+DIM+F+SG
juntazinhas	junto+A+DIM+F+PL
juntinha	junto+A+DIM+F+SG
juntinhas	junto+A+DIM+F+PL
juntinho	junto+A+DIM+M+SG
juntinhos	junto+A+DIM+M+PL
juntita	junto+A+DIM+F+SG
juntitas	junto+A+DIM+F+PL
juntito	junto+A+DIM+M+SG
juntitos	junto+A+DIM+M+PL
junto	junto+A+M+SG
juntos	junto+A+M+PL
juntozinho	junto+A+DIM+M+SG
juntozinhos	junto+A+DIM+M+PL
juntíssima	junto+A+SUPER+F+SG
juntíssimas	junto+A+SUPER+F+PL
juntíssimo	junto+A+SUPER+M+SG
juntíssimos	junto+A+SUPER+M+PL
juntaveizinhas	juntável+A+DIM+F+PL
juntaveizinhos	juntável+A+DIM+M+PL
juntavelzinha	juntável+A+DIM+F+SG
juntavelzinho	juntável+A+DIM+M+SG
juntáveis	juntável+A+PL
juntável	juntável+A+SG
juncinha	junça+A+DIM+F+SG
juncinhas	junça+A+DIM+F+PL
junça	junça+A+F+SG
junças	junça+A+F+PL
junçazinha	junça+A+DIM+F+SG
junçazinhas	junça+A+DIM+F+PL
junçosa	junçoso+A+F+SG
junçosas	junçoso+A+F+PL
junçosazinha	junçoso+A+DIM+F+SG
junçosazinhas	junçoso+A+DIM+F+PL
junçosinha	junçoso+A+DIM+F+SG
junçosinhas	junçoso+A+DIM+F+PL
junçosinho	junçoso+A+DIM+M+SG
junçosinhos	junçoso+A+DIM+M+PL
junçoso	junçoso+A+M+SG
junçosos	junçoso+A+M+PL
junçosozinho	junçoso+A+DIM+M+SG
junçosozinhos	junçoso+A+DIM+M+PL
junoniazinha	junónio+A+DIM+F+SG
junoniazinhas	junónio+A+DIM+F+PL
junoninha	junónio+A+DIM+F+SG
junoninhas	junónio+A+DIM+F+PL
junoninho	junónio+A+DIM+M+SG
junoninhos	junónio+A+DIM+M+PL
junoniozinho	junónio+A+DIM+M+SG
junoniozinhos	junónio+A+DIM+M+PL
junónia	junónio+A+F+SG
junónias	junónio+A+F+PL
junónio	junónio+A+M+SG
junónios	junónio+A+M+PL
junoniazinha	junônio+A+DIM+F+SG
junoniazinhas	junônio+A+DIM+F+PL
junoninha	junônio+A+DIM+F+SG
junoninhas	junônio+A+DIM+F+PL
junoninho	junônio+A+DIM+M+SG
junoninhos	junônio+A+DIM+M+PL
junoniozinho	junônio+A+DIM+M+SG
junoniozinhos	junônio+A+DIM+M+PL
junônia	junônio+A+F+SG
junônias	junônio+A+F+PL
junônio	junônio+A+M+SG
junônios	junônio+A+M+PL
jupiteriana	jupiteriano+A+F+SG
jupiterianas	jupiteriano+A+F+PL
jupiterianazinha	jupiteriano+A+DIM+F+SG
jupiterianazinhas	jupiteriano+A+DIM+F+PL
jupiterianinha	jupiteriano+A+DIM+F+SG
jupiterianinhas	jupiteriano+A+DIM+F+PL
jupiterianinho	jupiteriano+A+DIM+M+SG
jupiterianinhos	jupiteriano+A+DIM+M+PL
jupiteriano	jupiteriano+A+M+SG
jupiterianos	jupiteriano+A+M+PL
jupiterianozinho	jupiteriano+A+DIM+M+SG
jupiterianozinhos	jupiteriano+A+DIM+M+PL
jupteriana	jupteriano+A+F+SG
jupterianas	jupteriano+A+F+PL
jupterianazinha	jupteriano+A+DIM+F+SG
jupterianazinhas	jupteriano+A+DIM+F+PL
jupterianinha	jupteriano+A+DIM+F+SG
jupterianinhas	jupteriano+A+DIM+F+PL
jupterianinho	jupteriano+A+DIM+M+SG
jupterianinhos	jupteriano+A+DIM+M+PL
jupteriano	jupteriano+A+M+SG
jupterianos	jupteriano+A+M+PL
jupterianozinho	jupteriano+A+DIM+M+SG
jupterianozinhos	jupteriano+A+DIM+M+PL
jurada	jurado+A+F+SG
juradas	jurado+A+F+PL
juradazinha	jurado+A+DIM+F+SG
juradazinhas	jurado+A+DIM+F+PL
juradinha	jurado+A+DIM+F+SG
juradinhas	jurado+A+DIM+F+PL
juradinho	jurado+A+DIM+M+SG
juradinhos	jurado+A+DIM+M+PL
jurado	jurado+A+M+SG
jurados	jurado+A+M+PL
juradozinho	jurado+A+DIM+M+SG
juradozinhos	jurado+A+DIM+M+PL
jurador	jurador+A+M+SG
juradora	jurador+A+F+SG
juradoras	jurador+A+F+PL
juradorazinha	jurador+A+DIM+F+SG
juradorazinhas	jurador+A+DIM+F+PL
juradores	jurador+A+M+PL
juradorezinhos	jurador+A+DIM+M+PL
juradorinha	jurador+A+DIM+F+SG
juradorinhas	jurador+A+DIM+F+PL
juradorzinho	jurador+A+DIM+M+SG
juradorzinhos	jurador+A+DIM+M+PL
juramentaveizinhas	juramentável+A+DIM+F+PL
juramentaveizinhos	juramentável+A+DIM+M+PL
juramentavelzinha	juramentável+A+DIM+F+SG
juramentavelzinho	juramentável+A+DIM+M+SG
juramentáveis	juramentável+A+PL
juramentável	juramentável+A+SG
juratoriazinha	juratório+A+DIM+F+SG
juratoriazinhas	juratório+A+DIM+F+PL
juratorinha	juratório+A+DIM+F+SG
juratorinhas	juratório+A+DIM+F+PL
juratorinho	juratório+A+DIM+M+SG
juratorinhos	juratório+A+DIM+M+PL
juratoriozinho	juratório+A+DIM+M+SG
juratoriozinhos	juratório+A+DIM+M+PL
juratória	juratório+A+F+SG
juratórias	juratório+A+F+PL
juratório	juratório+A+M+SG
juratórios	juratório+A+M+PL
jurisdicionais	jurisdicional+A+PL
jurisdicionaizinhas	jurisdicional+A+DIM+F+PL
jurisdicionaizinhos	jurisdicional+A+DIM+M+PL
jurisdicional	jurisdicional+A+SG
jurisdicionalzinha	jurisdicional+A+DIM+F+SG
jurisdicionalzinho	jurisdicional+A+DIM+M+SG
jurisdicionaveizinhas	jurisdicionável+A+DIM+F+PL
jurisdicionaveizinhos	jurisdicionável+A+DIM+M+PL
jurisdicionavelzinha	jurisdicionável+A+DIM+F+SG
jurisdicionavelzinho	jurisdicionável+A+DIM+M+SG
jurisdicionáveis	jurisdicionável+A+PL
jurisdicionável	jurisdicionável+A+SG
jurisperita	jurisperito+A+F+SG
jurisperitas	jurisperito+A+F+PL
jurisperitazinha	jurisperito+A+DIM+F+SG
jurisperitazinhas	jurisperito+A+DIM+F+PL
jurisperitinha	jurisperito+A+DIM+F+SG
jurisperitinhas	jurisperito+A+DIM+F+PL
jurisperitinho	jurisperito+A+DIM+M+SG
jurisperitinhos	jurisperito+A+DIM+M+PL
jurisperito	jurisperito+A+M+SG
jurisperitos	jurisperito+A+M+PL
jurisperitozinho	jurisperito+A+DIM+M+SG
jurisperitozinhos	jurisperito+A+DIM+M+PL
jurisprudenciais	jurisprudencial+A+PL
jurisprudenciaizinhas	jurisprudencial+A+DIM+F+PL
jurisprudenciaizinhos	jurisprudencial+A+DIM+M+PL
jurisprudencial	jurisprudencial+A+SG
jurisprudencialzinha	jurisprudencial+A+DIM+F+SG
jurisprudencialzinho	jurisprudencial+A+DIM+M+SG
jurraveizinhas	jurrável+A+DIM+F+PL
jurraveizinhos	jurrável+A+DIM+M+PL
jurravelzinha	jurrável+A+DIM+F+SG
jurravelzinho	jurrável+A+DIM+M+SG
jurráveis	jurrável+A+PL
jurrável	jurrável+A+SG
jururu	jururu+A+SG
jururus	jururu+A+PL
jururuzinha	jururu+A+DIM+F+SG
jururuzinhas	jururu+A+DIM+F+PL
jururuzinho	jururu+A+DIM+M+SG
jururuzinhos	jururu+A+DIM+M+PL
jurassicazinha	jurássico+A+DIM+F+SG
jurassicazinhas	jurássico+A+DIM+F+PL
jurassicozinho	jurássico+A+DIM+M+SG
jurassicozinhos	jurássico+A+DIM+M+PL
jurassiquinha	jurássico+A+DIM+F+SG
jurassiquinhas	jurássico+A+DIM+F+PL
jurassiquinho	jurássico+A+DIM+M+SG
jurassiquinhos	jurássico+A+DIM+M+PL
jurássica	jurássico+A+F+SG
jurássicas	jurássico+A+F+PL
jurássico	jurássico+A+M+SG
jurássicos	jurássico+A+M+PL
juraveizinhas	jurável+A+DIM+F+PL
juraveizinhos	jurável+A+DIM+M+PL
juravelzinha	jurável+A+DIM+F+SG
juravelzinho	jurável+A+DIM+M+SG
juráveis	jurável+A+PL
jurável	jurável+A+SG
juridicazinha	jurídico+A+DIM+F+SG
juridicazinhas	jurídico+A+DIM+F+PL
juridicozinho	jurídico+A+DIM+M+SG
juridicozinhos	jurídico+A+DIM+M+PL
juridiquinha	jurídico+A+DIM+F+SG
juridiquinhas	jurídico+A+DIM+F+PL
juridiquinho	jurídico+A+DIM+M+SG
juridiquinhos	jurídico+A+DIM+M+PL
jurídica	jurídico+A+F+SG
jurídicas	jurídico+A+F+PL
jurídico	jurídico+A+M+SG
jurídicos	jurídico+A+M+PL
jurídico-administrativa	jurídico-administrativo+A+F+SG
jurídico-administrativas	jurídico-administrativo+A+F+PL
jurídico-administrativazinha	jurídico-administrativo+A+DIM+F+SG
jurídico-administrativazinhas	jurídico-administrativo+A+DIM+F+PL
jurídico-administrativinha	jurídico-administrativo+A+DIM+F+SG
jurídico-administrativinhas	jurídico-administrativo+A+DIM+F+PL
jurídico-administrativinho	jurídico-administrativo+A+DIM+M+SG
jurídico-administrativinhos	jurídico-administrativo+A+DIM+M+PL
jurídico-administrativo	jurídico-administrativo+A+M+SG
jurídico-administrativos	jurídico-administrativo+A+M+PL
jurídico-administrativozinho	jurídico-administrativo+A+DIM+M+SG
jurídico-administrativozinhos	jurídico-administrativo+A+DIM+M+PL
jurídico-constitucionais	jurídico-constitucional+A+PL
jurídico-constitucionaizinhas	jurídico-constitucional+A+DIM+F+PL
jurídico-constitucionaizinhos	jurídico-constitucional+A+DIM+M+PL
jurídico-constitucional	jurídico-constitucional+A+SG
jurídico-constitucionalzinha	jurídico-constitucional+A+DIM+F+SG
jurídico-constitucionalzinho	jurídico-constitucional+A+DIM+M+SG
jurídico-institucionais	jurídico-institucional+A+PL
jurídico-institucionaizinhas	jurídico-institucional+A+DIM+F+PL
jurídico-institucionaizinhos	jurídico-institucional+A+DIM+M+PL
jurídico-institucional	jurídico-institucional+A+SG
jurídico-institucionalzinha	jurídico-institucional+A+DIM+F+SG
jurídico-institucionalzinho	jurídico-institucional+A+DIM+M+SG
jurídico-laborais	jurídico-laboral+A+PL
jurídico-laboraizinhas	jurídico-laboral+A+DIM+F+PL
jurídico-laboraizinhos	jurídico-laboral+A+DIM+M+PL
jurídico-laboral	jurídico-laboral+A+SG
jurídico-laboralzinha	jurídico-laboral+A+DIM+F+SG
jurídico-laboralzinho	jurídico-laboral+A+DIM+M+SG
jurídico-legais	jurídico-legal+A+PL
jurídico-legaizinhas	jurídico-legal+A+DIM+F+PL
jurídico-legaizinhos	jurídico-legal+A+DIM+M+PL
jurídico-legal	jurídico-legal+A+SG
jurídico-legalzinha	jurídico-legal+A+DIM+F+SG
jurídico-legalzinho	jurídico-legal+A+DIM+M+SG
jurídico-penais	jurídico-penal+A+PL
jurídico-penaizinhas	jurídico-penal+A+DIM+F+PL
jurídico-penaizinhos	jurídico-penal+A+DIM+M+PL
jurídico-penal	jurídico-penal+A+SG
jurídico-penalzinha	jurídico-penal+A+DIM+F+SG
jurídico-penalzinho	jurídico-penal+A+DIM+M+SG
jurídico-politicazinha	jurídico-político+A+DIM+F+SG
jurídico-politicazinhas	jurídico-político+A+DIM+F+PL
jurídico-politicozinho	jurídico-político+A+DIM+M+SG
jurídico-politicozinhos	jurídico-político+A+DIM+M+PL
jurídico-politiquinha	jurídico-político+A+DIM+F+SG
jurídico-politiquinhas	jurídico-político+A+DIM+F+PL
jurídico-politiquinho	jurídico-político+A+DIM+M+SG
jurídico-politiquinhos	jurídico-político+A+DIM+M+PL
jurídico-política	jurídico-político+A+F+SG
jurídico-políticas	jurídico-político+A+F+PL
jurídico-político	jurídico-político+A+M+SG
jurídico-políticos	jurídico-político+A+M+PL
jurigenazinha	jurígeno+A+DIM+F+SG
jurigenazinhas	jurígeno+A+DIM+F+PL
jurigeninha	jurígeno+A+DIM+F+SG
jurigeninhas	jurígeno+A+DIM+F+PL
jurigeninho	jurígeno+A+DIM+M+SG
jurigeninhos	jurígeno+A+DIM+M+PL
jurigenozinho	jurígeno+A+DIM+M+SG
jurigenozinhos	jurígeno+A+DIM+M+PL
jurígena	jurígeno+A+F+SG
jurígenas	jurígeno+A+F+PL
jurígeno	jurígeno+A+M+SG
jurígenos	jurígeno+A+M+PL
juscelinista	juscelinista+A+SG
juscelinistas	juscelinista+A+PL
juscelinistazinha	juscelinista+A+DIM+F+SG
juscelinistazinhas	juscelinista+A+DIM+F+PL
juscelinistazinho	juscelinista+A+DIM+M+SG
juscelinistazinhos	juscelinista+A+DIM+M+PL
juscelinistinha	juscelinista+A+DIM+SG
juscelinistinhas	juscelinista+A+DIM+PL
jussiva	jussivo+A+F+SG
jussivas	jussivo+A+F+PL
jussivazinha	jussivo+A+DIM+F+SG
jussivazinhas	jussivo+A+DIM+F+PL
jussivinha	jussivo+A+DIM+F+SG
jussivinhas	jussivo+A+DIM+F+PL
jussivinho	jussivo+A+DIM+M+SG
jussivinhos	jussivo+A+DIM+M+PL
jussivo	jussivo+A+M+SG
jussivos	jussivo+A+M+PL
jussivozinho	jussivo+A+DIM+M+SG
jussivozinhos	jussivo+A+DIM+M+PL
justador	justador+A+M+SG
justadora	justador+A+F+SG
justadoras	justador+A+F+PL
justadorazinha	justador+A+DIM+F+SG
justadorazinhas	justador+A+DIM+F+PL
justadores	justador+A+M+PL
justadorezinhos	justador+A+DIM+M+PL
justadorinha	justador+A+DIM+F+SG
justadorinhas	justador+A+DIM+F+PL
justadorzinho	justador+A+DIM+M+SG
justadorzinhos	justador+A+DIM+M+PL
justafluviais	justafluvial+A+PL
justafluviaizinhas	justafluvial+A+DIM+F+PL
justafluviaizinhos	justafluvial+A+DIM+M+PL
justafluvial	justafluvial+A+SG
justafluvialzinha	justafluvial+A+DIM+F+SG
justafluvialzinho	justafluvial+A+DIM+M+SG
justalienar	justalienar+A+SG
justalienares	justalienar+A+PL
justalienarezinhas	justalienar+A+DIM+F+PL
justalienarezinhos	justalienar+A+DIM+M+PL
justalienarzinha	justalienar+A+DIM+F+SG
justalienarzinhas	justalienar+A+DIM+F+PL
justalienarzinho	justalienar+A+DIM+M+SG
justalienarzinhos	justalienar+A+DIM+M+PL
justaponiveizinhas	justaponível+A+DIM+F+PL
justaponiveizinhos	justaponível+A+DIM+M+PL
justaponivelzinha	justaponível+A+DIM+F+SG
justaponivelzinho	justaponível+A+DIM+M+SG
justaponíveis	justaponível+A+PL
justaponível	justaponível+A+SG
justaposta	justaposto+A+F+SG
justapostas	justaposto+A+F+PL
justapostazinha	justaposto+A+DIM+F+SG
justapostazinhas	justaposto+A+DIM+F+PL
justapostinha	justaposto+A+DIM+F+SG
justapostinhas	justaposto+A+DIM+F+PL
justapostinho	justaposto+A+DIM+M+SG
justapostinhos	justaposto+A+DIM+M+PL
justaposto	justaposto+A+M+SG
justapostos	justaposto+A+M+PL
justapostozinho	justaposto+A+DIM+M+SG
justapostozinhos	justaposto+A+DIM+M+PL
justavertebrais	justavertebral+A+PL
justavertebraizinhas	justavertebral+A+DIM+F+PL
justavertebraizinhos	justavertebral+A+DIM+M+PL
justavertebral	justavertebral+A+SG
justavertebralzinha	justavertebral+A+DIM+F+SG
justavertebralzinho	justavertebral+A+DIM+M+SG
justiceira	justiceiro+A+F+SG
justiceiras	justiceiro+A+F+PL
justiceirazinha	justiceiro+A+DIM+F+SG
justiceirazinhas	justiceiro+A+DIM+F+PL
justiceirinha	justiceiro+A+DIM+F+SG
justiceirinhas	justiceiro+A+DIM+F+PL
justiceirinho	justiceiro+A+DIM+M+SG
justiceirinhos	justiceiro+A+DIM+M+PL
justiceiro	justiceiro+A+M+SG
justiceiros	justiceiro+A+M+PL
justiceirozinho	justiceiro+A+DIM+M+SG
justiceirozinhos	justiceiro+A+DIM+M+PL
justicialista	justicialista+A+SG
justicialistas	justicialista+A+PL
justicialistazinha	justicialista+A+DIM+F+SG
justicialistazinhas	justicialista+A+DIM+F+PL
justicialistazinho	justicialista+A+DIM+M+SG
justicialistazinhos	justicialista+A+DIM+M+PL
justicialistinha	justicialista+A+DIM+SG
justicialistinhas	justicialista+A+DIM+PL
justificada	justificado+A+F+SG
justificadas	justificado+A+F+PL
justificadazinha	justificado+A+DIM+F+SG
justificadazinhas	justificado+A+DIM+F+PL
justificadinha	justificado+A+DIM+F+SG
justificadinhas	justificado+A+DIM+F+PL
justificadinho	justificado+A+DIM+M+SG
justificadinhos	justificado+A+DIM+M+PL
justificado	justificado+A+M+SG
justificados	justificado+A+M+PL
justificadozinho	justificado+A+DIM+M+SG
justificadozinhos	justificado+A+DIM+M+PL
justificadíssima	justificado+A+SUPER+F+SG
justificadíssimas	justificado+A+SUPER+F+PL
justificadíssimo	justificado+A+SUPER+M+SG
justificadíssimos	justificado+A+SUPER+M+PL
justificador	justificador+A+M+SG
justificadora	justificador+A+F+SG
justificadoras	justificador+A+F+PL
justificadorazinha	justificador+A+DIM+F+SG
justificadorazinhas	justificador+A+DIM+F+PL
justificadores	justificador+A+M+PL
justificadorezinhos	justificador+A+DIM+M+PL
justificadorinha	justificador+A+DIM+F+SG
justificadorinhas	justificador+A+DIM+F+PL
justificadorzinho	justificador+A+DIM+M+SG
justificadorzinhos	justificador+A+DIM+M+PL
justificante	justificante+A+SG
justificantes	justificante+A+PL
justificantezinha	justificante+A+DIM+F+SG
justificantezinhas	justificante+A+DIM+F+PL
justificantezinho	justificante+A+DIM+M+SG
justificantezinhos	justificante+A+DIM+M+PL
justificantinha	justificante+A+DIM+F+SG
justificantinhas	justificante+A+DIM+F+PL
justificantinho	justificante+A+DIM+M+SG
justificantinhos	justificante+A+DIM+M+PL
justificativa	justificativo+A+F+SG
justificativas	justificativo+A+F+PL
justificativazinha	justificativo+A+DIM+F+SG
justificativazinhas	justificativo+A+DIM+F+PL
justificativinha	justificativo+A+DIM+F+SG
justificativinhas	justificativo+A+DIM+F+PL
justificativinho	justificativo+A+DIM+M+SG
justificativinhos	justificativo+A+DIM+M+PL
justificativo	justificativo+A+M+SG
justificativos	justificativo+A+M+PL
justificativozinho	justificativo+A+DIM+M+SG
justificativozinhos	justificativo+A+DIM+M+PL
justificatoriazinha	justificatório+A+DIM+F+SG
justificatoriazinhas	justificatório+A+DIM+F+PL
justificatorinha	justificatório+A+DIM+F+SG
justificatorinhas	justificatório+A+DIM+F+PL
justificatorinho	justificatório+A+DIM+M+SG
justificatorinhos	justificatório+A+DIM+M+PL
justificatoriozinho	justificatório+A+DIM+M+SG
justificatoriozinhos	justificatório+A+DIM+M+PL
justificatória	justificatório+A+F+SG
justificatórias	justificatório+A+F+PL
justificatório	justificatório+A+M+SG
justificatórios	justificatório+A+M+PL
justificaveizinhas	justificável+A+DIM+F+PL
justificaveizinhos	justificável+A+DIM+M+PL
justificavelzinha	justificável+A+DIM+F+SG
justificavelzinho	justificável+A+DIM+M+SG
justificáveis	justificável+A+PL
justificável	justificável+A+SG
justinianeia	justinianeu+A+F+SG
justinianeias	justinianeu+A+F+PL
justinianeiazinha	justinianeu+A+DIM+F+SG
justinianeiazinhas	justinianeu+A+DIM+F+PL
justinianeinha	justinianeu+A+DIM+F+SG
justinianeinhas	justinianeu+A+DIM+F+PL
justinianeu	justinianeu+A+M+SG
justinianeus	justinianeu+A+M+PL
justinianeuzinho	justinianeu+A+DIM+M+SG
justinianeuzinhos	justinianeu+A+DIM+M+PL
justiçada	justiçado+A+F+SG
justiçadas	justiçado+A+F+PL
justiçadazinha	justiçado+A+DIM+F+SG
justiçadazinhas	justiçado+A+DIM+F+PL
justiçadinha	justiçado+A+DIM+F+SG
justiçadinhas	justiçado+A+DIM+F+PL
justiçadinho	justiçado+A+DIM+M+SG
justiçadinhos	justiçado+A+DIM+M+PL
justiçado	justiçado+A+M+SG
justiçados	justiçado+A+M+PL
justiçadozinho	justiçado+A+DIM+M+SG
justiçadozinhos	justiçado+A+DIM+M+PL
justiçador	justiçador+A+M+SG
justiçadora	justiçador+A+F+SG
justiçadoras	justiçador+A+F+PL
justiçadorazinha	justiçador+A+DIM+F+SG
justiçadorazinhas	justiçador+A+DIM+F+PL
justiçadores	justiçador+A+M+PL
justiçadorezinhos	justiçador+A+DIM+M+PL
justiçadorinha	justiçador+A+DIM+F+SG
justiçadorinhas	justiçador+A+DIM+F+PL
justiçadorzinho	justiçador+A+DIM+M+SG
justiçadorzinhos	justiçador+A+DIM+M+PL
justiçosa	justiçoso+A+F+SG
justiçosas	justiçoso+A+F+PL
justiçosazinha	justiçoso+A+DIM+F+SG
justiçosazinhas	justiçoso+A+DIM+F+PL
justiçosinha	justiçoso+A+DIM+F+SG
justiçosinhas	justiçoso+A+DIM+F+PL
justiçosinho	justiçoso+A+DIM+M+SG
justiçosinhos	justiçoso+A+DIM+M+PL
justiçoso	justiçoso+A+M+SG
justiçosos	justiçoso+A+M+PL
justiçosozinho	justiçoso+A+DIM+M+SG
justiçosozinhos	justiçoso+A+DIM+M+PL
justiçaveizinhas	justiçável+A+DIM+F+PL
justiçaveizinhos	justiçável+A+DIM+M+PL
justiçavelzinha	justiçável+A+DIM+F+SG
justiçavelzinho	justiçável+A+DIM+M+SG
justiçáveis	justiçável+A+PL
justiçável	justiçável+A+SG
justa	justo+A+F+SG
justas	justo+A+F+PL
justazinha	justo+A+DIM+F+SG
justazinhas	justo+A+DIM+F+PL
justazita	justo+A+DIM+F+SG
justazitas	justo+A+DIM+F+PL
justinha	justo+A+DIM+F+SG
justinhas	justo+A+DIM+F+PL
justinho	justo+A+DIM+M+SG
justinhos	justo+A+DIM+M+PL
justita	justo+A+DIM+F+SG
justitas	justo+A+DIM+F+PL
justito	justo+A+DIM+M+SG
justitos	justo+A+DIM+M+PL
justo	justo+A+M+SG
justos	justo+A+M+PL
justozinho	justo+A+DIM+M+SG
justozinhos	justo+A+DIM+M+PL
justozito	justo+A+DIM+M+SG
justozitos	justo+A+DIM+M+PL
justíssima	justo+A+SUPER+F+SG
justíssimas	justo+A+SUPER+F+PL
justíssimo	justo+A+SUPER+M+SG
justíssimos	justo+A+SUPER+M+PL
justaveizinhas	justável+A+DIM+F+PL
justaveizinhos	justável+A+DIM+M+PL
justavelzinha	justável+A+DIM+F+SG
justavelzinho	justável+A+DIM+M+SG
justáveis	justável+A+PL
justável	justável+A+SG
jutlandesa	jutlandês+A+F+SG
jutlandesas	jutlandês+A+F+PL
jutlandesazinha	jutlandês+A+DIM+F+SG
jutlandesazinhas	jutlandês+A+DIM+F+PL
jutlandeses	jutlandês+A+M+PL
jutlandesezinhos	jutlandês+A+DIM+M+PL
jutlandesinha	jutlandês+A+DIM+F+SG
jutlandesinhas	jutlandês+A+DIM+F+PL
jutlandesinho	jutlandês+A+DIM+M+SG
jutlandesinhos	jutlandês+A+DIM+M+PL
jutlandês	jutlandês+A+M+SG
jutinho	juto+A+DIM+M+SG
jutinhos	juto+A+DIM+M+PL
juto	juto+A+M+SG
jutos	juto+A+M+PL
jutozinho	juto+A+DIM+M+SG
jutozinhos	juto+A+DIM+M+PL
juvenalesca	juvenalesco+A+F+SG
juvenalescas	juvenalesco+A+F+PL
juvenalescazinha	juvenalesco+A+DIM+F+SG
juvenalescazinhas	juvenalesco+A+DIM+F+PL
juvenalesco	juvenalesco+A+M+SG
juvenalescos	juvenalesco+A+M+PL
juvenalescozinho	juvenalesco+A+DIM+M+SG
juvenalescozinhos	juvenalesco+A+DIM+M+PL
juvenalesquinha	juvenalesco+A+DIM+F+SG
juvenalesquinhas	juvenalesco+A+DIM+F+PL
juvenalesquinho	juvenalesco+A+DIM+M+SG
juvenalesquinhos	juvenalesco+A+DIM+M+PL
juvenil	juvenil+A+SG
juvenilzinha	juvenil+A+DIM+F+SG
juvenilzinho	juvenil+A+DIM+M+SG
juvenis	juvenil+A+PL
juvenizinhas	juvenil+A+DIM+F+PL
juvenizinhos	juvenil+A+DIM+M+PL
jaspeazinha	jáspeo+A+DIM+F+SG
jaspeazinhas	jáspeo+A+DIM+F+PL
jaspeinha	jáspeo+A+DIM+F+SG
jaspeinhas	jáspeo+A+DIM+F+PL
jaspeinho	jáspeo+A+DIM+M+SG
jaspeinhos	jáspeo+A+DIM+M+PL
jaspeozinho	jáspeo+A+DIM+M+SG
jaspeozinhos	jáspeo+A+DIM+M+PL
jáspea	jáspeo+A+F+SG
jáspeas	jáspeo+A+F+PL
jáspeo	jáspeo+A+M+SG
jáspeos	jáspeo+A+M+PL
jambicazinha	jâmbico+A+DIM+F+SG
jambicazinhas	jâmbico+A+DIM+F+PL
jambicozinho	jâmbico+A+DIM+M+SG
jambicozinhos	jâmbico+A+DIM+M+PL
jambiquinha	jâmbico+A+DIM+F+SG
jambiquinhas	jâmbico+A+DIM+F+PL
jambiquinho	jâmbico+A+DIM+M+SG
jambiquinhos	jâmbico+A+DIM+M+PL
jâmbica	jâmbico+A+F+SG
jâmbicas	jâmbico+A+F+PL
jâmbico	jâmbico+A+M+SG
jâmbicos	jâmbico+A+M+PL
joiazinha	jóia+A+DIM+F+SG
joiazinhas	jóia+A+DIM+F+PL
joiazinho	jóia+A+DIM+M+SG
joiazinhos	jóia+A+DIM+M+PL
joinha	jóia+A+DIM+SG
joinhas	jóia+A+DIM+PL
jóia	jóia+A+SG
jóias	jóia+A+PL
jonicazinha	jónico+A+DIM+F+SG
jonicazinhas	jónico+A+DIM+F+PL
jonicozinho	jónico+A+DIM+M+SG
jonicozinhos	jónico+A+DIM+M+PL
joniquinha	jónico+A+DIM+F+SG
joniquinhas	jónico+A+DIM+F+PL
joniquinho	jónico+A+DIM+M+SG
joniquinhos	jónico+A+DIM+M+PL
jónica	jónico+A+F+SG
jónicas	jónico+A+F+PL
jónico	jónico+A+M+SG
jónicos	jónico+A+M+PL
jónico-aticazinha	jónico-ático+A+DIM+F+SG
jónico-aticazinhas	jónico-ático+A+DIM+F+PL
jónico-aticozinho	jónico-ático+A+DIM+M+SG
jónico-aticozinhos	jónico-ático+A+DIM+M+PL
jónico-atiquinha	jónico-ático+A+DIM+F+SG
jónico-atiquinhas	jónico-ático+A+DIM+F+PL
jónico-atiquinho	jónico-ático+A+DIM+M+SG
jónico-atiquinhos	jónico-ático+A+DIM+M+PL
jónico-ática	jónico-ático+A+F+SG
jónico-áticas	jónico-ático+A+F+PL
jónico-ático	jónico-ático+A+M+SG
jónico-áticos	jónico-ático+A+M+PL
joniazinha	jónio+A+DIM+F+SG
joniazinhas	jónio+A+DIM+F+PL
joninha	jónio+A+DIM+F+SG
joninhas	jónio+A+DIM+F+PL
joninho	jónio+A+DIM+M+SG
joninhos	jónio+A+DIM+M+PL
joniozinho	jónio+A+DIM+M+SG
joniozinhos	jónio+A+DIM+M+PL
jónia	jónio+A+F+SG
jónias	jónio+A+F+PL
jónio	jónio+A+M+SG
jónios	jónio+A+M+PL
jonicazinha	jônico+A+DIM+F+SG
jonicazinhas	jônico+A+DIM+F+PL
jonicozinho	jônico+A+DIM+M+SG
jonicozinhos	jônico+A+DIM+M+PL
joniquinha	jônico+A+DIM+F+SG
joniquinhas	jônico+A+DIM+F+PL
joniquinho	jônico+A+DIM+M+SG
joniquinhos	jônico+A+DIM+M+PL
jônica	jônico+A+F+SG
jônicas	jônico+A+F+PL
jônico	jônico+A+M+SG
jônicos	jônico+A+M+PL
jônico-aticazinha	jônico-ático+A+DIM+F+SG
jônico-aticazinhas	jônico-ático+A+DIM+F+PL
jônico-aticozinho	jônico-ático+A+DIM+M+SG
jônico-aticozinhos	jônico-ático+A+DIM+M+PL
jônico-atiquinha	jônico-ático+A+DIM+F+SG
jônico-atiquinhas	jônico-ático+A+DIM+F+PL
jônico-atiquinho	jônico-ático+A+DIM+M+SG
jônico-atiquinhos	jônico-ático+A+DIM+M+PL
jônico-ática	jônico-ático+A+F+SG
jônico-áticas	jônico-ático+A+F+PL
jônico-ático	jônico-ático+A+M+SG
jônico-áticos	jônico-ático+A+M+PL
joniazinha	jônio+A+DIM+F+SG
joniazinhas	jônio+A+DIM+F+PL
joninha	jônio+A+DIM+F+SG
joninhas	jônio+A+DIM+F+PL
joninho	jônio+A+DIM+M+SG
joninhos	jônio+A+DIM+M+PL
joniozinho	jônio+A+DIM+M+SG
joniozinhos	jônio+A+DIM+M+PL
jônia	jônio+A+F+SG
jônias	jônio+A+F+PL
jônio	jônio+A+M+SG
jônios	jônio+A+M+PL
juniores	júnior+A+M+PL
juniorezinhas	júnior+A+DIM+F+PL
juniorezinhos	júnior+A+DIM+M+PL
juniorzinha	júnior+A+DIM+F+SG
juniorzinhas	júnior+A+DIM+F+PL
juniorzinho	júnior+A+DIM+M+SG
juniorzinhos	júnior+A+DIM+M+PL
júnior	júnior+A+SG
júniores	júnior+A+PL
