kafkiana	kafkiano+A+F+SG
kafkianas	kafkiano+A+F+PL
kafkianazinha	kafkiano+A+DIM+F+SG
kafkianazinhas	kafkiano+A+DIM+F+PL
kafkianinha	kafkiano+A+DIM+F+SG
kafkianinhas	kafkiano+A+DIM+F+PL
kafkianinho	kafkiano+A+DIM+M+SG
kafkianinhos	kafkiano+A+DIM+M+PL
kafkiano	kafkiano+A+M+SG
kafkianos	kafkiano+A+M+PL
kafkianozinho	kafkiano+A+DIM+M+SG
kafkianozinhos	kafkiano+A+DIM+M+PL
kantiana	kantiano+A+F+SG
kantianas	kantiano+A+F+PL
kantianazinha	kantiano+A+DIM+F+SG
kantianazinhas	kantiano+A+DIM+F+PL
kantianinha	kantiano+A+DIM+F+SG
kantianinhas	kantiano+A+DIM+F+PL
kantianinho	kantiano+A+DIM+M+SG
kantianinhos	kantiano+A+DIM+M+PL
kantiano	kantiano+A+M+SG
kantianos	kantiano+A+M+PL
kantianozinho	kantiano+A+DIM+M+SG
kantianozinhos	kantiano+A+DIM+M+PL
kepleriana	kepleriano+A+F+SG
keplerianas	kepleriano+A+F+PL
keplerianazinha	kepleriano+A+DIM+F+SG
keplerianazinhas	kepleriano+A+DIM+F+PL
keplerianinha	kepleriano+A+DIM+F+SG
keplerianinhas	kepleriano+A+DIM+F+PL
keplerianinho	kepleriano+A+DIM+M+SG
keplerianinhos	kepleriano+A+DIM+M+PL
kepleriano	kepleriano+A+M+SG
keplerianos	kepleriano+A+M+PL
keplerianozinho	kepleriano+A+DIM+M+SG
keplerianozinhos	kepleriano+A+DIM+M+PL
keynesiana	keynesiano+A+F+SG
keynesianas	keynesiano+A+F+PL
keynesianazinha	keynesiano+A+DIM+F+SG
keynesianazinhas	keynesiano+A+DIM+F+PL
keynesianinha	keynesiano+A+DIM+F+SG
keynesianinhas	keynesiano+A+DIM+F+PL
keynesianinho	keynesiano+A+DIM+M+SG
keynesianinhos	keynesiano+A+DIM+M+PL
keynesiano	keynesiano+A+M+SG
keynesianos	keynesiano+A+M+PL
keynesianozinho	keynesiano+A+DIM+M+SG
keynesianozinhos	keynesiano+A+DIM+M+PL
kitsch	kitsch+A
kitschzinha	kitsch+A+DIM+F+SG
kitschzinhas	kitsch+A+DIM+F+PL
kitschzinho	kitsch+A+DIM+M+SG
kitschzinhos	kitsch+A+DIM+M+PL
kleriana	kleriano+A+F+SG
klerianas	kleriano+A+F+PL
klerianazinha	kleriano+A+DIM+F+SG
klerianazinhas	kleriano+A+DIM+F+PL
klerianinha	kleriano+A+DIM+F+SG
klerianinhas	kleriano+A+DIM+F+PL
klerianinho	kleriano+A+DIM+M+SG
klerianinhos	kleriano+A+DIM+M+PL
kleriano	kleriano+A+M+SG
klerianos	kleriano+A+M+PL
klerianozinho	kleriano+A+DIM+M+SG
klerianozinhos	kleriano+A+DIM+M+PL
kuaitiana	kuaitiano+A+F+SG
kuaitianas	kuaitiano+A+F+PL
kuaitianazinha	kuaitiano+A+DIM+F+SG
kuaitianazinhas	kuaitiano+A+DIM+F+PL
kuaitianinha	kuaitiano+A+DIM+F+SG
kuaitianinhas	kuaitiano+A+DIM+F+PL
kuaitianinho	kuaitiano+A+DIM+M+SG
kuaitianinhos	kuaitiano+A+DIM+M+PL
kuaitiano	kuaitiano+A+M+SG
kuaitianos	kuaitiano+A+M+PL
kuaitianozinho	kuaitiano+A+DIM+M+SG
kuaitianozinhos	kuaitiano+A+DIM+M+PL
