wagneriana	wagneriano+A+F+SG
wagnerianas	wagneriano+A+F+PL
wagnerianazinha	wagneriano+A+DIM+F+SG
wagnerianazinhas	wagneriano+A+DIM+F+PL
wagnerianinha	wagneriano+A+DIM+F+SG
wagnerianinhas	wagneriano+A+DIM+F+PL
wagnerianinho	wagneriano+A+DIM+M+SG
wagnerianinhos	wagneriano+A+DIM+M+PL
wagneriano	wagneriano+A+M+SG
wagnerianos	wagneriano+A+M+PL
wagnerianozinho	wagneriano+A+DIM+M+SG
wagnerianozinhos	wagneriano+A+DIM+M+PL
wagneriense	wagneriense+A+SG
wagnerienses	wagneriense+A+PL
wagneriensezinha	wagneriense+A+DIM+F+SG
wagneriensezinhas	wagneriense+A+DIM+F+PL
wagneriensezinho	wagneriense+A+DIM+M+SG
wagneriensezinhos	wagneriense+A+DIM+M+PL
wagneriensinha	wagneriense+A+DIM+F+SG
wagneriensinhas	wagneriense+A+DIM+F+PL
wagneriensinho	wagneriense+A+DIM+M+SG
wagneriensinhos	wagneriense+A+DIM+M+PL
wagneristicazinha	wagnerístico+A+DIM+F+SG
wagneristicazinhas	wagnerístico+A+DIM+F+PL
wagneristicozinho	wagnerístico+A+DIM+M+SG
wagneristicozinhos	wagnerístico+A+DIM+M+PL
wagneristiquinha	wagnerístico+A+DIM+F+SG
wagneristiquinhas	wagnerístico+A+DIM+F+PL
wagneristiquinho	wagnerístico+A+DIM+M+SG
wagneristiquinhos	wagnerístico+A+DIM+M+PL
wagnerística	wagnerístico+A+F+SG
wagnerísticas	wagnerístico+A+F+PL
wagnerístico	wagnerístico+A+M+SG
wagnerísticos	wagnerístico+A+M+PL
walchowita	walchowita+A+F+SG
walchowitas	walchowita+A+F+PL
walchowitazinha	walchowita+A+DIM+F+SG
walchowitazinhas	walchowita+A+DIM+F+PL
walchowitinha	walchowita+A+DIM+F+SG
walchowitinhas	walchowita+A+DIM+F+PL
walleriana	walleriano+A+F+SG
wallerianas	walleriano+A+F+PL
wallerianazinha	walleriano+A+DIM+F+SG
wallerianazinhas	walleriano+A+DIM+F+PL
wallerianinha	walleriano+A+DIM+F+SG
wallerianinhas	walleriano+A+DIM+F+PL
wallerianinho	walleriano+A+DIM+M+SG
wallerianinhos	walleriano+A+DIM+M+PL
walleriano	walleriano+A+M+SG
wallerianos	walleriano+A+M+PL
wallerianozinho	walleriano+A+DIM+M+SG
wallerianozinhos	walleriano+A+DIM+M+PL
walpoliana	walpoliano+A+F+SG
walpolianas	walpoliano+A+F+PL
walpolianazinha	walpoliano+A+DIM+F+SG
walpolianazinhas	walpoliano+A+DIM+F+PL
walpolianinha	walpoliano+A+DIM+F+SG
walpolianinhas	walpoliano+A+DIM+F+PL
walpolianinho	walpoliano+A+DIM+M+SG
walpolianinhos	walpoliano+A+DIM+M+PL
walpoliano	walpoliano+A+M+SG
walpolianos	walpoliano+A+M+PL
walpolianozinho	walpoliano+A+DIM+M+SG
walpolianozinhos	walpoliano+A+DIM+M+PL
warrantaveizinhas	warrantável+A+DIM+F+PL
warrantaveizinhos	warrantável+A+DIM+M+PL
warrantavelzinha	warrantável+A+DIM+F+SG
warrantavelzinho	warrantável+A+DIM+M+SG
warrantáveis	warrantável+A+PL
warrantável	warrantável+A+SG
washingtoniana	washingtoniano+A+F+SG
washingtonianas	washingtoniano+A+F+PL
washingtonianazinha	washingtoniano+A+DIM+F+SG
washingtonianazinhas	washingtoniano+A+DIM+F+PL
washingtonianinha	washingtoniano+A+DIM+F+SG
washingtonianinhas	washingtoniano+A+DIM+F+PL
washingtonianinho	washingtoniano+A+DIM+M+SG
washingtonianinhos	washingtoniano+A+DIM+M+PL
washingtoniano	washingtoniano+A+M+SG
washingtonianos	washingtoniano+A+M+PL
washingtonianozinho	washingtoniano+A+DIM+M+SG
washingtonianozinhos	washingtoniano+A+DIM+M+PL
watsoniana	watsoniano+A+F+SG
watsonianas	watsoniano+A+F+PL
watsonianazinha	watsoniano+A+DIM+F+SG
watsonianazinhas	watsoniano+A+DIM+F+PL
watsonianinha	watsoniano+A+DIM+F+SG
watsonianinhas	watsoniano+A+DIM+F+PL
watsonianinho	watsoniano+A+DIM+M+SG
watsonianinhos	watsoniano+A+DIM+M+PL
watsoniano	watsoniano+A+M+SG
watsonianos	watsoniano+A+M+PL
watsonianozinho	watsoniano+A+DIM+M+SG
watsonianozinhos	watsoniano+A+DIM+M+PL
wattada	wattado+A+F+SG
wattadas	wattado+A+F+PL
wattadazinha	wattado+A+DIM+F+SG
wattadazinhas	wattado+A+DIM+F+PL
wattadinha	wattado+A+DIM+F+SG
wattadinhas	wattado+A+DIM+F+PL
wattadinho	wattado+A+DIM+M+SG
wattadinhos	wattado+A+DIM+M+PL
wattado	wattado+A+M+SG
wattados	wattado+A+M+PL
wattadozinho	wattado+A+DIM+M+SG
wattadozinhos	wattado+A+DIM+M+PL
weberiana	weberiano+A+F+SG
weberianas	weberiano+A+F+PL
weberianazinha	weberiano+A+DIM+F+SG
weberianazinhas	weberiano+A+DIM+F+PL
weberianinha	weberiano+A+DIM+F+SG
weberianinhas	weberiano+A+DIM+F+PL
weberianinho	weberiano+A+DIM+M+SG
weberianinhos	weberiano+A+DIM+M+PL
weberiano	weberiano+A+M+SG
weberianos	weberiano+A+M+PL
weberianozinho	weberiano+A+DIM+M+SG
weberianozinhos	weberiano+A+DIM+M+PL
websteriana	websteriano+A+F+SG
websterianas	websteriano+A+F+PL
websterianazinha	websteriano+A+DIM+F+SG
websterianazinhas	websteriano+A+DIM+F+PL
websterianinha	websteriano+A+DIM+F+SG
websterianinhas	websteriano+A+DIM+F+PL
websterianinho	websteriano+A+DIM+M+SG
websterianinhos	websteriano+A+DIM+M+PL
websteriano	websteriano+A+M+SG
websterianos	websteriano+A+M+PL
websterianozinho	websteriano+A+DIM+M+SG
websterianozinhos	websteriano+A+DIM+M+PL
wedekindiana	wedekindiano+A+F+SG
wedekindianas	wedekindiano+A+F+PL
wedekindianazinha	wedekindiano+A+DIM+F+SG
wedekindianazinhas	wedekindiano+A+DIM+F+PL
wedekindianinha	wedekindiano+A+DIM+F+SG
wedekindianinhas	wedekindiano+A+DIM+F+PL
wedekindianinho	wedekindiano+A+DIM+M+SG
wedekindianinhos	wedekindiano+A+DIM+M+PL
wedekindiano	wedekindiano+A+M+SG
wedekindianos	wedekindiano+A+M+PL
wedekindianozinho	wedekindiano+A+DIM+M+SG
wedekindianozinhos	wedekindiano+A+DIM+M+PL
wegeneriana	wegeneriano+A+F+SG
wegenerianas	wegeneriano+A+F+PL
wegenerianazinha	wegeneriano+A+DIM+F+SG
wegenerianazinhas	wegeneriano+A+DIM+F+PL
wegenerianinha	wegeneriano+A+DIM+F+SG
wegenerianinhas	wegeneriano+A+DIM+F+PL
wegenerianinho	wegeneriano+A+DIM+M+SG
wegenerianinhos	wegeneriano+A+DIM+M+PL
wegeneriano	wegeneriano+A+M+SG
wegenerianos	wegeneriano+A+M+PL
wegenerianozinho	wegeneriano+A+DIM+M+SG
wegenerianozinhos	wegeneriano+A+DIM+M+PL
wegenerista	wegenerista+A+SG
wegeneristas	wegenerista+A+PL
wegeneristazinha	wegenerista+A+DIM+F+SG
wegeneristazinhas	wegenerista+A+DIM+F+PL
wegeneristazinho	wegenerista+A+DIM+M+SG
wegeneristazinhos	wegenerista+A+DIM+M+PL
wegeneristinha	wegenerista+A+DIM+SG
wegeneristinhas	wegenerista+A+DIM+PL
wegeneristicazinha	wegenerístico+A+DIM+F+SG
wegeneristicazinhas	wegenerístico+A+DIM+F+PL
wegeneristicozinho	wegenerístico+A+DIM+M+SG
wegeneristicozinhos	wegenerístico+A+DIM+M+PL
wegeneristiquinha	wegenerístico+A+DIM+F+SG
wegeneristiquinhas	wegenerístico+A+DIM+F+PL
wegeneristiquinho	wegenerístico+A+DIM+M+SG
wegeneristiquinhos	wegenerístico+A+DIM+M+PL
wegenerística	wegenerístico+A+F+SG
wegenerísticas	wegenerístico+A+F+PL
wegenerístico	wegenerístico+A+M+SG
wegenerísticos	wegenerístico+A+M+PL
weimaranense	weimaranense+A+SG
weimaranenses	weimaranense+A+PL
weimaranensezinha	weimaranense+A+DIM+F+SG
weimaranensezinhas	weimaranense+A+DIM+F+PL
weimaranensezinho	weimaranense+A+DIM+M+SG
weimaranensezinhos	weimaranense+A+DIM+M+PL
weimaranensinha	weimaranense+A+DIM+F+SG
weimaranensinhas	weimaranense+A+DIM+F+PL
weimaranensinho	weimaranense+A+DIM+M+SG
weimaranensinhos	weimaranense+A+DIM+M+PL
weimariana	weimariano+A+F+SG
weimarianas	weimariano+A+F+PL
weimarianazinha	weimariano+A+DIM+F+SG
weimarianazinhas	weimariano+A+DIM+F+PL
weimarianinha	weimariano+A+DIM+F+SG
weimarianinhas	weimariano+A+DIM+F+PL
weimarianinho	weimariano+A+DIM+M+SG
weimarianinhos	weimariano+A+DIM+M+PL
weimariano	weimariano+A+M+SG
weimarianos	weimariano+A+M+PL
weimarianozinho	weimariano+A+DIM+M+SG
weimarianozinhos	weimariano+A+DIM+M+PL
weissiana	weissiano+A+F+SG
weissianas	weissiano+A+F+PL
weissianazinha	weissiano+A+DIM+F+SG
weissianazinhas	weissiano+A+DIM+F+PL
weissianinha	weissiano+A+DIM+F+SG
weissianinhas	weissiano+A+DIM+F+PL
weissianinho	weissiano+A+DIM+M+SG
weissianinhos	weissiano+A+DIM+M+PL
weissiano	weissiano+A+M+SG
weissianos	weissiano+A+M+PL
weissianozinho	weissiano+A+DIM+M+SG
weissianozinhos	weissiano+A+DIM+M+PL
weizmanniana	weizmanniano+A+F+SG
weizmannianas	weizmanniano+A+F+PL
weizmannianazinha	weizmanniano+A+DIM+F+SG
weizmannianazinhas	weizmanniano+A+DIM+F+PL
weizmannianinha	weizmanniano+A+DIM+F+SG
weizmannianinhas	weizmanniano+A+DIM+F+PL
weizmannianinho	weizmanniano+A+DIM+M+SG
weizmannianinhos	weizmanniano+A+DIM+M+PL
weizmanniano	weizmanniano+A+M+SG
weizmannianos	weizmanniano+A+M+PL
weizmannianozinho	weizmanniano+A+DIM+M+SG
weizmannianozinhos	weizmanniano+A+DIM+M+PL
wellhausianista	wellhausianista+A+SG
wellhausianistas	wellhausianista+A+PL
wellhausianistazinha	wellhausianista+A+DIM+F+SG
wellhausianistazinhas	wellhausianista+A+DIM+F+PL
wellhausianistazinho	wellhausianista+A+DIM+M+SG
wellhausianistazinhos	wellhausianista+A+DIM+M+PL
wellhausianistinha	wellhausianista+A+DIM+SG
wellhausianistinhas	wellhausianista+A+DIM+PL
wellhausianisticazinha	wellhausianístico+A+DIM+F+SG
wellhausianisticazinhas	wellhausianístico+A+DIM+F+PL
wellhausianisticozinho	wellhausianístico+A+DIM+M+SG
wellhausianisticozinhos	wellhausianístico+A+DIM+M+PL
wellhausianistiquinha	wellhausianístico+A+DIM+F+SG
wellhausianistiquinhas	wellhausianístico+A+DIM+F+PL
wellhausianistiquinho	wellhausianístico+A+DIM+M+SG
wellhausianistiquinhos	wellhausianístico+A+DIM+M+PL
wellhausianística	wellhausianístico+A+F+SG
wellhausianísticas	wellhausianístico+A+F+PL
wellhausianístico	wellhausianístico+A+M+SG
wellhausianísticos	wellhausianístico+A+M+PL
wellingtoniana	wellingtoniano+A+F+SG
wellingtonianas	wellingtoniano+A+F+PL
wellingtonianazinha	wellingtoniano+A+DIM+F+SG
wellingtonianazinhas	wellingtoniano+A+DIM+F+PL
wellingtonianinha	wellingtoniano+A+DIM+F+SG
wellingtonianinhas	wellingtoniano+A+DIM+F+PL
wellingtonianinho	wellingtoniano+A+DIM+M+SG
wellingtonianinhos	wellingtoniano+A+DIM+M+PL
wellingtoniano	wellingtoniano+A+M+SG
wellingtonianos	wellingtoniano+A+M+PL
wellingtonianozinho	wellingtoniano+A+DIM+M+SG
wellingtonianozinhos	wellingtoniano+A+DIM+M+PL
welwitschiaceazinha	welwitschiáceo+A+DIM+F+SG
welwitschiaceazinhas	welwitschiáceo+A+DIM+F+PL
welwitschiaceinha	welwitschiáceo+A+DIM+F+SG
welwitschiaceinhas	welwitschiáceo+A+DIM+F+PL
welwitschiaceinho	welwitschiáceo+A+DIM+M+SG
welwitschiaceinhos	welwitschiáceo+A+DIM+M+PL
welwitschiaceozinho	welwitschiáceo+A+DIM+M+SG
welwitschiaceozinhos	welwitschiáceo+A+DIM+M+PL
welwitschiácea	welwitschiáceo+A+F+SG
welwitschiáceas	welwitschiáceo+A+F+PL
welwitschiáceo	welwitschiáceo+A+M+SG
welwitschiáceos	welwitschiáceo+A+M+PL
welwitsquiaceazinha	welwitsquiáceo+A+DIM+F+SG
welwitsquiaceazinhas	welwitsquiáceo+A+DIM+F+PL
welwitsquiaceinha	welwitsquiáceo+A+DIM+F+SG
welwitsquiaceinhas	welwitsquiáceo+A+DIM+F+PL
welwitsquiaceinho	welwitsquiáceo+A+DIM+M+SG
welwitsquiaceinhos	welwitsquiáceo+A+DIM+M+PL
welwitsquiaceozinho	welwitsquiáceo+A+DIM+M+SG
welwitsquiaceozinhos	welwitsquiáceo+A+DIM+M+PL
welwitsquiácea	welwitsquiáceo+A+F+SG
welwitsquiáceas	welwitsquiáceo+A+F+PL
welwitsquiáceo	welwitsquiáceo+A+M+SG
welwitsquiáceos	welwitsquiáceo+A+M+PL
werneckense	werneckense+A+SG
werneckenses	werneckense+A+PL
werneckensezinha	werneckense+A+DIM+F+SG
werneckensezinhas	werneckense+A+DIM+F+PL
werneckensezinho	werneckense+A+DIM+M+SG
werneckensezinhos	werneckense+A+DIM+M+PL
werneckensinha	werneckense+A+DIM+F+SG
werneckensinhas	werneckense+A+DIM+F+PL
werneckensinho	werneckense+A+DIM+M+SG
werneckensinhos	werneckense+A+DIM+M+PL
werneriana	werneriano+A+F+SG
wernerianas	werneriano+A+F+PL
wernerianazinha	werneriano+A+DIM+F+SG
wernerianazinhas	werneriano+A+DIM+F+PL
wernerianinha	werneriano+A+DIM+F+SG
wernerianinhas	werneriano+A+DIM+F+PL
wernerianinho	werneriano+A+DIM+M+SG
wernerianinhos	werneriano+A+DIM+M+PL
werneriano	werneriano+A+M+SG
wernerianos	werneriano+A+M+PL
wernerianozinho	werneriano+A+DIM+M+SG
wernerianozinhos	werneriano+A+DIM+M+PL
werneriticazinha	wernerítico+A+DIM+F+SG
werneriticazinhas	wernerítico+A+DIM+F+PL
werneriticozinho	wernerítico+A+DIM+M+SG
werneriticozinhos	wernerítico+A+DIM+M+PL
werneritiquinha	wernerítico+A+DIM+F+SG
werneritiquinhas	wernerítico+A+DIM+F+PL
werneritiquinho	wernerítico+A+DIM+M+SG
werneritiquinhos	wernerítico+A+DIM+M+PL
wernerítica	wernerítico+A+F+SG
werneríticas	wernerítico+A+F+PL
wernerítico	wernerítico+A+M+SG
werneríticos	wernerítico+A+M+PL
wesleyanisticazinha	wesleyanístico+A+DIM+F+SG
wesleyanisticazinhas	wesleyanístico+A+DIM+F+PL
wesleyanisticozinho	wesleyanístico+A+DIM+M+SG
wesleyanisticozinhos	wesleyanístico+A+DIM+M+PL
wesleyanistiquinha	wesleyanístico+A+DIM+F+SG
wesleyanistiquinhas	wesleyanístico+A+DIM+F+PL
wesleyanistiquinho	wesleyanístico+A+DIM+M+SG
wesleyanistiquinhos	wesleyanístico+A+DIM+M+PL
wesleyanística	wesleyanístico+A+F+SG
wesleyanísticas	wesleyanístico+A+F+PL
wesleyanístico	wesleyanístico+A+M+SG
wesleyanísticos	wesleyanístico+A+M+PL
westfalense	westfalense+A+SG
westfalenses	westfalense+A+PL
westfalensezinha	westfalense+A+DIM+F+SG
westfalensezinhas	westfalense+A+DIM+F+PL
westfalensezinho	westfalense+A+DIM+M+SG
westfalensezinhos	westfalense+A+DIM+M+PL
westfalensinha	westfalense+A+DIM+F+SG
westfalensinhas	westfalense+A+DIM+F+PL
westfalensinho	westfalense+A+DIM+M+SG
westfalensinhos	westfalense+A+DIM+M+PL
westfaliana	westfaliano+A+F+SG
westfalianas	westfaliano+A+F+PL
westfalianazinha	westfaliano+A+DIM+F+SG
westfalianazinhas	westfaliano+A+DIM+F+PL
westfalianinha	westfaliano+A+DIM+F+SG
westfalianinhas	westfaliano+A+DIM+F+PL
westfalianinho	westfaliano+A+DIM+M+SG
westfalianinhos	westfaliano+A+DIM+M+PL
westfaliano	westfaliano+A+M+SG
westfalianos	westfaliano+A+M+PL
westfalianozinho	westfaliano+A+DIM+M+SG
westfalianozinhos	westfaliano+A+DIM+M+PL
westminsteriana	westminsteriano+A+F+SG
westminsterianas	westminsteriano+A+F+PL
westminsterianazinha	westminsteriano+A+DIM+F+SG
westminsterianazinhas	westminsteriano+A+DIM+F+PL
westminsterianinha	westminsteriano+A+DIM+F+SG
westminsterianinhas	westminsteriano+A+DIM+F+PL
westminsterianinho	westminsteriano+A+DIM+M+SG
westminsterianinhos	westminsteriano+A+DIM+M+PL
westminsteriano	westminsteriano+A+M+SG
westminsterianos	westminsteriano+A+M+PL
westminsterianozinho	westminsteriano+A+DIM+M+SG
westminsterianozinhos	westminsteriano+A+DIM+M+PL
westphalense	westphalense+A+SG
westphalenses	westphalense+A+PL
westphalensezinha	westphalense+A+DIM+F+SG
westphalensezinhas	westphalense+A+DIM+F+PL
westphalensezinho	westphalense+A+DIM+M+SG
westphalensezinhos	westphalense+A+DIM+M+PL
westphalensinha	westphalense+A+DIM+F+SG
westphalensinhas	westphalense+A+DIM+F+PL
westphalensinho	westphalense+A+DIM+M+SG
westphalensinhos	westphalense+A+DIM+M+PL
white-collar	white-collar+A+SG
white-collarzinha	white-collar+A+DIM+F+SG
white-collarzinho	white-collar+A+DIM+M+SG
whiteheadiana	whiteheadiano+A+F+SG
whiteheadianas	whiteheadiano+A+F+PL
whiteheadianazinha	whiteheadiano+A+DIM+F+SG
whiteheadianazinhas	whiteheadiano+A+DIM+F+PL
whiteheadianinha	whiteheadiano+A+DIM+F+SG
whiteheadianinhas	whiteheadiano+A+DIM+F+PL
whiteheadianinho	whiteheadiano+A+DIM+M+SG
whiteheadianinhos	whiteheadiano+A+DIM+M+PL
whiteheadiano	whiteheadiano+A+M+SG
whiteheadianos	whiteheadiano+A+M+PL
whiteheadianozinho	whiteheadiano+A+DIM+M+SG
whiteheadianozinhos	whiteheadiano+A+DIM+M+PL
whiteriticazinha	whiterítico+A+DIM+F+SG
whiteriticazinhas	whiterítico+A+DIM+F+PL
whiteriticozinho	whiterítico+A+DIM+M+SG
whiteriticozinhos	whiterítico+A+DIM+M+PL
whiteritiquinha	whiterítico+A+DIM+F+SG
whiteritiquinhas	whiterítico+A+DIM+F+PL
whiteritiquinho	whiterítico+A+DIM+M+SG
whiteritiquinhos	whiterítico+A+DIM+M+PL
whiterítica	whiterítico+A+F+SG
whiteríticas	whiterítico+A+F+PL
whiterítico	whiterítico+A+M+SG
whiteríticos	whiterítico+A+M+PL
whitmaniana	whitmaniano+A+F+SG
whitmanianas	whitmaniano+A+F+PL
whitmanianazinha	whitmaniano+A+DIM+F+SG
whitmanianazinhas	whitmaniano+A+DIM+F+PL
whitmanianinha	whitmaniano+A+DIM+F+SG
whitmanianinhas	whitmaniano+A+DIM+F+PL
whitmanianinho	whitmaniano+A+DIM+M+SG
whitmanianinhos	whitmaniano+A+DIM+M+PL
whitmaniano	whitmaniano+A+M+SG
whitmanianos	whitmaniano+A+M+PL
whitmanianozinho	whitmaniano+A+DIM+M+SG
whitmanianozinhos	whitmaniano+A+DIM+M+PL
wiechnewiticazinha	wiechnewítico+A+DIM+F+SG
wiechnewiticazinhas	wiechnewítico+A+DIM+F+PL
wiechnewiticozinho	wiechnewítico+A+DIM+M+SG
wiechnewiticozinhos	wiechnewítico+A+DIM+M+PL
wiechnewitiquinha	wiechnewítico+A+DIM+F+SG
wiechnewitiquinhas	wiechnewítico+A+DIM+F+PL
wiechnewitiquinho	wiechnewítico+A+DIM+M+SG
wiechnewitiquinhos	wiechnewítico+A+DIM+M+PL
wiechnewítica	wiechnewítico+A+F+SG
wiechnewíticas	wiechnewítico+A+F+PL
wiechnewítico	wiechnewítico+A+M+SG
wiechnewíticos	wiechnewítico+A+M+PL
wielandiana	wielandiano+A+F+SG
wielandianas	wielandiano+A+F+PL
wielandianazinha	wielandiano+A+DIM+F+SG
wielandianazinhas	wielandiano+A+DIM+F+PL
wielandianinha	wielandiano+A+DIM+F+SG
wielandianinhas	wielandiano+A+DIM+F+PL
wielandianinho	wielandiano+A+DIM+M+SG
wielandianinhos	wielandiano+A+DIM+M+PL
wielandiano	wielandiano+A+M+SG
wielandianos	wielandiano+A+M+PL
wielandianozinho	wielandiano+A+DIM+M+SG
wielandianozinhos	wielandiano+A+DIM+M+PL
wielandielaceazinha	wielandieláceo+A+DIM+F+SG
wielandielaceazinhas	wielandieláceo+A+DIM+F+PL
wielandielaceinha	wielandieláceo+A+DIM+F+SG
wielandielaceinhas	wielandieláceo+A+DIM+F+PL
wielandielaceinho	wielandieláceo+A+DIM+M+SG
wielandielaceinhos	wielandieláceo+A+DIM+M+PL
wielandielaceozinho	wielandieláceo+A+DIM+M+SG
wielandielaceozinhos	wielandieláceo+A+DIM+M+PL
wielandielácea	wielandieláceo+A+F+SG
wielandieláceas	wielandieláceo+A+F+PL
wielandieláceo	wielandieláceo+A+M+SG
wielandieláceos	wielandieláceo+A+M+PL
wildiana	wildiano+A+F+SG
wildianas	wildiano+A+F+PL
wildianazinha	wildiano+A+DIM+F+SG
wildianazinhas	wildiano+A+DIM+F+PL
wildianinha	wildiano+A+DIM+F+SG
wildianinhas	wildiano+A+DIM+F+PL
wildianinho	wildiano+A+DIM+M+SG
wildianinhos	wildiano+A+DIM+M+PL
wildiano	wildiano+A+M+SG
wildianos	wildiano+A+M+PL
wildianozinho	wildiano+A+DIM+M+SG
wildianozinhos	wildiano+A+DIM+M+PL
wilsoniana	wilsoniano+A+F+SG
wilsonianas	wilsoniano+A+F+PL
wilsonianazinha	wilsoniano+A+DIM+F+SG
wilsonianazinhas	wilsoniano+A+DIM+F+PL
wilsonianinha	wilsoniano+A+DIM+F+SG
wilsonianinhas	wilsoniano+A+DIM+F+PL
wilsonianinho	wilsoniano+A+DIM+M+SG
wilsonianinhos	wilsoniano+A+DIM+M+PL
wilsoniano	wilsoniano+A+M+SG
wilsonianos	wilsoniano+A+M+PL
wilsonianozinho	wilsoniano+A+DIM+M+SG
wilsonianozinhos	wilsoniano+A+DIM+M+PL
windsoriana	windsoriano+A+F+SG
windsorianas	windsoriano+A+F+PL
windsorianazinha	windsoriano+A+DIM+F+SG
windsorianazinhas	windsoriano+A+DIM+F+PL
windsorianinha	windsoriano+A+DIM+F+SG
windsorianinhas	windsoriano+A+DIM+F+PL
windsorianinho	windsoriano+A+DIM+M+SG
windsorianinhos	windsoriano+A+DIM+M+PL
windsoriano	windsoriano+A+M+SG
windsorianos	windsoriano+A+M+PL
windsorianozinho	windsoriano+A+DIM+M+SG
windsorianozinhos	windsoriano+A+DIM+M+PL
wolfiana	wolfiano+A+F+SG
wolfianas	wolfiano+A+F+PL
wolfianazinha	wolfiano+A+DIM+F+SG
wolfianazinhas	wolfiano+A+DIM+F+PL
wolfianinha	wolfiano+A+DIM+F+SG
wolfianinhas	wolfiano+A+DIM+F+PL
wolfianinho	wolfiano+A+DIM+M+SG
wolfianinhos	wolfiano+A+DIM+M+PL
wolfiano	wolfiano+A+M+SG
wolfianos	wolfiano+A+M+PL
wolfianozinho	wolfiano+A+DIM+M+SG
wolfianozinhos	wolfiano+A+DIM+M+PL
wronskiana	wronskiano+A+F+SG
wronskianas	wronskiano+A+F+PL
wronskianazinha	wronskiano+A+DIM+F+SG
wronskianazinhas	wronskiano+A+DIM+F+PL
wronskianinha	wronskiano+A+DIM+F+SG
wronskianinhas	wronskiano+A+DIM+F+PL
wronskianinho	wronskiano+A+DIM+M+SG
wronskianinhos	wronskiano+A+DIM+M+PL
wronskiano	wronskiano+A+M+SG
wronskianos	wronskiano+A+M+PL
wronskianozinho	wronskiano+A+DIM+M+SG
wronskianozinhos	wronskiano+A+DIM+M+PL
