u	u+N+M+SG
us	u+N+M+PL
uu	u+N+M+PL
uuzinhos	u+N+DIM+M+PL
uzinho	u+N+DIM+M+SG
uzinhos	u+N+DIM+M+PL
uaabisminho	uaabismo+N+DIM+M+SG
uaabisminhos	uaabismo+N+DIM+M+PL
uaabismo	uaabismo+N+M+SG
uaabismos	uaabismo+N+M+PL
uaabismozinho	uaabismo+N+DIM+M+SG
uaabismozinhos	uaabismo+N+DIM+M+PL
uabagenina	uabagenina+N+F+SG
uabageninas	uabagenina+N+F+PL
uabageninazinha	uabagenina+N+DIM+F+SG
uabageninazinhas	uabagenina+N+DIM+F+PL
uabagenininha	uabagenina+N+DIM+F+SG
uabagenininhas	uabagenina+N+DIM+F+PL
uabainho	uabaio+N+DIM+M+SG
uabainhos	uabaio+N+DIM+M+PL
uabaio	uabaio+N+M+SG
uabaios	uabaio+N+M+PL
uabaiozinho	uabaio+N+DIM+M+SG
uabaiozinhos	uabaio+N+DIM+M+PL
uabatimozinho	uabatimó+N+DIM+M+SG
uabatimozinhos	uabatimó+N+DIM+M+PL
uabatimó	uabatimó+N+M+SG
uabatimós	uabatimó+N+M+PL
uabatinga	uabatinga+N+F+SG
uabatingas	uabatinga+N+F+PL
uabatingazinha	uabatinga+N+DIM+F+SG
uabatingazinhas	uabatinga+N+DIM+F+PL
uabatinguinha	uabatinga+N+DIM+F+SG
uabatinguinhas	uabatinga+N+DIM+F+PL
uacacu	uacacu+N+M+SG
uacacus	uacacu+N+M+PL
uacacuzinho	uacacu+N+DIM+M+SG
uacacuzinhos	uacacu+N+DIM+M+PL
uacanga	uacanga+N+F+SG
uacangas	uacanga+N+F+PL
uacangazinha	uacanga+N+DIM+F+SG
uacangazinhas	uacanga+N+DIM+F+PL
uacanguinha	uacanga+N+DIM+F+SG
uacanguinhas	uacanga+N+DIM+F+PL
uacaparazinho	uacapará+N+DIM+M+SG
uacaparazinhos	uacapará+N+DIM+M+PL
uacapará	uacapará+N+M+SG
uacaparás	uacapará+N+M+PL
uacapu	uacapu+N+M+SG
uacapus	uacapu+N+M+PL
uacapuzinho	uacapu+N+DIM+M+SG
uacapuzinhos	uacapu+N+DIM+M+PL
uacapurana	uacapurana+N+F+SG
uacapuranas	uacapurana+N+F+PL
uacapuranazinha	uacapurana+N+DIM+F+SG
uacapuranazinhas	uacapurana+N+DIM+F+PL
uacapuraninha	uacapurana+N+DIM+F+SG
uacapuraninhas	uacapurana+N+DIM+F+PL
uacarau	uacarau+N+M+SG
uacaraus	uacarau+N+M+PL
uacarauzinho	uacarau+N+DIM+M+SG
uacarauzinhos	uacarau+N+DIM+M+PL
uacari	uacari+N+M+SG
uacaris	uacari+N+M+PL
uacarizinho	uacari+N+DIM+M+SG
uacarizinhos	uacari+N+DIM+M+PL
uacataca	uacataca+N+F+SG
uacatacas	uacataca+N+F+PL
uacatacazinha	uacataca+N+DIM+F+SG
uacatacazinhas	uacataca+N+DIM+F+PL
uacataquinha	uacataca+N+DIM+F+SG
uacataquinhas	uacataca+N+DIM+F+PL
uacindiba	uacindiba+N+F+SG
uacindibas	uacindiba+N+F+PL
uacindibazinha	uacindiba+N+DIM+F+SG
uacindibazinhas	uacindiba+N+DIM+F+PL
uacindibinha	uacindiba+N+DIM+F+SG
uacindibinhas	uacindiba+N+DIM+F+PL
uacumã	uacumã+N+M+SG
uacumãs	uacumã+N+M+PL
uacumãzinho	uacumã+N+DIM+M+SG
uacumãzinhos	uacumã+N+DIM+M+PL
uacurau	uacurau+N+M+SG
uacuraus	uacurau+N+M+PL
uacurauzinho	uacurau+N+DIM+M+SG
uacurauzinhos	uacurau+N+DIM+M+PL
uacuri	uacuri+N+M+SG
uacuris	uacuri+N+M+PL
uacurizinho	uacuri+N+DIM+M+SG
uacurizinhos	uacuri+N+DIM+M+PL
uadaduri	uadaduri+N+M+SG
uadaduris	uadaduri+N+M+PL
uadadurizinho	uadaduri+N+DIM+M+SG
uadadurizinhos	uadaduri+N+DIM+M+PL
uadadazinho	uadadá+N+DIM+M+SG
uadadazinhos	uadadá+N+DIM+M+PL
uadadá	uadadá+N+M+SG
uadadás	uadadá+N+M+PL
uadaianinho	uadaiano+N+DIM+M+SG
uadaianinhos	uadaiano+N+DIM+M+PL
uadaiano	uadaiano+N+M+SG
uadaianos	uadaiano+N+M+PL
uadaianozinho	uadaiano+N+DIM+M+SG
uadaianozinhos	uadaiano+N+DIM+M+PL
uade	uade+N+M+SG
uades	uade+N+M+PL
uadezinho	uade+N+DIM+M+SG
uadezinhos	uade+N+DIM+M+PL
uadinho	uade+N+DIM+M+SG
uadinhos	uade+N+DIM+M+PL
uadinho	uado+N+DIM+M+SG
uadinhos	uado+N+DIM+M+PL
uado	uado+N+M+SG
uados	uado+N+M+PL
uadozinho	uado+N+DIM+M+SG
uadozinhos	uado+N+DIM+M+PL
uaeira	uaeira+N+F+SG
uaeiras	uaeira+N+F+PL
uaeirazinha	uaeira+N+DIM+F+SG
uaeirazinhas	uaeira+N+DIM+F+PL
uaeirinha	uaeira+N+DIM+F+SG
uaeirinhas	uaeira+N+DIM+F+PL
uafezinho	uafé+N+DIM+M+SG
uafezinhos	uafé+N+DIM+M+PL
uafé	uafé+N+M+SG
uafés	uafé+N+M+PL
uaiandi	uaiandi+N+M+SG
uaiandis	uaiandi+N+M+PL
uaiandizinho	uaiandi+N+DIM+M+SG
uaiandizinhos	uaiandi+N+DIM+M+PL
uaiapuçazinho	uaiapuçá+N+DIM+M+SG
uaiapuçazinhos	uaiapuçá+N+DIM+M+PL
uaiapuçá	uaiapuçá+N+M+SG
uaiapuçás	uaiapuçá+N+M+PL
uaiapezinho	uaiapé+N+DIM+M+SG
uaiapezinhos	uaiapé+N+DIM+M+PL
uaiapé	uaiapé+N+M+SG
uaiapés	uaiapé+N+M+PL
uaibama	uaibama+N+F+SG
uaibamas	uaibama+N+F+PL
uaibamazinha	uaibama+N+DIM+F+SG
uaibamazinhas	uaibama+N+DIM+F+PL
uaibaminha	uaibama+N+DIM+F+SG
uaibaminhas	uaibama+N+DIM+F+PL
uaicima	uaicima+N+F+SG
uaicimas	uaicima+N+F+PL
uaicimazinha	uaicima+N+DIM+F+SG
uaicimazinhas	uaicima+N+DIM+F+PL
uaiciminha	uaicima+N+DIM+F+SG
uaiciminhas	uaicima+N+DIM+F+PL
uaieira	uaieira+N+F+SG
uaieiras	uaieira+N+F+PL
uaieirazinha	uaieira+N+DIM+F+SG
uaieirazinhas	uaieira+N+DIM+F+PL
uaieirinha	uaieira+N+DIM+F+SG
uaieirinhas	uaieira+N+DIM+F+PL
uaimirijuru	uaimirijuru+N+M+SG
uaimirijurus	uaimirijuru+N+M+PL
uaimirijuruzinho	uaimirijuru+N+DIM+M+SG
uaimirijuruzinhos	uaimirijuru+N+DIM+M+PL
uaimiuru	uaimiuru+N+M+SG
uaimiurus	uaimiuru+N+M+PL
uaimiuruzinho	uaimiuru+N+DIM+M+SG
uaimiuruzinhos	uaimiuru+N+DIM+M+PL
uaimazinho	uaimá+N+DIM+M+SG
uaimazinhos	uaimá+N+DIM+M+PL
uaimá	uaimá+N+M+SG
uaimás	uaimá+N+M+PL
uaina	uaina+N+F+SG
uainas	uaina+N+F+PL
uainazinha	uaina+N+DIM+F+SG
uainazinhas	uaina+N+DIM+F+PL
uaininha	uaina+N+DIM+F+SG
uaininhas	uaina+N+DIM+F+PL
uaipi	uaipi+N+M+SG
uaipis	uaipi+N+M+PL
uaipizinho	uaipi+N+DIM+M+SG
uaipizinhos	uaipi+N+DIM+M+PL
uairari	uairari+N+M+SG
uairaris	uairari+N+M+PL
uairarizinho	uairari+N+DIM+M+SG
uairarizinhos	uairari+N+DIM+M+PL
uaiumazinho	uaiumá+N+DIM+M+SG
uaiumazinhos	uaiumá+N+DIM+M+PL
uaiumá	uaiumá+N+M+SG
uaiumás	uaiumá+N+M+PL
uajarazinho	uajará+N+DIM+M+SG
uajarazinhos	uajará+N+DIM+M+PL
uajará	uajará+N+M+SG
uajarás	uajará+N+M+PL
uajeru	uajeru+N+M+SG
uajerus	uajeru+N+M+PL
uajeruzinho	uajeru+N+DIM+M+SG
uajeruzinhos	uajeru+N+DIM+M+PL
uajuru	uajuru+N+M+SG
uajurus	uajuru+N+M+PL
uajuruzinho	uajuru+N+DIM+M+SG
uajuruzinhos	uajuru+N+DIM+M+PL
ualabazinho	ualabá+N+DIM+M+SG
ualabazinhos	ualabá+N+DIM+M+PL
ualabá	ualabá+N+M+SG
ualabás	ualabá+N+M+PL
ualala	ualala+N+F+SG
ualalas	ualala+N+F+PL
ualalazinha	ualala+N+DIM+F+SG
ualalazinhas	ualala+N+DIM+F+PL
ualalinha	ualala+N+DIM+F+SG
ualalinhas	ualala+N+DIM+F+PL
ualalocezinho	ualalocê+N+DIM+M+SG
ualalocezinhos	ualalocê+N+DIM+M+PL
ualalocê	ualalocê+N+M+SG
ualalocês	ualalocê+N+M+PL
uale	uale+N+M+SG
uales	uale+N+M+PL
ualezinho	uale+N+DIM+M+SG
ualezinhos	uale+N+DIM+M+PL
ualinho	uale+N+DIM+M+SG
ualinhos	uale+N+DIM+M+PL
ualongo	ualongo+N+M+SG
ualongos	ualongo+N+M+PL
ualongozinho	ualongo+N+DIM+M+SG
ualongozinhos	ualongo+N+DIM+M+PL
ualonguinho	ualongo+N+DIM+M+SG
ualonguinhos	ualongo+N+DIM+M+PL
ualazinho	ualá+N+DIM+M+SG
ualazinhos	ualá+N+DIM+M+PL
ualá	ualá+N+M+SG
ualás	ualá+N+M+PL
uambezinho	uambé+N+DIM+M+SG
uambezinhos	uambé+N+DIM+M+PL
uambé	uambé+N+M+SG
uambés	uambé+N+M+PL
uamiri	uamiri+N+M+SG
uamiris	uamiri+N+M+PL
uamirizinho	uamiri+N+DIM+M+SG
uamirizinhos	uamiri+N+DIM+M+PL
uanambezinho	uanambé+N+DIM+M+SG
uanambezinhos	uanambé+N+DIM+M+PL
uanambé	uanambé+N+M+SG
uanambés	uanambé+N+M+PL
uanapinho	uanapo+N+DIM+M+SG
uanapinhos	uanapo+N+DIM+M+PL
uanapo	uanapo+N+M+SG
uanapos	uanapo+N+M+PL
uanapozinho	uanapo+N+DIM+M+SG
uanapozinhos	uanapo+N+DIM+M+PL
uanda	uanda+N+F+SG
uandas	uanda+N+F+PL
uandazinha	uanda+N+DIM+F+SG
uandazinhas	uanda+N+DIM+F+PL
uandinha	uanda+N+DIM+F+SG
uandinhas	uanda+N+DIM+F+PL
uanderu	uanderu+N+M+SG
uanderus	uanderu+N+M+PL
uanderuzinho	uanderu+N+DIM+M+SG
uanderuzinhos	uanderu+N+DIM+M+PL
uariquina	uariquina+N+F+SG
uariquinas	uariquina+N+F+PL
uariquinazinha	uariquina+N+DIM+F+SG
uariquinazinhas	uariquina+N+DIM+F+PL
uariquininha	uariquina+N+DIM+F+SG
uariquininhas	uariquina+N+DIM+F+PL
uariazinho	uariá+N+DIM+M+SG
uariazinhos	uariá+N+DIM+M+PL
uariá	uariá+N+M+SG
uariás	uariá+N+M+PL
uarubezinho	uarubé+N+DIM+M+SG
uarubezinhos	uarubé+N+DIM+M+PL
uarubé	uarubé+N+M+SG
uarubés	uarubé+N+M+PL
uaruremboia	uaruremboia+N+F+SG
uaruremboias	uaruremboia+N+F+PL
uaruremboiazinha	uaruremboia+N+DIM+F+SG
uaruremboiazinhas	uaruremboia+N+DIM+F+PL
uaruremboinha	uaruremboia+N+DIM+F+SG
uaruremboinhas	uaruremboia+N+DIM+F+PL
uaruremboiazinha	uarurembóia+N+DIM+F+SG
uaruremboiazinhas	uarurembóia+N+DIM+F+PL
uaruremboinha	uarurembóia+N+DIM+F+SG
uaruremboinhas	uarurembóia+N+DIM+F+PL
uarurembóia	uarurembóia+N+F+SG
uarurembóias	uarurembóia+N+F+PL
uatupu	uatupu+N+M+SG
uatupus	uatupu+N+M+PL
uatupuzinho	uatupu+N+DIM+M+SG
uatupuzinhos	uatupu+N+DIM+M+PL
uauaçu	uauaçu+N+M+SG
uauaçus	uauaçu+N+M+PL
uauaçuzinho	uauaçu+N+DIM+M+SG
uauaçuzinhos	uauaçu+N+DIM+M+PL
uaçaizinho	uaçaí+N+DIM+M+SG
uaçaizinhos	uaçaí+N+DIM+M+PL
uaçaí	uaçaí+N+M+SG
uaçaís	uaçaí+N+M+PL
ubacaba	ubacaba+N+F+SG
ubacabas	ubacaba+N+F+PL
ubacabazinha	ubacaba+N+DIM+F+SG
ubacabazinhas	ubacaba+N+DIM+F+PL
ubacabinha	ubacaba+N+DIM+F+SG
ubacabinhas	ubacaba+N+DIM+F+PL
ubaense	ubaense+N+SG
ubaenses	ubaense+N+PL
ubaensezinha	ubaense+N+DIM+F+SG
ubaensezinhas	ubaense+N+DIM+F+PL
ubaensezinho	ubaense+N+DIM+M+SG
ubaensezinhos	ubaense+N+DIM+M+PL
ubaensinha	ubaense+N+DIM+F+SG
ubaensinhas	ubaense+N+DIM+F+PL
ubaensinho	ubaense+N+DIM+M+SG
ubaensinhos	ubaense+N+DIM+M+PL
ubango	ubango+N+M+SG
ubangos	ubango+N+M+PL
ubangozinho	ubango+N+DIM+M+SG
ubangozinhos	ubango+N+DIM+M+PL
ubanguinho	ubango+N+DIM+M+SG
ubanguinhos	ubango+N+DIM+M+PL
ubarana	ubarana+N+M+SG
ubaranas	ubarana+N+M+PL
ubaranazinho	ubarana+N+DIM+M+SG
ubaranazinhos	ubarana+N+DIM+M+PL
ubaraninha	ubarana+N+DIM+M+SG
ubaraninhas	ubarana+N+DIM+M+PL
ubatã	ubatã+N+M+SG
ubatãs	ubatã+N+M+PL
ubatãzinho	ubatã+N+DIM+M+SG
ubatãzinhos	ubatã+N+DIM+M+PL
uberabilidade	uberabilidade+N+F+SG
uberabilidades	uberabilidade+N+F+PL
uberabilidadezinha	uberabilidade+N+DIM+F+SG
uberabilidadezinhas	uberabilidade+N+DIM+F+PL
uberabilidadinha	uberabilidade+N+DIM+F+SG
uberabilidadinhas	uberabilidade+N+DIM+F+PL
uberdade	uberdade+N+F+SG
uberdades	uberdade+N+F+PL
uberdadezinha	uberdade+N+DIM+F+SG
uberdadezinhas	uberdade+N+DIM+F+PL
uberdadinha	uberdade+N+DIM+F+SG
uberdadinhas	uberdade+N+DIM+F+PL
uberosidade	uberosidade+N+F+SG
uberosidades	uberosidade+N+F+PL
uberosidadezinha	uberosidade+N+DIM+F+SG
uberosidadezinhas	uberosidade+N+DIM+F+PL
uberosidadinha	uberosidade+N+DIM+F+SG
uberosidadinhas	uberosidade+N+DIM+F+PL
ubi	ubi+N+M+SG
ubis	ubi+N+M+PL
ubizinho	ubi+N+DIM+M+SG
ubizinhos	ubi+N+DIM+M+PL
ubianganga	ubianganga+N+F+SG
ubiangangas	ubianganga+N+F+PL
ubiangangazinha	ubianganga+N+DIM+F+SG
ubiangangazinhas	ubianganga+N+DIM+F+PL
ubianganguinha	ubianganga+N+DIM+F+SG
ubianganguinhas	ubianganga+N+DIM+F+PL
ubim	ubim+N+M+SG
ubins	ubim+N+M+PL
ubinzinho	ubim+N+DIM+M+SG
ubinzinhos	ubim+N+DIM+M+PL
ubimirim	ubimirim+N+M+SG
ubimirins	ubimirim+N+M+PL
ubimirinzinho	ubimirim+N+DIM+M+SG
ubimirinzinhos	ubimirim+N+DIM+M+PL
ubiquação	ubiquação+N+F+SG
ubiquaçãozinha	ubiquação+N+DIM+F+SG
ubiquações	ubiquação+N+F+PL
ubiquaçõezinhas	ubiquação+N+DIM+F+PL
ubiquidade	ubiquidade+N+F+SG
ubiquidades	ubiquidade+N+F+PL
ubiquidadezinha	ubiquidade+N+DIM+F+SG
ubiquidadezinhas	ubiquidade+N+DIM+F+PL
ubiquidadinha	ubiquidade+N+DIM+F+SG
ubiquidadinhas	ubiquidade+N+DIM+F+PL
ubiquisminho	ubiquismo+N+DIM+M+SG
ubiquisminhos	ubiquismo+N+DIM+M+PL
ubiquismo	ubiquismo+N+M+SG
ubiquismos	ubiquismo+N+M+PL
ubiquismozinho	ubiquismo+N+DIM+M+SG
ubiquismozinhos	ubiquismo+N+DIM+M+PL
ubiquitarisminho	ubiquitarismo+N+DIM+M+SG
ubiquitarisminhos	ubiquitarismo+N+DIM+M+PL
ubiquitarismo	ubiquitarismo+N+M+SG
ubiquitarismos	ubiquitarismo+N+M+PL
ubiquitarismozinho	ubiquitarismo+N+DIM+M+SG
ubiquitarismozinhos	ubiquitarismo+N+DIM+M+PL
ubiquitariazinha	ubiquitário+N+DIM+F+SG
ubiquitariazinhas	ubiquitário+N+DIM+F+PL
ubiquitarinha	ubiquitário+N+DIM+F+SG
ubiquitarinhas	ubiquitário+N+DIM+F+PL
ubiquitarinho	ubiquitário+N+DIM+M+SG
ubiquitarinhos	ubiquitário+N+DIM+M+PL
ubiquitariozinho	ubiquitário+N+DIM+M+SG
ubiquitariozinhos	ubiquitário+N+DIM+M+PL
ubiquitária	ubiquitário+N+F+SG
ubiquitárias	ubiquitário+N+F+PL
ubiquitário	ubiquitário+N+M+SG
ubiquitários	ubiquitário+N+M+PL
ubiqüidade	ubiqüidade+N+F+SG
ubiqüidades	ubiqüidade+N+F+PL
ubiqüidadezinha	ubiqüidade+N+DIM+F+SG
ubiqüidadezinhas	ubiqüidade+N+DIM+F+PL
ubiqüidadinha	ubiqüidade+N+DIM+F+SG
ubiqüidadinhas	ubiqüidade+N+DIM+F+PL
ubiracicazinha	ubiracicá+N+DIM+F+SG
ubiracicazinhas	ubiracicá+N+DIM+F+PL
ubiracicá	ubiracicá+N+F+SG
ubiracicás	ubiracicá+N+F+PL
ubre	ubre+N+M+SG
ubres	ubre+N+M+PL
ubrezinho	ubre+N+DIM+M+SG
ubrezinhos	ubre+N+DIM+M+PL
ubrinho	ubre+N+DIM+M+SG
ubrinhos	ubre+N+DIM+M+PL
ubazinha	ubá+N+DIM+F+SG
ubazinhas	ubá+N+DIM+F+PL
ubazinho	ubá+N+DIM+M+SG
ubazinhos	ubá+N+DIM+M+PL
ubá	ubá+N+SG
ubás	ubá+N+PL
uca	uca+N+F+SG
ucas	uca+N+F+PL
ucazinha	uca+N+DIM+F+SG
ucazinhas	uca+N+DIM+F+PL
uquinha	uca+N+DIM+F+SG
uquinhas	uca+N+DIM+F+PL
ucasse	ucasse+N+M+SG
ucasses	ucasse+N+M+PL
ucassezinho	ucasse+N+DIM+M+SG
ucassezinhos	ucasse+N+DIM+M+PL
ucassinho	ucasse+N+DIM+M+SG
ucassinhos	ucasse+N+DIM+M+PL
ucha	ucha+N+F+SG
uchas	ucha+N+F+PL
uchazinha	ucha+N+DIM+F+SG
uchazinhas	ucha+N+DIM+F+PL
uchinha	ucha+N+DIM+F+SG
uchinhas	ucha+N+DIM+F+PL
ucharia	ucharia+N+F+SG
ucharias	ucharia+N+F+PL
uchariazinha	ucharia+N+DIM+F+SG
uchariazinhas	ucharia+N+DIM+F+PL
ucharinha	ucharia+N+DIM+F+SG
ucharinhas	ucharia+N+DIM+F+PL
uchona	uchão+N+F+SG
uchonas	uchão+N+F+PL
uchonazinha	uchão+N+DIM+F+SG
uchonazinhas	uchão+N+DIM+F+PL
uchoninha	uchão+N+DIM+F+SG
uchoninhas	uchão+N+DIM+F+PL
uchão	uchão+N+M+SG
uchãozinho	uchão+N+DIM+M+SG
uchões	uchão+N+M+PL
uchõezinhos	uchão+N+DIM+M+PL
ucraniana	ucraniano+N+F+SG
ucranianas	ucraniano+N+F+PL
ucranianazinha	ucraniano+N+DIM+F+SG
ucranianazinhas	ucraniano+N+DIM+F+PL
ucranianinha	ucraniano+N+DIM+F+SG
ucranianinhas	ucraniano+N+DIM+F+PL
ucranianinho	ucraniano+N+DIM+M+SG
ucranianinhos	ucraniano+N+DIM+M+PL
ucraniano	ucraniano+N+M+SG
ucranianos	ucraniano+N+M+PL
ucranianozinho	ucraniano+N+DIM+M+SG
ucranianozinhos	ucraniano+N+DIM+M+PL
ucronia	ucronia+N+F+SG
ucronias	ucronia+N+F+PL
ucroniazinha	ucronia+N+DIM+F+SG
ucroniazinhas	ucronia+N+DIM+F+PL
ucroninha	ucronia+N+DIM+F+SG
ucroninhas	ucronia+N+DIM+F+PL
ucronicidade	ucronicidade+N+F+SG
ucronicidades	ucronicidade+N+F+PL
ucronicidadezinha	ucronicidade+N+DIM+F+SG
ucronicidadezinhas	ucronicidade+N+DIM+F+PL
ucronicidadinha	ucronicidade+N+DIM+F+SG
ucronicidadinhas	ucronicidade+N+DIM+F+PL
ucuuba	ucuuba+N+F+SG
ucuubas	ucuuba+N+F+PL
ucuubazinha	ucuuba+N+DIM+F+SG
ucuubazinhas	ucuuba+N+DIM+F+PL
ucuubinha	ucuuba+N+DIM+F+SG
ucuubinhas	ucuuba+N+DIM+F+PL
ucuubeira	ucuubeira+N+F+SG
ucuubeiras	ucuubeira+N+F+PL
ucuubeirazinha	ucuubeira+N+DIM+F+SG
ucuubeirazinhas	ucuubeira+N+DIM+F+PL
ucuubeirinha	ucuubeira+N+DIM+F+SG
ucuubeirinhas	ucuubeira+N+DIM+F+PL
udenista	udenista+N+SG
udenistas	udenista+N+PL
udenistazinha	udenista+N+DIM+F+SG
udenistazinhas	udenista+N+DIM+F+PL
udenistazinho	udenista+N+DIM+M+SG
udenistazinhos	udenista+N+DIM+M+PL
udenistinha	udenista+N+DIM+SG
udenistinhas	udenista+N+DIM+PL
udometria	udometria+N+F+SG
udometrias	udometria+N+F+PL
udometriazinha	udometria+N+DIM+F+SG
udometriazinhas	udometria+N+DIM+F+PL
udometrinha	udometria+N+DIM+F+SG
udometrinhas	udometria+N+DIM+F+PL
udometricidade	udometricidade+N+F+SG
udometricidades	udometricidade+N+F+PL
udometricidadezinha	udometricidade+N+DIM+F+SG
udometricidadezinhas	udometricidade+N+DIM+F+PL
udometricidadinha	udometricidade+N+DIM+F+SG
udometricidadinhas	udometricidade+N+DIM+F+PL
udu	udu+N+M+SG
udus	udu+N+M+PL
uduzinho	udu+N+DIM+M+SG
uduzinhos	udu+N+DIM+M+PL
udometrinho	udómetro+N+DIM+M+SG
udometrinhos	udómetro+N+DIM+M+PL
udometrozinho	udómetro+N+DIM+M+SG
udometrozinhos	udómetro+N+DIM+M+PL
udómetro	udómetro+N+M+SG
udómetros	udómetro+N+M+PL
udometrinho	udômetro+N+DIM+M+SG
udometrinhos	udômetro+N+DIM+M+PL
udometrozinho	udômetro+N+DIM+M+SG
udometrozinhos	udômetro+N+DIM+M+PL
udômetro	udômetro+N+M+SG
udômetros	udômetro+N+M+PL
ufa	ufa+N+F+SG
ufas	ufa+N+F+PL
ufazinha	ufa+N+DIM+F+SG
ufazinhas	ufa+N+DIM+F+PL
ufinha	ufa+N+DIM+F+SG
ufinhas	ufa+N+DIM+F+PL
ufanabilidade	ufanabilidade+N+F+SG
ufanabilidades	ufanabilidade+N+F+PL
ufanabilidadezinha	ufanabilidade+N+DIM+F+SG
ufanabilidadezinhas	ufanabilidade+N+DIM+F+PL
ufanabilidadinha	ufanabilidade+N+DIM+F+SG
ufanabilidadinhas	ufanabilidade+N+DIM+F+PL
ufania	ufania+N+F+SG
ufanias	ufania+N+F+PL
ufaniazinha	ufania+N+DIM+F+SG
ufaniazinhas	ufania+N+DIM+F+PL
ufaninha	ufania+N+DIM+F+SG
ufaninhas	ufania+N+DIM+F+PL
ufanisminho	ufanismo+N+DIM+M+SG
ufanisminhos	ufanismo+N+DIM+M+PL
ufanismo	ufanismo+N+M+SG
ufanismos	ufanismo+N+M+PL
ufanismozinho	ufanismo+N+DIM+M+SG
ufanismozinhos	ufanismo+N+DIM+M+PL
ufanosidade	ufanosidade+N+F+SG
ufanosidades	ufanosidade+N+F+PL
ufanosidadezinha	ufanosidade+N+DIM+F+SG
ufanosidadezinhas	ufanosidade+N+DIM+F+PL
ufanosidadinha	ufanosidade+N+DIM+F+SG
ufanosidadinhas	ufanosidade+N+DIM+F+PL
ufinho	ufo+N+DIM+M+SG
ufinhos	ufo+N+DIM+M+PL
ufo	ufo+N+M+SG
ufos	ufo+N+M+PL
ufozinho	ufo+N+DIM+M+SG
ufozinhos	ufo+N+DIM+M+PL
ufologia	ufologia+N+F+SG
ufologias	ufologia+N+F+PL
ufologiazinha	ufologia+N+DIM+F+SG
ufologiazinhas	ufologia+N+DIM+F+PL
ufologinha	ufologia+N+DIM+F+SG
ufologinhas	ufologia+N+DIM+F+PL
ufologicidade	ufologicidade+N+F+SG
ufologicidades	ufologicidade+N+F+PL
ufologicidadezinha	ufologicidade+N+DIM+F+SG
ufologicidadezinhas	ufologicidade+N+DIM+F+PL
ufologicidadinha	ufologicidade+N+DIM+F+SG
ufologicidadinhas	ufologicidade+N+DIM+F+PL
ufologista	ufologista+N+SG
ufologistas	ufologista+N+PL
ufologistazinha	ufologista+N+DIM+F+SG
ufologistazinhas	ufologista+N+DIM+F+PL
ufologistazinho	ufologista+N+DIM+M+SG
ufologistazinhos	ufologista+N+DIM+M+PL
ufologistinha	ufologista+N+DIM+SG
ufologistinhas	ufologista+N+DIM+PL
ufomania	ufomania+N+F+SG
ufomanias	ufomania+N+F+PL
ufomaniazinha	ufomania+N+DIM+F+SG
ufomaniazinhas	ufomania+N+DIM+F+PL
ufomaninha	ufomania+N+DIM+F+SG
ufomaninhas	ufomania+N+DIM+F+PL
ufonauta	ufonauta+N+SG
ufonautas	ufonauta+N+PL
ufonautazinha	ufonauta+N+DIM+F+SG
ufonautazinhas	ufonauta+N+DIM+F+PL
ufonautazinho	ufonauta+N+DIM+M+SG
ufonautazinhos	ufonauta+N+DIM+M+PL
ufonautinha	ufonauta+N+DIM+SG
ufonautinhas	ufonauta+N+DIM+PL
ufologazinha	ufólogo+N+DIM+F+SG
ufologazinhas	ufólogo+N+DIM+F+PL
ufologozinho	ufólogo+N+DIM+M+SG
ufologozinhos	ufólogo+N+DIM+M+PL
ufologuinha	ufólogo+N+DIM+F+SG
ufologuinhas	ufólogo+N+DIM+F+PL
ufologuinho	ufólogo+N+DIM+M+SG
ufologuinhos	ufólogo+N+DIM+M+PL
ufóloga	ufólogo+N+F+SG
ufólogas	ufólogo+N+F+PL
ufólogo	ufólogo+N+M+SG
ufólogos	ufólogo+N+M+PL
ugabe	ugabe+N+M+SG
ugabes	ugabe+N+M+PL
ugabezinho	ugabe+N+DIM+M+SG
ugabezinhos	ugabe+N+DIM+M+PL
ugabinho	ugabe+N+DIM+M+SG
ugabinhos	ugabe+N+DIM+M+PL
ugabilidade	ugabilidade+N+F+SG
ugabilidades	ugabilidade+N+F+PL
ugabilidadezinha	ugabilidade+N+DIM+F+SG
ugabilidadezinhas	ugabilidade+N+DIM+F+PL
ugabilidadinha	ugabilidade+N+DIM+F+SG
ugabilidadinhas	ugabilidade+N+DIM+F+PL
ugalha	ugalha+N+F+SG
ugalhas	ugalha+N+F+PL
ugalhazinha	ugalha+N+DIM+F+SG
ugalhazinhas	ugalha+N+DIM+F+PL
ugalhinha	ugalha+N+DIM+F+SG
ugalhinhas	ugalha+N+DIM+F+PL
ugalhabilidade	ugalhabilidade+N+F+SG
ugalhabilidades	ugalhabilidade+N+F+PL
ugalhabilidadezinha	ugalhabilidade+N+DIM+F+SG
ugalhabilidadezinhas	ugalhabilidade+N+DIM+F+PL
ugalhabilidadinha	ugalhabilidade+N+DIM+F+SG
ugalhabilidadinhas	ugalhabilidade+N+DIM+F+PL
ugalhinho	ugalho+N+DIM+M+SG
ugalhinhos	ugalho+N+DIM+M+PL
ugalho	ugalho+N+M+SG
ugalhos	ugalho+N+M+PL
ugalhozinho	ugalho+N+DIM+M+SG
ugalhozinhos	ugalho+N+DIM+M+PL
ugandesa	ugandês+N+F+SG
ugandesas	ugandês+N+F+PL
ugandesazinha	ugandês+N+DIM+F+SG
ugandesazinhas	ugandês+N+DIM+F+PL
ugandeses	ugandês+N+M+PL
ugandesezinhos	ugandês+N+DIM+M+PL
ugandesinha	ugandês+N+DIM+F+SG
ugandesinhas	ugandês+N+DIM+F+PL
ugandesinho	ugandês+N+DIM+M+SG
ugandesinhos	ugandês+N+DIM+M+PL
ugandês	ugandês+N+M+SG
ugariticidade	ugariticidade+N+F+SG
ugariticidades	ugariticidade+N+F+PL
ugariticidadezinha	ugariticidade+N+DIM+F+SG
ugariticidadezinhas	ugariticidade+N+DIM+F+PL
ugariticidadinha	ugariticidade+N+DIM+F+SG
ugariticidadinhas	ugariticidade+N+DIM+F+PL
ugrinho	ugro+N+DIM+M+SG
ugrinhos	ugro+N+DIM+M+PL
ugro	ugro+N+M+SG
ugros	ugro+N+M+PL
ugrozinho	ugro+N+DIM+M+SG
ugrozinhos	ugro+N+DIM+M+PL
uiara	uiara+N+SG
uiaras	uiara+N+PL
uiarazinha	uiara+N+DIM+F+SG
uiarazinhas	uiara+N+DIM+F+PL
uiarazinho	uiara+N+DIM+M+SG
uiarazinhos	uiara+N+DIM+M+PL
uiarinha	uiara+N+DIM+SG
uiarinhas	uiara+N+DIM+PL
uigure	uigure+N+M+SG
uigures	uigure+N+M+PL
uigurezinho	uigure+N+DIM+M+SG
uigurezinhos	uigure+N+DIM+M+PL
uigurinho	uigure+N+DIM+M+SG
uigurinhos	uigure+N+DIM+M+PL
uigurzinhos	uigure+N+DIM+M+PL
uiguricidade	uiguricidade+N+F+SG
uiguricidades	uiguricidade+N+F+PL
uiguricidadezinha	uiguricidade+N+DIM+F+SG
uiguricidadezinhas	uiguricidade+N+DIM+F+PL
uiguricidadinha	uiguricidade+N+DIM+F+SG
uiguricidadinhas	uiguricidade+N+DIM+F+PL
uiofobia	uiofobia+N+F+SG
uiofobias	uiofobia+N+F+PL
uiofobiazinha	uiofobia+N+DIM+F+SG
uiofobiazinhas	uiofobia+N+DIM+F+PL
uiofobinha	uiofobia+N+DIM+F+SG
uiofobinhas	uiofobia+N+DIM+F+PL
uirapuru	uirapuru+N+M+SG
uirapurus	uirapuru+N+M+PL
uirapuruzinho	uirapuru+N+DIM+M+SG
uirapuruzinhos	uirapuru+N+DIM+M+PL
uirari	uirari+N+M+SG
uiraris	uirari+N+M+PL
uirarizinho	uirari+N+DIM+M+SG
uirarizinhos	uirari+N+DIM+M+PL
uiraçu	uiraçu+N+M+SG
uiraçus	uiraçu+N+M+PL
uiraçuzinho	uiraçu+N+DIM+M+SG
uiraçuzinhos	uiraçu+N+DIM+M+PL
uiraunazinha	uiraúna+N+DIM+F+SG
uiraunazinhas	uiraúna+N+DIM+F+PL
uirauninha	uiraúna+N+DIM+F+SG
uirauninhas	uiraúna+N+DIM+F+PL
uiraúna	uiraúna+N+F+SG
uiraúnas	uiraúna+N+F+PL
uiruucotim	uiruucotim+N+M+SG
uiruucotins	uiruucotim+N+M+PL
uiruucotinzinho	uiruucotim+N+DIM+M+SG
uiruucotinzinhos	uiruucotim+N+DIM+M+PL
uisque	uisque+N+M+SG
uisques	uisque+N+M+PL
uisquezinho	uisque+N+DIM+M+SG
uisquezinhos	uisque+N+DIM+M+PL
uisquinho	uisque+N+DIM+M+SG
uisquinhos	uisque+N+DIM+M+PL
uivabilidade	uivabilidade+N+F+SG
uivabilidades	uivabilidade+N+F+PL
uivabilidadezinha	uivabilidade+N+DIM+F+SG
uivabilidadezinhas	uivabilidade+N+DIM+F+PL
uivabilidadinha	uivabilidade+N+DIM+F+SG
uivabilidadinhas	uivabilidade+N+DIM+F+PL
uivada	uivada+N+F+SG
uivadas	uivada+N+F+PL
uivadazinha	uivada+N+DIM+F+SG
uivadazinhas	uivada+N+DIM+F+PL
uivadinha	uivada+N+DIM+F+SG
uivadinhas	uivada+N+DIM+F+PL
uivador	uivador+N+M+SG
uivadora	uivador+N+F+SG
uivadoras	uivador+N+F+PL
uivadorazinha	uivador+N+DIM+F+SG
uivadorazinhas	uivador+N+DIM+F+PL
uivadores	uivador+N+M+PL
uivadorezinhos	uivador+N+DIM+M+PL
uivadorinha	uivador+N+DIM+F+SG
uivadorinhas	uivador+N+DIM+F+PL
uivadorzinho	uivador+N+DIM+M+SG
uivadorzinhos	uivador+N+DIM+M+PL
uivinho	uivo+N+DIM+M+SG
uivinhos	uivo+N+DIM+M+PL
uivo	uivo+N+M+SG
uivos	uivo+N+M+PL
uivozinho	uivo+N+DIM+M+SG
uivozinhos	uivo+N+DIM+M+PL
uja	uja+N+M+SG
ujas	uja+N+M+PL
ujazinho	uja+N+DIM+M+SG
ujazinhos	uja+N+DIM+M+PL
ujinha	uja+N+DIM+M+SG
ujinhas	uja+N+DIM+M+PL
uje	uje+N+M+SG
ujes	uje+N+M+PL
ujezinho	uje+N+DIM+M+SG
ujezinhos	uje+N+DIM+M+PL
ujinho	uje+N+DIM+M+SG
ujinhos	uje+N+DIM+M+PL
ujica	ujica+N+F+SG
ujicas	ujica+N+F+PL
ujicazinha	ujica+N+DIM+F+SG
ujicazinhas	ujica+N+DIM+F+PL
ujiquinha	ujica+N+DIM+F+SG
ujiquinhas	ujica+N+DIM+F+PL
ujinho	ujo+N+DIM+M+SG
ujinhos	ujo+N+DIM+M+PL
ujo	ujo+N+M+SG
ujos	ujo+N+M+PL
ujozinho	ujo+N+DIM+M+SG
ujozinhos	ujo+N+DIM+M+PL
ulalgia	ulalgia+N+F+SG
ulalgias	ulalgia+N+F+PL
ulalgiazinha	ulalgia+N+DIM+F+SG
ulalgiazinhas	ulalgia+N+DIM+F+PL
ulalginha	ulalgia+N+DIM+F+SG
ulalginhas	ulalgia+N+DIM+F+PL
ulaninho	ulano+N+DIM+M+SG
ulaninhos	ulano+N+DIM+M+PL
ulano	ulano+N+M+SG
ulanos	ulano+N+M+PL
ulanozinho	ulano+N+DIM+M+SG
ulanozinhos	ulano+N+DIM+M+PL
ulcerabilidade	ulcerabilidade+N+F+SG
ulcerabilidades	ulcerabilidade+N+F+PL
ulcerabilidadezinha	ulcerabilidade+N+DIM+F+SG
ulcerabilidadezinhas	ulcerabilidade+N+DIM+F+PL
ulcerabilidadinha	ulcerabilidade+N+DIM+F+SG
ulcerabilidadinhas	ulcerabilidade+N+DIM+F+PL
ulceratividade	ulceratividade+N+F+SG
ulceratividades	ulceratividade+N+F+PL
ulceratividadezinha	ulceratividade+N+DIM+F+SG
ulceratividadezinhas	ulceratividade+N+DIM+F+PL
ulceratividadinha	ulceratividade+N+DIM+F+SG
ulceratividadinhas	ulceratividade+N+DIM+F+PL
ulceração	ulceração+N+F+SG
ulceraçãozinha	ulceração+N+DIM+F+SG
ulcerações	ulceração+N+F+PL
ulceraçõezinhas	ulceração+N+DIM+F+PL
ulcerosidade	ulcerosidade+N+F+SG
ulcerosidades	ulcerosidade+N+F+PL
ulcerosidadezinha	ulcerosidade+N+DIM+F+SG
ulcerosidadezinhas	ulcerosidade+N+DIM+F+PL
ulcerosidadinha	ulcerosidade+N+DIM+F+SG
ulcerosidadinhas	ulcerosidade+N+DIM+F+PL
ulemazinho	ulemá+N+DIM+M+SG
ulemazinhos	ulemá+N+DIM+M+PL
ulemá	ulemá+N+M+SG
ulemás	ulemá+N+M+PL
uliginosidade	uliginosidade+N+F+SG
uliginosidades	uliginosidade+N+F+PL
uliginosidadezinha	uliginosidade+N+DIM+F+SG
uliginosidadezinhas	uliginosidade+N+DIM+F+PL
uliginosidadinha	uliginosidade+N+DIM+F+SG
uliginosidadinhas	uliginosidade+N+DIM+F+PL
ulissiponense	ulissiponense+N+SG
ulissiponenses	ulissiponense+N+PL
ulissiponensezinha	ulissiponense+N+DIM+F+SG
ulissiponensezinhas	ulissiponense+N+DIM+F+PL
ulissiponensezinho	ulissiponense+N+DIM+M+SG
ulissiponensezinhos	ulissiponense+N+DIM+M+PL
ulissiponensinha	ulissiponense+N+DIM+F+SG
ulissiponensinhas	ulissiponense+N+DIM+F+PL
ulissiponensinho	ulissiponense+N+DIM+M+SG
ulissiponensinhos	ulissiponense+N+DIM+M+PL
ulite	ulite+N+F+SG
ulites	ulite+N+F+PL
ulitezinha	ulite+N+DIM+F+SG
ulitezinhas	ulite+N+DIM+F+PL
ulitinha	ulite+N+DIM+F+SG
ulitinhas	ulite+N+DIM+F+PL
ulmarina	ulmarina+N+F+SG
ulmarinas	ulmarina+N+F+PL
ulmarinazinha	ulmarina+N+DIM+F+SG
ulmarinazinhas	ulmarina+N+DIM+F+PL
ulmarininha	ulmarina+N+DIM+F+SG
ulmarininhas	ulmarina+N+DIM+F+PL
ulmeira	ulmeira+N+F+SG
ulmeiras	ulmeira+N+F+PL
ulmeirazinha	ulmeira+N+DIM+F+SG
ulmeirazinhas	ulmeira+N+DIM+F+PL
ulmeirinha	ulmeira+N+DIM+F+SG
ulmeirinhas	ulmeira+N+DIM+F+PL
ulmeirinho	ulmeiro+N+DIM+M+SG
ulmeirinhos	ulmeiro+N+DIM+M+PL
ulmeiro	ulmeiro+N+M+SG
ulmeiros	ulmeiro+N+M+PL
ulmeirozinho	ulmeiro+N+DIM+M+SG
ulmeirozinhos	ulmeiro+N+DIM+M+PL
ulmicidade	ulmicidade+N+F+SG
ulmicidades	ulmicidade+N+F+PL
ulmicidadezinha	ulmicidade+N+DIM+F+SG
ulmicidadezinhas	ulmicidade+N+DIM+F+PL
ulmicidadinha	ulmicidade+N+DIM+F+SG
ulmicidadinhas	ulmicidade+N+DIM+F+PL
ulminho	ulmo+N+DIM+M+SG
ulminhos	ulmo+N+DIM+M+PL
ulmo	ulmo+N+M+SG
ulmos	ulmo+N+M+PL
ulmozinho	ulmo+N+DIM+M+SG
ulmozinhos	ulmo+N+DIM+M+PL
ulmaceazinha	ulmácea+N+DIM+F+SG
ulmaceazinhas	ulmácea+N+DIM+F+PL
ulmaceinha	ulmácea+N+DIM+F+SG
ulmaceinhas	ulmácea+N+DIM+F+PL
ulmácea	ulmácea+N+F+SG
ulmáceas	ulmácea+N+F+PL
ulmáceas	ulmáceas+N+F+PL
ulmaceazinha	ulmáceo+N+DIM+F+SG
ulmaceazinhas	ulmáceo+N+DIM+F+PL
ulmaceinha	ulmáceo+N+DIM+F+SG
ulmaceinhas	ulmáceo+N+DIM+F+PL
ulmaceinho	ulmáceo+N+DIM+M+SG
ulmaceinhos	ulmáceo+N+DIM+M+PL
ulmaceozinho	ulmáceo+N+DIM+M+SG
ulmaceozinhos	ulmáceo+N+DIM+M+PL
ulmácea	ulmáceo+N+F+SG
ulmáceas	ulmáceo+N+F+PL
ulmáceo	ulmáceo+N+M+SG
ulmáceos	ulmáceo+N+M+PL
ulmariazinha	ulmária+N+DIM+F+SG
ulmariazinhas	ulmária+N+DIM+F+PL
ulmarinha	ulmária+N+DIM+F+SG
ulmarinhas	ulmária+N+DIM+F+PL
ulmária	ulmária+N+F+SG
ulmárias	ulmária+N+F+PL
ulna	ulna+N+F+SG
ulnas	ulna+N+F+PL
ulnazinha	ulna+N+DIM+F+SG
ulnazinhas	ulna+N+DIM+F+PL
ulninha	ulna+N+DIM+F+SG
ulninhas	ulna+N+DIM+F+PL
ulnalidade	ulnalidade+N+F+SG
ulnalidades	ulnalidade+N+F+PL
ulnalidadezinha	ulnalidade+N+DIM+F+SG
ulnalidadezinhas	ulnalidade+N+DIM+F+PL
ulnalidadinha	ulnalidade+N+DIM+F+SG
ulnalidadinhas	ulnalidade+N+DIM+F+PL
ulnaridade	ulnaridade+N+F+SG
ulnaridades	ulnaridade+N+F+PL
ulnaridadezinha	ulnaridade+N+DIM+F+SG
ulnaridadezinhas	ulnaridade+N+DIM+F+PL
ulnaridadinha	ulnaridade+N+DIM+F+SG
ulnaridadinhas	ulnaridade+N+DIM+F+PL
ulinho	ulo+N+DIM+M+SG
ulinhos	ulo+N+DIM+M+PL
ulo	ulo+N+M+SG
ulos	ulo+N+M+PL
ulozinho	ulo+N+DIM+M+SG
ulozinhos	ulo+N+DIM+M+PL
uloatrofia	uloatrofia+N+F+SG
uloatrofias	uloatrofia+N+F+PL
uloatrofiazinha	uloatrofia+N+DIM+F+SG
uloatrofiazinhas	uloatrofia+N+DIM+F+PL
uloatrofinha	uloatrofia+N+DIM+F+SG
uloatrofinhas	uloatrofia+N+DIM+F+PL
uloma	uloma+N+M+SG
ulomas	uloma+N+M+PL
ulomazinho	uloma+N+DIM+M+SG
ulomazinhos	uloma+N+DIM+M+PL
ulominha	uloma+N+DIM+M+SG
ulominhas	uloma+N+DIM+M+PL
ulotricidade	ulotricidade+N+F+SG
ulotricidades	ulotricidade+N+F+PL
ulotricidadezinha	ulotricidade+N+DIM+F+SG
ulotricidadezinhas	ulotricidade+N+DIM+F+PL
ulotricidadinha	ulotricidade+N+DIM+F+SG
ulotricidadinhas	ulotricidade+N+DIM+F+PL
ulterioridade	ulterioridade+N+F+SG
ulterioridades	ulterioridade+N+F+PL
ulterioridadezinha	ulterioridade+N+DIM+F+SG
ulterioridadezinhas	ulterioridade+N+DIM+F+PL
ulterioridadinha	ulterioridade+N+DIM+F+SG
ulterioridadinhas	ulterioridade+N+DIM+F+PL
ultimabilidade	ultimabilidade+N+F+SG
ultimabilidades	ultimabilidade+N+F+PL
ultimabilidadezinha	ultimabilidade+N+DIM+F+SG
ultimabilidadezinhas	ultimabilidade+N+DIM+F+PL
ultimabilidadinha	ultimabilidade+N+DIM+F+SG
ultimabilidadinhas	ultimabilidade+N+DIM+F+PL
ultimador	ultimador+N+M+SG
ultimadora	ultimador+N+F+SG
ultimadoras	ultimador+N+F+PL
ultimadorazinha	ultimador+N+DIM+F+SG
ultimadorazinhas	ultimador+N+DIM+F+PL
ultimadores	ultimador+N+M+PL
ultimadorezinhos	ultimador+N+DIM+M+PL
ultimadorinha	ultimador+N+DIM+F+SG
ultimadorinhas	ultimador+N+DIM+F+PL
ultimadorzinho	ultimador+N+DIM+M+SG
ultimadorzinhos	ultimador+N+DIM+M+PL
ultimatinho	ultimato+N+DIM+M+SG
ultimatinhos	ultimato+N+DIM+M+PL
ultimato	ultimato+N+M+SG
ultimatos	ultimato+N+M+PL
ultimatozinho	ultimato+N+DIM+M+SG
ultimatozinhos	ultimato+N+DIM+M+PL
ultimatum	ultimatum+N+M+SG
ultimatuns	ultimatum+N+M+PL
ultimatunzinho	ultimatum+N+DIM+M+SG
ultimatunzinhos	ultimatum+N+DIM+M+PL
ultimação	ultimação+N+F+SG
ultimaçãozinha	ultimação+N+DIM+F+SG
ultimações	ultimação+N+F+PL
ultimaçõezinhas	ultimação+N+DIM+F+PL
ultimogenitazinha	ultimogénito+N+DIM+F+SG
ultimogenitazinhas	ultimogénito+N+DIM+F+PL
ultimogenitinha	ultimogénito+N+DIM+F+SG
ultimogenitinhas	ultimogénito+N+DIM+F+PL
ultimogenitinho	ultimogénito+N+DIM+M+SG
ultimogenitinhos	ultimogénito+N+DIM+M+PL
ultimogenitozinho	ultimogénito+N+DIM+M+SG
ultimogenitozinhos	ultimogénito+N+DIM+M+PL
ultimogénita	ultimogénito+N+F+SG
ultimogénitas	ultimogénito+N+F+PL
ultimogénito	ultimogénito+N+M+SG
ultimogénitos	ultimogénito+N+M+PL
ultimogenitinho	ultimogênito+N+DIM+SG
ultimogenitinhos	ultimogênito+N+DIM+PL
ultimogenitozinha	ultimogênito+N+DIM+F+SG
ultimogenitozinhas	ultimogênito+N+DIM+F+PL
ultimogenitozinho	ultimogênito+N+DIM+M+SG
ultimogenitozinhos	ultimogênito+N+DIM+M+PL
ultimogênito	ultimogênito+N+SG
ultimogênitos	ultimogênito+N+PL
ultor	ultor+N+M+SG
ultora	ultor+N+F+SG
ultoras	ultor+N+F+PL
ultorazinha	ultor+N+DIM+F+SG
ultorazinhas	ultor+N+DIM+F+PL
ultores	ultor+N+M+PL
ultorezinhos	ultor+N+DIM+M+PL
ultorinha	ultor+N+DIM+F+SG
ultorinhas	ultor+N+DIM+F+PL
ultorzinho	ultor+N+DIM+M+SG
ultorzinhos	ultor+N+DIM+M+PL
ultra	ultra+N+SG
ultras	ultra+N+PL
ultrazinha	ultra+N+DIM+F+SG
ultrazinhas	ultra+N+DIM+F+PL
ultrazinho	ultra+N+DIM+M+SG
ultrazinhos	ultra+N+DIM+M+PL
ultrinha	ultra+N+DIM+SG
ultrinhas	ultra+N+DIM+PL
ultrabasicidade	ultrabasicidade+N+F+SG
ultrabasicidades	ultrabasicidade+N+F+PL
ultrabasicidadezinha	ultrabasicidade+N+DIM+F+SG
ultrabasicidadezinhas	ultrabasicidade+N+DIM+F+PL
ultrabasicidadinha	ultrabasicidade+N+DIM+F+SG
ultrabasicidadinhas	ultrabasicidade+N+DIM+F+PL
ultracentrifugabilidade	ultracentrifugabilidade+N+F+SG
ultracentrifugabilidades	ultracentrifugabilidade+N+F+PL
ultracentrifugabilidadezinha	ultracentrifugabilidade+N+DIM+F+SG
ultracentrifugabilidadezinhas	ultracentrifugabilidade+N+DIM+F+PL
ultracentrifugabilidadinha	ultracentrifugabilidade+N+DIM+F+SG
ultracentrifugabilidadinhas	ultracentrifugabilidade+N+DIM+F+PL
ultracentrifugação	ultracentrifugação+N+F+SG
ultracentrifugaçãozinha	ultracentrifugação+N+DIM+F+SG
ultracentrifugações	ultracentrifugação+N+F+PL
ultracentrifugaçõezinhas	ultracentrifugação+N+DIM+F+PL
ultracongelação	ultracongelação+N+F+SG
ultracongelaçãozinha	ultracongelação+N+DIM+F+SG
ultracongelações	ultracongelação+N+F+PL
ultracongelaçõezinhas	ultracongelação+N+DIM+F+PL
ultraconservador	ultraconservador+N+M+SG
ultraconservadora	ultraconservador+N+F+SG
ultraconservadoras	ultraconservador+N+F+PL
ultraconservadorazinha	ultraconservador+N+DIM+F+SG
ultraconservadorazinhas	ultraconservador+N+DIM+F+PL
ultraconservadores	ultraconservador+N+M+PL
ultraconservadorezinhos	ultraconservador+N+DIM+M+PL
ultraconservadorinha	ultraconservador+N+DIM+F+SG
ultraconservadorinhas	ultraconservador+N+DIM+F+PL
ultraconservadorzinho	ultraconservador+N+DIM+M+SG
ultraconservadorzinhos	ultraconservador+N+DIM+M+PL
ultracorrecção	ultracorrecção+N+F+SG
ultracorrecçãozinha	ultracorrecção+N+DIM+F+SG
ultracorrecções	ultracorrecção+N+F+PL
ultracorrecçõezinhas	ultracorrecção+N+DIM+F+PL
ultracorreção	ultracorreção+N+F+SG
ultracorreçãozinha	ultracorreção+N+DIM+F+SG
ultracorreções	ultracorreção+N+F+PL
ultracorreçõezinhas	ultracorreção+N+DIM+F+PL
ultrademocraticidade	ultrademocraticidade+N+F+SG
ultrademocraticidades	ultrademocraticidade+N+F+PL
ultrademocraticidadezinha	ultrademocraticidade+N+DIM+F+SG
ultrademocraticidadezinhas	ultrademocraticidade+N+DIM+F+PL
ultrademocraticidadinha	ultrademocraticidade+N+DIM+F+SG
ultrademocraticidadinhas	ultrademocraticidade+N+DIM+F+PL
ultraeconomicidade	ultraeconomicidade+N+F+SG
ultraeconomicidades	ultraeconomicidade+N+F+PL
ultraeconomicidadezinha	ultraeconomicidade+N+DIM+F+SG
ultraeconomicidadezinhas	ultraeconomicidade+N+DIM+F+PL
ultraeconomicidadinha	ultraeconomicidade+N+DIM+F+SG
ultraeconomicidadinhas	ultraeconomicidade+N+DIM+F+PL
ultraestratosfericidade	ultraestratosfericidade+N+F+SG
ultraestratosfericidades	ultraestratosfericidade+N+F+PL
ultraestratosfericidadezinha	ultraestratosfericidade+N+DIM+F+SG
ultraestratosfericidadezinhas	ultraestratosfericidade+N+DIM+F+PL
ultraestratosfericidadinha	ultraestratosfericidade+N+DIM+F+SG
ultraestratosfericidadinhas	ultraestratosfericidade+N+DIM+F+PL
ultraestrutura	ultraestrutura+N+F+SG
ultraestruturas	ultraestrutura+N+F+PL
ultraestruturazinha	ultraestrutura+N+DIM+F+SG
ultraestruturazinhas	ultraestrutura+N+DIM+F+PL
ultraestruturinha	ultraestrutura+N+DIM+F+SG
ultraestruturinhas	ultraestrutura+N+DIM+F+PL
ultraestruturabilidade	ultraestruturabilidade+N+F+SG
ultraestruturabilidades	ultraestruturabilidade+N+F+PL
ultraestruturabilidadezinha	ultraestruturabilidade+N+DIM+F+SG
ultraestruturabilidadezinhas	ultraestruturabilidade+N+DIM+F+PL
ultraestruturabilidadinha	ultraestruturabilidade+N+DIM+F+SG
ultraestruturabilidadinhas	ultraestruturabilidade+N+DIM+F+PL
ultraestruturalidade	ultraestruturalidade+N+F+SG
ultraestruturalidades	ultraestruturalidade+N+F+PL
ultraestruturalidadezinha	ultraestruturalidade+N+DIM+F+SG
ultraestruturalidadezinhas	ultraestruturalidade+N+DIM+F+PL
ultraestruturalidadinha	ultraestruturalidade+N+DIM+F+SG
ultraestruturalidadinhas	ultraestruturalidade+N+DIM+F+PL
ultraestruturação	ultraestruturação+N+F+SG
ultraestruturaçãozinha	ultraestruturação+N+DIM+F+SG
ultraestruturações	ultraestruturação+N+F+PL
ultraestruturaçõezinhas	ultraestruturação+N+DIM+F+PL
ultraetimologicidade	ultraetimologicidade+N+F+SG
ultraetimologicidades	ultraetimologicidade+N+F+PL
ultraetimologicidadezinha	ultraetimologicidade+N+DIM+F+SG
ultraetimologicidadezinhas	ultraetimologicidade+N+DIM+F+PL
ultraetimologicidadinha	ultraetimologicidade+N+DIM+F+SG
ultraetimologicidadinhas	ultraetimologicidade+N+DIM+F+PL
ultraexistenciazinha	ultraexistência+N+DIM+F+SG
ultraexistenciazinhas	ultraexistência+N+DIM+F+PL
ultraexistencinha	ultraexistência+N+DIM+F+SG
ultraexistencinhas	ultraexistência+N+DIM+F+PL
ultraexistência	ultraexistência+N+F+SG
ultraexistências	ultraexistência+N+F+PL
ultrafantasticidade	ultrafantasticidade+N+F+SG
ultrafantasticidades	ultrafantasticidade+N+F+PL
ultrafantasticidadezinha	ultrafantasticidade+N+DIM+F+SG
ultrafantasticidadezinhas	ultrafantasticidade+N+DIM+F+PL
ultrafantasticidadinha	ultrafantasticidade+N+DIM+F+SG
ultrafantasticidadinhas	ultrafantasticidade+N+DIM+F+PL
ultrafiltração	ultrafiltração+N+F+SG
ultrafiltraçãozinha	ultrafiltração+N+DIM+F+SG
ultrafiltrações	ultrafiltração+N+F+PL
ultrafiltraçõezinhas	ultrafiltração+N+DIM+F+PL
ultrainfernalidade	ultrainfernalidade+N+F+SG
ultrainfernalidades	ultrainfernalidade+N+F+PL
ultrainfernalidadezinha	ultrainfernalidade+N+DIM+F+SG
ultrainfernalidadezinhas	ultrainfernalidade+N+DIM+F+PL
ultrainfernalidadinha	ultrainfernalidade+N+DIM+F+SG
ultrainfernalidadinhas	ultrainfernalidade+N+DIM+F+PL
ultrajabilidade	ultrajabilidade+N+F+SG
ultrajabilidades	ultrajabilidade+N+F+PL
ultrajabilidadezinha	ultrajabilidade+N+DIM+F+SG
ultrajabilidadezinhas	ultrajabilidade+N+DIM+F+PL
ultrajabilidadinha	ultrajabilidade+N+DIM+F+SG
ultrajabilidadinhas	ultrajabilidade+N+DIM+F+PL
ultrajador	ultrajador+N+M+SG
ultrajadora	ultrajador+N+F+SG
ultrajadoras	ultrajador+N+F+PL
ultrajadorazinha	ultrajador+N+DIM+F+SG
ultrajadorazinhas	ultrajador+N+DIM+F+PL
ultrajadores	ultrajador+N+M+PL
ultrajadorezinhos	ultrajador+N+DIM+M+PL
ultrajadorinha	ultrajador+N+DIM+F+SG
ultrajadorinhas	ultrajador+N+DIM+F+PL
ultrajadorzinho	ultrajador+N+DIM+M+SG
ultrajadorzinhos	ultrajador+N+DIM+M+PL
ultraje	ultraje+N+M+SG
ultrajes	ultraje+N+M+PL
ultrajezinho	ultraje+N+DIM+M+SG
ultrajezinhos	ultraje+N+DIM+M+PL
ultrajinho	ultraje+N+DIM+M+SG
ultrajinhos	ultraje+N+DIM+M+PL
ultrajosidade	ultrajosidade+N+F+SG
ultrajosidades	ultrajosidade+N+F+PL
ultrajosidadezinha	ultrajosidade+N+DIM+F+SG
ultrajosidadezinhas	ultrajosidade+N+DIM+F+PL
ultrajosidadinha	ultrajosidade+N+DIM+F+SG
ultrajosidadinhas	ultrajosidade+N+DIM+F+PL
ultraliberalidade	ultraliberalidade+N+F+SG
ultraliberalidades	ultraliberalidade+N+F+PL
ultraliberalidadezinha	ultraliberalidade+N+DIM+F+SG
ultraliberalidadezinhas	ultraliberalidade+N+DIM+F+PL
ultraliberalidadinha	ultraliberalidade+N+DIM+F+SG
ultraliberalidadinhas	ultraliberalidade+N+DIM+F+PL
ultraliberalisminho	ultraliberalismo+N+DIM+M+SG
ultraliberalisminhos	ultraliberalismo+N+DIM+M+PL
ultraliberalismo	ultraliberalismo+N+M+SG
ultraliberalismos	ultraliberalismo+N+M+PL
ultraliberalismozinho	ultraliberalismo+N+DIM+M+SG
ultraliberalismozinhos	ultraliberalismo+N+DIM+M+PL
ultramabilidade	ultramabilidade+N+F+SG
ultramabilidades	ultramabilidade+N+F+PL
ultramabilidadezinha	ultramabilidade+N+DIM+F+SG
ultramabilidadezinhas	ultramabilidade+N+DIM+F+PL
ultramabilidadinha	ultramabilidade+N+DIM+F+SG
ultramabilidadinhas	ultramabilidade+N+DIM+F+PL
ultramar	ultramar+N+M+SG
ultramares	ultramar+N+M+PL
ultramarezinhos	ultramar+N+DIM+M+PL
ultramarzinho	ultramar+N+DIM+M+SG
ultramarzinhos	ultramar+N+DIM+M+PL
ultramicroscopia	ultramicroscopia+N+F+SG
ultramicroscopias	ultramicroscopia+N+F+PL
ultramicroscopiazinha	ultramicroscopia+N+DIM+F+SG
ultramicroscopiazinhas	ultramicroscopia+N+DIM+F+PL
ultramicroscopinha	ultramicroscopia+N+DIM+F+SG
ultramicroscopinhas	ultramicroscopia+N+DIM+F+PL
ultramicroscopicidade	ultramicroscopicidade+N+F+SG
ultramicroscopicidades	ultramicroscopicidade+N+F+PL
ultramicroscopicidadezinha	ultramicroscopicidade+N+DIM+F+SG
ultramicroscopicidadezinhas	ultramicroscopicidade+N+DIM+F+PL
ultramicroscopicidadinha	ultramicroscopicidade+N+DIM+F+SG
ultramicroscopicidadinhas	ultramicroscopicidade+N+DIM+F+PL
ultramicroscopinho	ultramicroscópio+N+DIM+M+SG
ultramicroscopinhos	ultramicroscópio+N+DIM+M+PL
ultramicroscopiozinho	ultramicroscópio+N+DIM+M+SG
ultramicroscopiozinhos	ultramicroscópio+N+DIM+M+PL
ultramicroscópio	ultramicroscópio+N+M+SG
ultramicroscópios	ultramicroscópio+N+M+PL
ultramontanisminho	ultramontanismo+N+DIM+M+SG
ultramontanisminhos	ultramontanismo+N+DIM+M+PL
ultramontanismo	ultramontanismo+N+M+SG
ultramontanismos	ultramontanismo+N+M+PL
ultramontanismozinho	ultramontanismo+N+DIM+M+SG
ultramontanismozinhos	ultramontanismo+N+DIM+M+PL
ultramontana	ultramontano+N+F+SG
ultramontanas	ultramontano+N+F+PL
ultramontanazinha	ultramontano+N+DIM+F+SG
ultramontanazinhas	ultramontano+N+DIM+F+PL
ultramontaninha	ultramontano+N+DIM+F+SG
ultramontaninhas	ultramontano+N+DIM+F+PL
ultramontaninho	ultramontano+N+DIM+M+SG
ultramontaninhos	ultramontano+N+DIM+M+PL
ultramontano	ultramontano+N+M+SG
ultramontanos	ultramontano+N+M+PL
ultramontanozinho	ultramontano+N+DIM+M+SG
ultramontanozinhos	ultramontano+N+DIM+M+PL
ultranacionalisminho	ultranacionalismo+N+DIM+M+SG
ultranacionalisminhos	ultranacionalismo+N+DIM+M+PL
ultranacionalismo	ultranacionalismo+N+M+SG
ultranacionalismos	ultranacionalismo+N+M+PL
ultranacionalismozinho	ultranacionalismo+N+DIM+M+SG
ultranacionalismozinhos	ultranacionalismo+N+DIM+M+PL
ultranacionalista	ultranacionalista+N+SG
ultranacionalistas	ultranacionalista+N+PL
ultranacionalistazinha	ultranacionalista+N+DIM+F+SG
ultranacionalistazinhas	ultranacionalista+N+DIM+F+PL
ultranacionalistazinho	ultranacionalista+N+DIM+M+SG
ultranacionalistazinhos	ultranacionalista+N+DIM+M+PL
ultranacionalistinha	ultranacionalista+N+DIM+SG
ultranacionalistinhas	ultranacionalista+N+DIM+PL
ultranaturalidade	ultranaturalidade+N+F+SG
ultranaturalidades	ultranaturalidade+N+F+PL
ultranaturalidadezinha	ultranaturalidade+N+DIM+F+SG
ultranaturalidadezinhas	ultranaturalidade+N+DIM+F+PL
ultranaturalidadinha	ultranaturalidade+N+DIM+F+SG
ultranaturalidadinhas	ultranaturalidade+N+DIM+F+PL
ultraoceanicidade	ultraoceanicidade+N+F+SG
ultraoceanicidades	ultraoceanicidade+N+F+PL
ultraoceanicidadezinha	ultraoceanicidade+N+DIM+F+SG
ultraoceanicidadezinhas	ultraoceanicidade+N+DIM+F+PL
ultraoceanicidadinha	ultraoceanicidade+N+DIM+F+SG
ultraoceanicidadinhas	ultraoceanicidade+N+DIM+F+PL
ultraorientalidade	ultraorientalidade+N+F+SG
ultraorientalidades	ultraorientalidade+N+F+PL
ultraorientalidadezinha	ultraorientalidade+N+DIM+F+SG
ultraorientalidadezinhas	ultraorientalidade+N+DIM+F+PL
ultraorientalidadinha	ultraorientalidade+N+DIM+F+SG
ultraorientalidadinhas	ultraorientalidade+N+DIM+F+PL
ultrapassabilidade	ultrapassabilidade+N+F+SG
ultrapassabilidades	ultrapassabilidade+N+F+PL
ultrapassabilidadezinha	ultrapassabilidade+N+DIM+F+SG
ultrapassabilidadezinhas	ultrapassabilidade+N+DIM+F+PL
ultrapassabilidadinha	ultrapassabilidade+N+DIM+F+SG
ultrapassabilidadinhas	ultrapassabilidade+N+DIM+F+PL
ultrapassada	ultrapassado+N+F+SG
ultrapassadas	ultrapassado+N+F+PL
ultrapassadazinha	ultrapassado+N+DIM+F+SG
ultrapassadazinhas	ultrapassado+N+DIM+F+PL
ultrapassadinha	ultrapassado+N+DIM+F+SG
ultrapassadinhas	ultrapassado+N+DIM+F+PL
ultrapassadinho	ultrapassado+N+DIM+M+SG
ultrapassadinhos	ultrapassado+N+DIM+M+PL
ultrapassado	ultrapassado+N+M+SG
ultrapassados	ultrapassado+N+M+PL
ultrapassadozinho	ultrapassado+N+DIM+M+SG
ultrapassadozinhos	ultrapassado+N+DIM+M+PL
ultrapassagem	ultrapassagem+N+F+SG
ultrapassagens	ultrapassagem+N+F+PL
ultrapassagenzinha	ultrapassagem+N+DIM+F+SG
ultrapassagenzinhas	ultrapassagem+N+DIM+F+PL
ultrapassaveizinhas	ultrapassável+N+DIM+F+PL
ultrapassaveizinhos	ultrapassável+N+DIM+M+PL
ultrapassavelzinha	ultrapassável+N+DIM+F+SG
ultrapassavelzinho	ultrapassável+N+DIM+M+SG
ultrapassáveis	ultrapassável+N+PL
ultrapassável	ultrapassável+N+SG
ultraperifericidade	ultraperifericidade+N+F+SG
ultraperifericidades	ultraperifericidade+N+F+PL
ultraperifericidadezinha	ultraperifericidade+N+DIM+F+SG
ultraperifericidadezinhas	ultraperifericidade+N+DIM+F+PL
ultraperifericidadinha	ultraperifericidade+N+DIM+F+SG
ultraperifericidadinhas	ultraperifericidade+N+DIM+F+PL
ultrapressão	ultrapressão+N+F+SG
ultrapressãozinha	ultrapressão+N+DIM+F+SG
ultrapressões	ultrapressão+N+F+PL
ultrapressõezinhas	ultrapressão+N+DIM+F+PL
ultrarracionalidade	ultrarracionalidade+N+F+SG
ultrarracionalidades	ultrarracionalidade+N+F+PL
ultrarracionalidadezinha	ultrarracionalidade+N+DIM+F+SG
ultrarracionalidadezinhas	ultrarracionalidade+N+DIM+F+PL
ultrarracionalidadinha	ultrarracionalidade+N+DIM+F+SG
ultrarracionalidadinhas	ultrarracionalidade+N+DIM+F+PL
ultrarracionalisminho	ultrarracionalismo+N+DIM+M+SG
ultrarracionalisminhos	ultrarracionalismo+N+DIM+M+PL
ultrarracionalismo	ultrarracionalismo+N+M+SG
ultrarracionalismos	ultrarracionalismo+N+M+PL
ultrarracionalismozinho	ultrarracionalismo+N+DIM+M+SG
ultrarracionalismozinhos	ultrarracionalismo+N+DIM+M+PL
ultrarradicalidade	ultrarradicalidade+N+F+SG
ultrarradicalidades	ultrarradicalidade+N+F+PL
ultrarradicalidadezinha	ultrarradicalidade+N+DIM+F+SG
ultrarradicalidadezinhas	ultrarradicalidade+N+DIM+F+PL
ultrarradicalidadinha	ultrarradicalidade+N+DIM+F+SG
ultrarradicalidadinhas	ultrarradicalidade+N+DIM+F+PL
ultrarradicalisminho	ultrarradicalismo+N+DIM+M+SG
ultrarradicalisminhos	ultrarradicalismo+N+DIM+M+PL
ultrarradicalismo	ultrarradicalismo+N+M+SG
ultrarradicalismos	ultrarradicalismo+N+M+PL
ultrarradicalismozinho	ultrarradicalismo+N+DIM+M+SG
ultrarradicalismozinhos	ultrarradicalismo+N+DIM+M+PL
ultrarreacionariazinha	ultrarreacionária+N+DIM+F+SG
ultrarreacionariazinhas	ultrarreacionária+N+DIM+F+PL
ultrarreacionarinha	ultrarreacionária+N+DIM+F+SG
ultrarreacionarinhas	ultrarreacionária+N+DIM+F+PL
ultrarreacionária	ultrarreacionária+N+F+SG
ultrarreacionárias	ultrarreacionária+N+F+PL
ultrarreacionarinho	ultrarreacionário+N+DIM+M+SG
ultrarreacionarinhos	ultrarreacionário+N+DIM+M+PL
ultrarreacionariozinho	ultrarreacionário+N+DIM+M+SG
ultrarreacionariozinhos	ultrarreacionário+N+DIM+M+PL
ultrarreacionário	ultrarreacionário+N+M+SG
ultrarreacionários	ultrarreacionário+N+M+PL
ultrarrealisminho	ultrarrealismo+N+DIM+M+SG
ultrarrealisminhos	ultrarrealismo+N+DIM+M+PL
ultrarrealismo	ultrarrealismo+N+M+SG
ultrarrealismos	ultrarrealismo+N+M+PL
ultrarrealismozinho	ultrarrealismo+N+DIM+M+SG
ultrarrealismozinhos	ultrarrealismo+N+DIM+M+PL
ultrarrealista	ultrarrealista+N+SG
ultrarrealistas	ultrarrealista+N+PL
ultrarrealistazinha	ultrarrealista+N+DIM+F+SG
ultrarrealistazinhas	ultrarrealista+N+DIM+F+PL
ultrarrealistazinho	ultrarrealista+N+DIM+M+SG
ultrarrealistazinhos	ultrarrealista+N+DIM+M+PL
ultrarrealistinha	ultrarrealista+N+DIM+SG
ultrarrealistinhas	ultrarrealista+N+DIM+PL
ultrarreação	ultrarreação+N+F+SG
ultrarreaçãozinha	ultrarreação+N+DIM+F+SG
ultrarreações	ultrarreação+N+F+PL
ultrarreaçõezinhas	ultrarreação+N+DIM+F+PL
ultrarreforma	ultrarreforma+N+F+SG
ultrarreformas	ultrarreforma+N+F+PL
ultrarreformazinha	ultrarreforma+N+DIM+F+SG
ultrarreformazinhas	ultrarreforma+N+DIM+F+PL
ultrarreforminha	ultrarreforma+N+DIM+F+SG
ultrarreforminhas	ultrarreforma+N+DIM+F+PL
ultrarregionalidade	ultrarregionalidade+N+F+SG
ultrarregionalidades	ultrarregionalidade+N+F+PL
ultrarregionalidadezinha	ultrarregionalidade+N+DIM+F+SG
ultrarregionalidadezinhas	ultrarregionalidade+N+DIM+F+PL
ultrarregionalidadinha	ultrarregionalidade+N+DIM+F+SG
ultrarregionalidadinhas	ultrarregionalidade+N+DIM+F+PL
ultrarrepublicanisminho	ultrarrepublicanismo+N+DIM+M+SG
ultrarrepublicanisminhos	ultrarrepublicanismo+N+DIM+M+PL
ultrarrepublicanismo	ultrarrepublicanismo+N+M+SG
ultrarrepublicanismos	ultrarrepublicanismo+N+M+PL
ultrarrepublicanismozinho	ultrarrepublicanismo+N+DIM+M+SG
ultrarrepublicanismozinhos	ultrarrepublicanismo+N+DIM+M+PL
ultrarrevolucionariazinha	ultrarrevolucionária+N+DIM+F+SG
ultrarrevolucionariazinhas	ultrarrevolucionária+N+DIM+F+PL
ultrarrevolucionarinha	ultrarrevolucionária+N+DIM+F+SG
ultrarrevolucionarinhas	ultrarrevolucionária+N+DIM+F+PL
ultrarrevolucionária	ultrarrevolucionária+N+F+SG
ultrarrevolucionárias	ultrarrevolucionária+N+F+PL
ultrarrevolucionarinho	ultrarrevolucionário+N+DIM+M+SG
ultrarrevolucionarinhos	ultrarrevolucionário+N+DIM+M+PL
ultrarrevolucionariozinho	ultrarrevolucionário+N+DIM+M+SG
ultrarrevolucionariozinhos	ultrarrevolucionário+N+DIM+M+PL
ultrarrevolucionário	ultrarrevolucionário+N+M+SG
ultrarrevolucionários	ultrarrevolucionário+N+M+PL
ultrarrigorosidade	ultrarrigorosidade+N+F+SG
ultrarrigorosidades	ultrarrigorosidade+N+F+PL
ultrarrigorosidadezinha	ultrarrigorosidade+N+DIM+F+SG
ultrarrigorosidadezinhas	ultrarrigorosidade+N+DIM+F+PL
ultrarrigorosidadinha	ultrarrigorosidade+N+DIM+F+SG
ultrarrigorosidadinhas	ultrarrigorosidade+N+DIM+F+PL
ultrarromanticidade	ultrarromanticidade+N+F+SG
ultrarromanticidades	ultrarromanticidade+N+F+PL
ultrarromanticidadezinha	ultrarromanticidade+N+DIM+F+SG
ultrarromanticidadezinhas	ultrarromanticidade+N+DIM+F+PL
ultrarromanticidadinha	ultrarromanticidade+N+DIM+F+SG
ultrarromanticidadinhas	ultrarromanticidade+N+DIM+F+PL
ultrarromantisminho	ultrarromantismo+N+DIM+M+SG
ultrarromantisminhos	ultrarromantismo+N+DIM+M+PL
ultrarromantismo	ultrarromantismo+N+M+SG
ultrarromantismos	ultrarromantismo+N+M+PL
ultrarromantismozinho	ultrarromantismo+N+DIM+M+SG
ultrarromantismozinhos	ultrarromantismo+N+DIM+M+PL
ultrarromanticazinha	ultrarromântica+N+DIM+F+SG
ultrarromanticazinhas	ultrarromântica+N+DIM+F+PL
ultrarromantiquinha	ultrarromântica+N+DIM+F+SG
ultrarromantiquinhas	ultrarromântica+N+DIM+F+PL
ultrarromântica	ultrarromântica+N+F+SG
ultrarromânticas	ultrarromântica+N+F+PL
ultrarromanticozinho	ultrarromântico+N+DIM+M+SG
ultrarromanticozinhos	ultrarromântico+N+DIM+M+PL
ultrarromantiquinho	ultrarromântico+N+DIM+M+SG
ultrarromantiquinhos	ultrarromântico+N+DIM+M+PL
ultrarromântico	ultrarromântico+N+M+SG
ultrarromânticos	ultrarromântico+N+M+PL
ultras	ultras+N+M+PL
ultrasinhas	ultras+N+DIM+F+PL
ultrasinhos	ultras+N+DIM+M+PL
ultrassecularidade	ultrassecularidade+N+F+SG
ultrassecularidades	ultrassecularidade+N+F+PL
ultrassecularidadezinha	ultrassecularidade+N+DIM+F+SG
ultrassecularidadezinhas	ultrassecularidade+N+DIM+F+PL
ultrassecularidadinha	ultrassecularidade+N+DIM+F+SG
ultrassecularidadinhas	ultrassecularidade+N+DIM+F+PL
ultrassemicircularidade	ultrassemicircularidade+N+F+SG
ultrassemicircularidades	ultrassemicircularidade+N+F+PL
ultrassemicircularidadezinha	ultrassemicircularidade+N+DIM+F+SG
ultrassemicircularidadezinhas	ultrassemicircularidade+N+DIM+F+PL
ultrassemicircularidadinha	ultrassemicircularidade+N+DIM+F+SG
ultrassemicircularidadinhas	ultrassemicircularidade+N+DIM+F+PL
ultrassolaridade	ultrassolaridade+N+F+SG
ultrassolaridades	ultrassolaridade+N+F+PL
ultrassolaridadezinha	ultrassolaridade+N+DIM+F+SG
ultrassolaridadezinhas	ultrassolaridade+N+DIM+F+PL
ultrassolaridadinha	ultrassolaridade+N+DIM+F+SG
ultrassolaridadinhas	ultrassolaridade+N+DIM+F+PL
ultrassom	ultrassom+N+M+SG
ultrassons	ultrassom+N+M+PL
ultrassonzinho	ultrassom+N+DIM+M+SG
ultrassonzinhos	ultrassom+N+DIM+M+PL
ultrassonicidade	ultrassonicidade+N+F+SG
ultrassonicidades	ultrassonicidade+N+F+PL
ultrassonicidadezinha	ultrassonicidade+N+DIM+F+SG
ultrassonicidadezinhas	ultrassonicidade+N+DIM+F+PL
ultrassonicidadinha	ultrassonicidade+N+DIM+F+SG
ultrassonicidadinhas	ultrassonicidade+N+DIM+F+PL
ultrassonografia	ultrassonografia+N+F+SG
ultrassonografias	ultrassonografia+N+F+PL
ultrassonografiazinha	ultrassonografia+N+DIM+F+SG
ultrassonografiazinhas	ultrassonografia+N+DIM+F+PL
ultrassonografinha	ultrassonografia+N+DIM+F+SG
ultrassonografinhas	ultrassonografia+N+DIM+F+PL
ultrassonograficidade	ultrassonograficidade+N+F+SG
ultrassonograficidades	ultrassonograficidade+N+F+PL
ultrassonograficidadezinha	ultrassonograficidade+N+DIM+F+SG
ultrassonograficidadezinhas	ultrassonograficidade+N+DIM+F+PL
ultrassonograficidadinha	ultrassonograficidade+N+DIM+F+SG
ultrassonograficidadinhas	ultrassonograficidade+N+DIM+F+PL
ultrassonoterapia	ultrassonoterapia+N+F+SG
ultrassonoterapias	ultrassonoterapia+N+F+PL
ultrassonoterapiazinha	ultrassonoterapia+N+DIM+F+SG
ultrassonoterapiazinhas	ultrassonoterapia+N+DIM+F+PL
ultrassonoterapinha	ultrassonoterapia+N+DIM+F+SG
ultrassonoterapinhas	ultrassonoterapia+N+DIM+F+PL
ultrassonoterapicidade	ultrassonoterapicidade+N+F+SG
ultrassonoterapicidades	ultrassonoterapicidade+N+F+PL
ultrassonoterapicidadezinha	ultrassonoterapicidade+N+DIM+F+SG
ultrassonoterapicidadezinhas	ultrassonoterapicidade+N+DIM+F+PL
ultrassonoterapicidadinha	ultrassonoterapicidade+N+DIM+F+SG
ultrassonoterapicidadinhas	ultrassonoterapicidade+N+DIM+F+PL
ultrassonografinho	ultrassonógrafo+N+DIM+M+SG
ultrassonografinhos	ultrassonógrafo+N+DIM+M+PL
ultrassonografozinho	ultrassonógrafo+N+DIM+M+SG
ultrassonografozinhos	ultrassonógrafo+N+DIM+M+PL
ultrassonógrafo	ultrassonógrafo+N+M+SG
ultrassonógrafos	ultrassonógrafo+N+M+PL
ultravida	ultravida+N+F+SG
ultravidas	ultravida+N+F+PL
ultravidazinha	ultravida+N+DIM+F+SG
ultravidazinhas	ultravida+N+DIM+F+PL
ultravidinha	ultravida+N+DIM+F+SG
ultravidinhas	ultravida+N+DIM+F+PL
ultravioleta	ultravioleta+N+SG
ultravioletas	ultravioleta+N+PL
ultravioletazinha	ultravioleta+N+DIM+F+SG
ultravioletazinhas	ultravioleta+N+DIM+F+PL
ultravioletazinho	ultravioleta+N+DIM+M+SG
ultravioletazinhos	ultravioleta+N+DIM+M+PL
ultravioletinha	ultravioleta+N+DIM+SG
ultravioletinhas	ultravioleta+N+DIM+PL
ultraviolenciazinha	ultraviolência+N+DIM+F+SG
ultraviolenciazinhas	ultraviolência+N+DIM+F+PL
ultraviolencinha	ultraviolência+N+DIM+F+SG
ultraviolencinhas	ultraviolência+N+DIM+F+PL
ultraviolência	ultraviolência+N+F+SG
ultraviolências	ultraviolência+N+F+PL
ultravirozinhos	ultravírus+N+DIM+M+PL
ultravirusinho	ultravírus+N+DIM+M+SG
ultravíros	ultravírus+N+M+PL
ultravírus	ultravírus+N+M+SG
ultrazodiacalidade	ultrazodiacalidade+N+F+SG
ultrazodiacalidades	ultrazodiacalidade+N+F+PL
ultrazodiacalidadezinha	ultrazodiacalidade+N+DIM+F+SG
ultrazodiacalidadezinhas	ultrazodiacalidade+N+DIM+F+PL
ultrazodiacalidadinha	ultrazodiacalidade+N+DIM+F+SG
ultrazodiacalidadinhas	ultrazodiacalidade+N+DIM+F+PL
ultrice	ultrice+N+F+SG
ultrices	ultrice+N+F+PL
ultricezinha	ultrice+N+DIM+F+SG
ultricezinhas	ultrice+N+DIM+F+PL
ultricinha	ultrice+N+DIM+F+SG
ultricinhas	ultrice+N+DIM+F+PL
ultriz	ultriz+N+F+SG
ultrizinha	ultriz+N+DIM+F+SG
ultrizinhas	ultriz+N+DIM+F+PL
ultrizs	ultriz+N+F+PL
ululabilidade	ululabilidade+N+F+SG
ululabilidades	ululabilidade+N+F+PL
ululabilidadezinha	ululabilidade+N+DIM+F+SG
ululabilidadezinhas	ululabilidade+N+DIM+F+PL
ululabilidadinha	ululabilidade+N+DIM+F+SG
ululabilidadinhas	ululabilidade+N+DIM+F+PL
ululador	ululador+N+M+SG
ululadora	ululador+N+F+SG
ululadoras	ululador+N+F+PL
ululadorazinha	ululador+N+DIM+F+SG
ululadorazinhas	ululador+N+DIM+F+PL
ululadores	ululador+N+M+PL
ululadorezinhos	ululador+N+DIM+M+PL
ululadorinha	ululador+N+DIM+F+SG
ululadorinhas	ululador+N+DIM+F+PL
ululadorzinho	ululador+N+DIM+M+SG
ululadorzinhos	ululador+N+DIM+M+PL
ulular	ulular+N+M+SG
ulularzinho	ulular+N+DIM+M+SG
ululatinho	ululato+N+DIM+M+SG
ululatinhos	ululato+N+DIM+M+PL
ululato	ululato+N+M+SG
ululatos	ululato+N+M+PL
ululatozinho	ululato+N+DIM+M+SG
ululatozinhos	ululato+N+DIM+M+PL
ululação	ululação+N+F+SG
ululaçãozinha	ululação+N+DIM+F+SG
ululações	ululação+N+F+PL
ululaçõezinhas	ululação+N+DIM+F+PL
ululinho	ululo+N+DIM+M+SG
ululinhos	ululo+N+DIM+M+PL
ululo	ululo+N+M+SG
ululos	ululo+N+M+PL
ululozinho	ululo+N+DIM+M+SG
ululozinhos	ululo+N+DIM+M+PL
ulvaceazinha	ulvácea+N+DIM+F+SG
ulvaceazinhas	ulvácea+N+DIM+F+PL
ulvaceinha	ulvácea+N+DIM+F+SG
ulvaceinhas	ulvácea+N+DIM+F+PL
ulvácea	ulvácea+N+F+SG
ulváceas	ulvácea+N+F+PL
ulotricazinha	ulótrico+N+DIM+F+SG
ulotricazinhas	ulótrico+N+DIM+F+PL
ulotricozinho	ulótrico+N+DIM+M+SG
ulotricozinhos	ulótrico+N+DIM+M+PL
ulotriquinha	ulótrico+N+DIM+F+SG
ulotriquinhas	ulótrico+N+DIM+F+PL
ulotriquinho	ulótrico+N+DIM+M+SG
ulotriquinhos	ulótrico+N+DIM+M+PL
ulótrica	ulótrico+N+F+SG
ulótricas	ulótrico+N+F+PL
ulótrico	ulótrico+N+M+SG
ulótricos	ulótrico+N+M+PL
um	um+N+M+SG
uma	um+N+F+SG
umazinha	um+N+DIM+F+SG
uminha	um+N+DIM+F+SG
uminhas	um+N+DIM+F+PL
uns	um+N+M+PL
unzinho	um+N+DIM+M+SG
unzinhos	um+N+DIM+M+PL
umari	umari+N+M+SG
umaris	umari+N+M+PL
umarizinho	umari+N+DIM+M+SG
umarizinhos	umari+N+DIM+M+PL
umação	umação+N+F+SG
umaçãozinha	umação+N+DIM+F+SG
umações	umação+N+F+PL
umaçõezinhas	umação+N+DIM+F+PL
umbala	umbala+N+F+SG
umbalas	umbala+N+F+PL
umbalazinha	umbala+N+DIM+F+SG
umbalazinhas	umbala+N+DIM+F+PL
umbalinha	umbala+N+DIM+F+SG
umbalinhas	umbala+N+DIM+F+PL
umbamba	umbamba+N+F+SG
umbambas	umbamba+N+F+PL
umbambazinha	umbamba+N+DIM+F+SG
umbambazinhas	umbamba+N+DIM+F+PL
umbambinha	umbamba+N+DIM+F+SG
umbambinhas	umbamba+N+DIM+F+PL
umbanda	umbanda+N+F+SG
umbandas	umbanda+N+F+PL
umbandazinha	umbanda+N+DIM+F+SG
umbandazinhas	umbanda+N+DIM+F+PL
umbandinha	umbanda+N+DIM+F+SG
umbandinhas	umbanda+N+DIM+F+PL
umbandista	umbandista+N+SG
umbandistas	umbandista+N+PL
umbandistazinha	umbandista+N+DIM+F+SG
umbandistazinhas	umbandista+N+DIM+F+PL
umbandistazinho	umbandista+N+DIM+M+SG
umbandistazinhos	umbandista+N+DIM+M+PL
umbandistinha	umbandista+N+DIM+SG
umbandistinhas	umbandista+N+DIM+PL
umbaubais	umbaubal+N+M+PL
umbaubaizinhos	umbaubal+N+DIM+M+PL
umbaubal	umbaubal+N+M+SG
umbaubalzinho	umbaubal+N+DIM+M+SG
umbaubazinha	umbaúba+N+DIM+F+SG
umbaubazinhas	umbaúba+N+DIM+F+PL
umbaubinha	umbaúba+N+DIM+F+SG
umbaubinhas	umbaúba+N+DIM+F+PL
umbaúba	umbaúba+N+F+SG
umbaúbas	umbaúba+N+F+PL
umbela	umbela+N+F+SG
umbelas	umbela+N+F+PL
umbelazinha	umbela+N+DIM+F+SG
umbelazinhas	umbela+N+DIM+F+PL
umbelinha	umbela+N+DIM+F+SG
umbelinhas	umbela+N+DIM+F+PL
umbeliflora	umbeliflora+N+F+SG
umbelifloras	umbeliflora+N+F+PL
umbeliflorazinha	umbeliflora+N+DIM+F+SG
umbeliflorazinhas	umbeliflora+N+DIM+F+PL
umbeliflorinha	umbeliflora+N+DIM+F+SG
umbeliflorinhas	umbeliflora+N+DIM+F+PL
umbeliferazinha	umbelífera+N+DIM+F+SG
umbeliferazinhas	umbelífera+N+DIM+F+PL
umbeliferinha	umbelífera+N+DIM+F+SG
umbeliferinhas	umbelífera+N+DIM+F+PL
umbelífera	umbelífera+N+F+SG
umbelíferas	umbelífera+N+F+PL
umbigada	umbigada+N+F+SG
umbigadas	umbigada+N+F+PL
umbigadazinha	umbigada+N+DIM+F+SG
umbigadazinhas	umbigada+N+DIM+F+PL
umbigadinha	umbigada+N+DIM+F+SG
umbigadinhas	umbigada+N+DIM+F+PL
umbigo	umbigo+N+M+SG
umbigos	umbigo+N+M+PL
umbigozinho	umbigo+N+DIM+M+SG
umbigozinhos	umbigo+N+DIM+M+PL
umbiguinho	umbigo+N+DIM+M+SG
umbiguinhos	umbigo+N+DIM+M+PL
umbigo-de-venusinho	umbigo-de-vénus+N+DIM+M+SG
umbigo-de-vénus	umbigo-de-vénus+N+M+SG
umbigos-de-venuzinhos	umbigo-de-vénus+N+DIM+M+PL
umbigos-de-vénus	umbigo-de-vénus+N+M+PL
umbigo-de-venusinho	umbigo-de-vênus+N+DIM+M+SG
umbigo-de-vênus	umbigo-de-vênus+N+M+SG
umbigos-de-venuzinhos	umbigo-de-vênus+N+DIM+M+PL
umbigos-de-vênus	umbigo-de-vênus+N+M+PL
umbigueira	umbigueira+N+F+SG
umbigueiras	umbigueira+N+F+PL
umbigueirazinha	umbigueira+N+DIM+F+SG
umbigueirazinhas	umbigueira+N+DIM+F+PL
umbigueirinha	umbigueira+N+DIM+F+SG
umbigueirinhas	umbigueira+N+DIM+F+PL
umbilicalidade	umbilicalidade+N+F+SG
umbilicalidades	umbilicalidade+N+F+PL
umbilicalidadezinha	umbilicalidade+N+DIM+F+SG
umbilicalidadezinhas	umbilicalidade+N+DIM+F+PL
umbilicalidadinha	umbilicalidade+N+DIM+F+SG
umbilicalidadinhas	umbilicalidade+N+DIM+F+PL
umbra	umbra+N+F+SG
umbras	umbra+N+F+PL
umbrazinha	umbra+N+DIM+F+SG
umbrazinhas	umbra+N+DIM+F+PL
umbrinha	umbra+N+DIM+F+SG
umbrinhas	umbra+N+DIM+F+PL
umbrais	umbral+N+M+PL
umbraizinhos	umbral+N+DIM+M+PL
umbral	umbral+N+M+SG
umbralzinho	umbral+N+DIM+M+SG
umbralicidade	umbralicidade+N+F+SG
umbralicidades	umbralicidade+N+F+PL
umbralicidadezinha	umbralicidade+N+DIM+F+SG
umbralicidadezinhas	umbralicidade+N+DIM+F+PL
umbralicidadinha	umbralicidade+N+DIM+F+SG
umbralicidadinhas	umbralicidade+N+DIM+F+PL
umbreira	umbreira+N+F+SG
umbreiras	umbreira+N+F+PL
umbreirazinha	umbreira+N+DIM+F+SG
umbreirazinhas	umbreira+N+DIM+F+PL
umbreirinha	umbreira+N+DIM+F+SG
umbreirinhas	umbreira+N+DIM+F+PL
umbrela	umbrela+N+F+SG
umbrelas	umbrela+N+F+PL
umbrelazinha	umbrela+N+DIM+F+SG
umbrelazinhas	umbrela+N+DIM+F+PL
umbrelinha	umbrela+N+DIM+F+SG
umbrelinhas	umbrela+N+DIM+F+PL
umbria	umbria+N+F+SG
umbrias	umbria+N+F+PL
umbriazinha	umbria+N+DIM+F+SG
umbriazinhas	umbria+N+DIM+F+PL
umbrinha	umbria+N+DIM+F+SG
umbrinhas	umbria+N+DIM+F+PL
umbricidade	umbricidade+N+F+SG
umbricidades	umbricidade+N+F+PL
umbricidadezinha	umbricidade+N+DIM+F+SG
umbricidadezinhas	umbricidade+N+DIM+F+PL
umbricidadinha	umbricidade+N+DIM+F+SG
umbricidadinhas	umbricidade+N+DIM+F+PL
umbrinho	umbro+N+DIM+M+SG
umbrinhos	umbro+N+DIM+M+PL
umbro	umbro+N+M+SG
umbros	umbro+N+M+PL
umbrozinho	umbro+N+DIM+M+SG
umbrozinhos	umbro+N+DIM+M+PL
umbrosidade	umbrosidade+N+F+SG
umbrosidades	umbrosidade+N+F+PL
umbrosidadezinha	umbrosidade+N+DIM+F+SG
umbrosidadezinhas	umbrosidade+N+DIM+F+PL
umbrosidadinha	umbrosidade+N+DIM+F+SG
umbrosidadinhas	umbrosidade+N+DIM+F+PL
umbraculinho	umbráculo+N+DIM+M+SG
umbraculinhos	umbráculo+N+DIM+M+PL
umbraculozinho	umbráculo+N+DIM+M+SG
umbraculozinhos	umbráculo+N+DIM+M+PL
umbráculo	umbráculo+N+M+SG
umbráculos	umbráculo+N+M+PL
umbu	umbu+N+M+SG
umbus	umbu+N+M+PL
umbuzinho	umbu+N+DIM+M+SG
umbuzinhos	umbu+N+DIM+M+PL
umburana	umburana+N+F+SG
umburanas	umburana+N+F+PL
umburanazinha	umburana+N+DIM+F+SG
umburanazinhas	umburana+N+DIM+F+PL
umburaninha	umburana+N+DIM+F+SG
umburaninhas	umburana+N+DIM+F+PL
umbuzada	umbuzada+N+F+SG
umbuzadas	umbuzada+N+F+PL
umbuzadazinha	umbuzada+N+DIM+F+SG
umbuzadazinhas	umbuzada+N+DIM+F+PL
umbuzadinha	umbuzada+N+DIM+F+SG
umbuzadinhas	umbuzada+N+DIM+F+PL
umbuzais	umbuzal+N+M+PL
umbuzaizinhos	umbuzal+N+DIM+M+PL
umbuzal	umbuzal+N+M+SG
umbuzalzinho	umbuzal+N+DIM+M+SG
umbuzeirinho	umbuzeiro+N+DIM+M+SG
umbuzeirinhos	umbuzeiro+N+DIM+M+PL
umbuzeiro	umbuzeiro+N+M+SG
umbuzeiros	umbuzeiro+N+M+PL
umbuzeirozinho	umbuzeiro+N+DIM+M+SG
umbuzeirozinhos	umbuzeiro+N+DIM+M+PL
umbelulazinha	umbélula+N+DIM+F+SG
umbelulazinhas	umbélula+N+DIM+F+PL
umbelulinha	umbélula+N+DIM+F+SG
umbelulinhas	umbélula+N+DIM+F+PL
umbélula	umbélula+N+F+SG
umbélulas	umbélula+N+F+PL
ume	ume+N+M+SG
umes	ume+N+M+PL
umezinho	ume+N+DIM+M+SG
umezinhos	ume+N+DIM+M+PL
uminho	ume+N+DIM+M+SG
uminhos	ume+N+DIM+M+PL
umectação	umectação+N+F+SG
umectaçãozinha	umectação+N+DIM+F+SG
umectações	umectação+N+F+PL
umectaçõezinhas	umectação+N+DIM+F+PL
umedecimentinho	umedecimento+N+DIM+M+SG
umedecimentinhos	umedecimento+N+DIM+M+PL
umedecimento	umedecimento+N+M+SG
umedecimentos	umedecimento+N+M+PL
umedecimentozinho	umedecimento+N+DIM+M+SG
umedecimentozinhos	umedecimento+N+DIM+M+PL
umeralidade	umeralidade+N+F+SG
umeralidades	umeralidade+N+F+PL
umeralidadezinha	umeralidade+N+DIM+F+SG
umeralidadezinhas	umeralidade+N+DIM+F+PL
umeralidadinha	umeralidade+N+DIM+F+SG
umeralidadinhas	umeralidade+N+DIM+F+PL
umidade	umidade+N+F+SG
umidades	umidade+N+F+PL
umidadezinha	umidade+N+DIM+F+SG
umidadezinhas	umidade+N+DIM+F+PL
umidadinha	umidade+N+DIM+F+SG
umidadinhas	umidade+N+DIM+F+PL
unanimidade	unanimidade+N+F+SG
unanimidades	unanimidade+N+F+PL
unanimidadezinha	unanimidade+N+DIM+F+SG
unanimidadezinhas	unanimidade+N+DIM+F+PL
unanimidadinha	unanimidade+N+DIM+F+SG
unanimidadinhas	unanimidade+N+DIM+F+PL
unanimisminho	unanimismo+N+DIM+M+SG
unanimisminhos	unanimismo+N+DIM+M+PL
unanimismo	unanimismo+N+M+SG
unanimismos	unanimismo+N+M+PL
unanimismozinho	unanimismo+N+DIM+M+SG
unanimismozinhos	unanimismo+N+DIM+M+PL
unanimista	unanimista+N+SG
unanimistas	unanimista+N+PL
unanimistazinha	unanimista+N+DIM+F+SG
unanimistazinhas	unanimista+N+DIM+F+PL
unanimistazinho	unanimista+N+DIM+M+SG
unanimistazinhos	unanimista+N+DIM+M+PL
unanimistinha	unanimista+N+DIM+SG
unanimistinhas	unanimista+N+DIM+PL
uncialidade	uncialidade+N+F+SG
uncialidades	uncialidade+N+F+PL
uncialidadezinha	uncialidade+N+DIM+F+SG
uncialidadezinhas	uncialidade+N+DIM+F+PL
uncialidadinha	uncialidade+N+DIM+F+SG
uncialidadinhas	uncialidade+N+DIM+F+PL
unciforme	unciforme+N+SG
unciformes	unciforme+N+PL
unciformezinha	unciforme+N+DIM+F+SG
unciformezinhas	unciforme+N+DIM+F+PL
unciformezinho	unciforme+N+DIM+M+SG
unciformezinhos	unciforme+N+DIM+M+PL
unciforminha	unciforme+N+DIM+F+SG
unciforminhas	unciforme+N+DIM+F+PL
unciforminho	unciforme+N+DIM+M+SG
unciforminhos	unciforme+N+DIM+M+PL
uncinariose	uncinariose+N+F+SG
uncinarioses	uncinariose+N+F+PL
uncinariosezinha	uncinariose+N+DIM+F+SG
uncinariosezinhas	uncinariose+N+DIM+F+PL
uncinariosinha	uncinariose+N+DIM+F+SG
uncinariosinhas	uncinariose+N+DIM+F+PL
undalinho	undalo+N+DIM+M+SG
undalinhos	undalo+N+DIM+M+PL
undalo	undalo+N+M+SG
undalos	undalo+N+M+PL
undalozinho	undalo+N+DIM+M+SG
undalozinhos	undalo+N+DIM+M+PL
undação	undação+N+F+SG
undaçãozinha	undação+N+DIM+F+SG
undações	undação+N+F+PL
undaçõezinhas	undação+N+DIM+F+PL
undecaedrinho	undecaedro+N+DIM+M+SG
undecaedrinhos	undecaedro+N+DIM+M+PL
undecaedro	undecaedro+N+M+SG
undecaedros	undecaedro+N+M+PL
undecaedrozinho	undecaedro+N+DIM+M+SG
undecaedrozinhos	undecaedro+N+DIM+M+PL
undecenalidade	undecenalidade+N+F+SG
undecenalidades	undecenalidade+N+F+PL
undecenalidadezinha	undecenalidade+N+DIM+F+SG
undecenalidadezinhas	undecenalidade+N+DIM+F+PL
undecenalidadinha	undecenalidade+N+DIM+F+SG
undecenalidadinhas	undecenalidade+N+DIM+F+PL
undecilenatinho	undecilenato+N+DIM+M+SG
undecilenatinhos	undecilenato+N+DIM+M+PL
undecilenato	undecilenato+N+M+SG
undecilenatos	undecilenato+N+M+PL
undecilenatozinho	undecilenato+N+DIM+M+SG
undecilenatozinhos	undecilenato+N+DIM+M+PL
undecagoninho	undecágono+N+DIM+M+SG
undecagoninhos	undecágono+N+DIM+M+PL
undecagonozinho	undecágono+N+DIM+M+SG
undecagonozinhos	undecágono+N+DIM+M+PL
undecágono	undecágono+N+M+SG
undecágonos	undecágono+N+M+PL
underground	underground+N+M+SG
undergroundzinho	underground+N+DIM+M+SG
underline	underline+N+M+SG
underlines	underline+N+M+PL
underlinezinho	underline+N+DIM+M+SG
underlinezinhos	underline+N+DIM+M+PL
underlininho	underline+N+DIM+M+SG
underlininhos	underline+N+DIM+M+PL
undosidade	undosidade+N+F+SG
undosidades	undosidade+N+F+PL
undosidadezinha	undosidade+N+DIM+F+SG
undosidadezinhas	undosidade+N+DIM+F+PL
undosidadinha	undosidade+N+DIM+F+SG
undosidadinhas	undosidade+N+DIM+F+PL
undulabilidade	undulabilidade+N+F+SG
undulabilidades	undulabilidade+N+F+PL
undulabilidadezinha	undulabilidade+N+DIM+F+SG
undulabilidadezinhas	undulabilidade+N+DIM+F+PL
undulabilidadinha	undulabilidade+N+DIM+F+SG
undulabilidadinhas	undulabilidade+N+DIM+F+PL
undulosidade	undulosidade+N+F+SG
undulosidades	undulosidade+N+F+PL
undulosidadezinha	undulosidade+N+DIM+F+SG
undulosidadezinhas	undulosidade+N+DIM+F+PL
undulosidadinha	undulosidade+N+DIM+F+SG
undulosidadinhas	undulosidade+N+DIM+F+PL
undeciminho	undécimo+N+DIM+M+SG
undeciminhos	undécimo+N+DIM+M+PL
undecimozinho	undécimo+N+DIM+M+SG
undecimozinhos	undécimo+N+DIM+M+PL
undécimo	undécimo+N+M+SG
undécimos	undécimo+N+M+PL
undecuplinho	undécuplo+N+DIM+M+SG
undecuplinhos	undécuplo+N+DIM+M+PL
undecuplozinho	undécuplo+N+DIM+M+SG
undecuplozinhos	undécuplo+N+DIM+M+PL
undécuplo	undécuplo+N+M+SG
undécuplos	undécuplo+N+M+PL
undicolazinha	undícola+N+DIM+F+SG
undicolazinhas	undícola+N+DIM+F+PL
undicolazinho	undícola+N+DIM+M+SG
undicolazinhos	undícola+N+DIM+M+PL
undicolinha	undícola+N+DIM+SG
undicolinhas	undícola+N+DIM+PL
undícola	undícola+N+SG
undícolas	undícola+N+PL
ungida	ungido+N+F+SG
ungidas	ungido+N+F+PL
ungidazinha	ungido+N+DIM+F+SG
ungidazinhas	ungido+N+DIM+F+PL
ungidinha	ungido+N+DIM+F+SG
ungidinhas	ungido+N+DIM+F+PL
ungidinho	ungido+N+DIM+M+SG
ungidinhos	ungido+N+DIM+M+PL
ungido	ungido+N+M+SG
ungidos	ungido+N+M+PL
ungidozinho	ungido+N+DIM+M+SG
ungidozinhos	ungido+N+DIM+M+PL
ungualidade	ungualidade+N+F+SG
ungualidades	ungualidade+N+F+PL
ungualidadezinha	ungualidade+N+DIM+F+SG
ungualidadezinhas	ungualidade+N+DIM+F+PL
ungualidadinha	ungualidade+N+DIM+F+SG
ungualidadinhas	ungualidade+N+DIM+F+PL
unguari	unguari+N+M+SG
unguaris	unguari+N+M+PL
unguarizinho	unguari+N+DIM+M+SG
unguarizinhos	unguari+N+DIM+M+PL
unguealidade	unguealidade+N+F+SG
unguealidades	unguealidade+N+F+PL
unguealidadezinha	unguealidade+N+DIM+F+SG
unguealidadezinhas	unguealidade+N+DIM+F+PL
unguealidadinha	unguealidade+N+DIM+F+SG
unguealidadinhas	unguealidade+N+DIM+F+PL
unguentabilidade	unguentabilidade+N+F+SG
unguentabilidades	unguentabilidade+N+F+PL
unguentabilidadezinha	unguentabilidade+N+DIM+F+SG
unguentabilidadezinhas	unguentabilidade+N+DIM+F+PL
unguentabilidadinha	unguentabilidade+N+DIM+F+SG
unguentabilidadinhas	unguentabilidade+N+DIM+F+PL
unguentinho	unguento+N+DIM+M+SG
unguentinhos	unguento+N+DIM+M+PL
unguento	unguento+N+M+SG
unguentos	unguento+N+M+PL
unguentozinho	unguento+N+DIM+M+SG
unguentozinhos	unguento+N+DIM+M+PL
unguentarinho	unguentário+N+DIM+M+SG
unguentarinhos	unguentário+N+DIM+M+PL
unguentariozinho	unguentário+N+DIM+M+SG
unguentariozinhos	unguentário+N+DIM+M+PL
unguentário	unguentário+N+M+SG
unguentários	unguentário+N+M+PL
ungui	ungui+N+M+SG
unguis	ungui+N+M+PL
unguizinho	ungui+N+DIM+M+SG
unguizinhos	ungui+N+DIM+M+PL
unguialidade	unguialidade+N+F+SG
unguialidades	unguialidade+N+F+PL
unguialidadezinha	unguialidade+N+DIM+F+SG
unguialidadezinhas	unguialidade+N+DIM+F+PL
unguialidadinha	unguialidade+N+DIM+F+SG
unguialidadinhas	unguialidade+N+DIM+F+PL
unguiculada	unguiculado+N+F+SG
unguiculadas	unguiculado+N+F+PL
unguiculadazinha	unguiculado+N+DIM+F+SG
unguiculadazinhas	unguiculado+N+DIM+F+PL
unguiculadinha	unguiculado+N+DIM+F+SG
unguiculadinhas	unguiculado+N+DIM+F+PL
unguiculadinho	unguiculado+N+DIM+M+SG
unguiculadinhos	unguiculado+N+DIM+M+PL
unguiculado	unguiculado+N+M+SG
unguiculados	unguiculado+N+M+PL
unguiculadozinho	unguiculado+N+DIM+M+SG
unguiculadozinhos	unguiculado+N+DIM+M+PL
unguinosidade	unguinosidade+N+F+SG
unguinosidades	unguinosidade+N+F+PL
unguinosidadezinha	unguinosidade+N+DIM+F+SG
unguinosidadezinhas	unguinosidade+N+DIM+F+PL
unguinosidadinha	unguinosidade+N+DIM+F+SG
unguinosidadinhas	unguinosidade+N+DIM+F+PL
unguladinho	ungulado+N+DIM+M+SG
unguladinhos	ungulado+N+DIM+M+PL
ungulado	ungulado+N+M+SG
ungulados	ungulado+N+M+PL
unguladozinho	ungulado+N+DIM+M+SG
unguladozinhos	ungulado+N+DIM+M+PL
unguligradinho	ungulígrado+N+DIM+M+SG
unguligradinhos	ungulígrado+N+DIM+M+PL
unguligradozinho	ungulígrado+N+DIM+M+SG
unguligradozinhos	ungulígrado+N+DIM+M+PL
ungulígrado	ungulígrado+N+M+SG
ungulígrados	ungulígrado+N+M+PL
ungüentinho	ungüento+N+DIM+M+SG
ungüentinhos	ungüento+N+DIM+M+PL
ungüento	ungüento+N+M+SG
ungüentos	ungüento+N+M+PL
ungüentozinho	ungüento+N+DIM+M+SG
ungüentozinhos	ungüento+N+DIM+M+PL
ungüi	ungüi+N+M+SG
ungüis	ungüi+N+M+PL
ungüizinho	ungüi+N+DIM+M+SG
ungüizinhos	ungüi+N+DIM+M+PL
unha	unha+N+F+SG
unhas	unha+N+F+PL
unhazinha	unha+N+DIM+F+SG
unhazinhas	unha+N+DIM+F+PL
unhinha	unha+N+DIM+F+SG
unhinhas	unha+N+DIM+F+PL
unhita	unha+N+DIM+F+SG
unhitas	unha+N+DIM+F+PL
unhão	unha+N+AUG+M+SG
unhãozinho	unha+N+AUG+DIM+M+SG
unhões	unha+N+AUG+M+PL
unhõezinhos	unha+N+AUG+DIM+M+PL
unhabilidade	unhabilidade+N+F+SG
unhabilidades	unhabilidade+N+F+PL
unhabilidadezinha	unhabilidade+N+DIM+F+SG
unhabilidadezinhas	unhabilidade+N+DIM+F+PL
unhabilidadinha	unhabilidade+N+DIM+F+SG
unhabilidadinhas	unhabilidade+N+DIM+F+PL
unhaca	unhaca+N+SG
unhacas	unhaca+N+PL
unhacazinha	unhaca+N+DIM+F+SG
unhacazinhas	unhaca+N+DIM+F+PL
unhacazinho	unhaca+N+DIM+M+SG
unhacazinhos	unhaca+N+DIM+M+PL
unhaquinha	unhaca+N+DIM+SG
unhaquinhas	unhaca+N+DIM+PL
unhada	unhada+N+F+SG
unhadas	unhada+N+F+PL
unhadazinha	unhada+N+DIM+F+SG
unhadazinhas	unhada+N+DIM+F+PL
unhadinha	unhada+N+DIM+F+SG
unhadinhas	unhada+N+DIM+F+PL
unhador	unhador+N+M+SG
unhadora	unhador+N+F+SG
unhadoras	unhador+N+F+PL
unhadorazinha	unhador+N+DIM+F+SG
unhadorazinhas	unhador+N+DIM+F+PL
unhadores	unhador+N+M+PL
unhadorezinhos	unhador+N+DIM+M+PL
unhadorinha	unhador+N+DIM+F+SG
unhadorinhas	unhador+N+DIM+F+PL
unhadorzinho	unhador+N+DIM+M+SG
unhadorzinhos	unhador+N+DIM+M+PL
unhagata	unhagata+N+F+SG
unhagatas	unhagata+N+F+PL
unhagatazinha	unhagata+N+DIM+F+SG
unhagatazinhas	unhagata+N+DIM+F+PL
unhagatinha	unhagata+N+DIM+F+SG
unhagatinhas	unhagata+N+DIM+F+PL
unhamentinho	unhamento+N+DIM+M+SG
unhamentinhos	unhamento+N+DIM+M+PL
unhamento	unhamento+N+M+SG
unhamentos	unhamento+N+M+PL
unhamentozinho	unhamento+N+DIM+M+SG
unhamentozinhos	unhamento+N+DIM+M+PL
unhante	unhante+N+M+SG
unhantes	unhante+N+M+PL
unhantezinho	unhante+N+DIM+M+SG
unhantezinhos	unhante+N+DIM+M+PL
unhantinho	unhante+N+DIM+M+SG
unhantinhos	unhante+N+DIM+M+PL
unhacinho	unhaço+N+DIM+M+SG
unhacinhos	unhaço+N+DIM+M+PL
unhaço	unhaço+N+M+SG
unhaços	unhaço+N+M+PL
unhaçozinho	unhaço+N+DIM+M+SG
unhaçozinhos	unhaço+N+DIM+M+PL
unheira	unheiro+N+F+SG
unheiras	unheiro+N+F+PL
unheirazinha	unheiro+N+DIM+F+SG
unheirazinhas	unheiro+N+DIM+F+PL
unheirinha	unheiro+N+DIM+F+SG
unheirinhas	unheiro+N+DIM+F+PL
unheirinho	unheiro+N+DIM+M+SG
unheirinhos	unheiro+N+DIM+M+PL
unheiro	unheiro+N+M+SG
unheiros	unheiro+N+M+PL
unheirozinho	unheiro+N+DIM+M+SG
unheirozinhos	unheiro+N+DIM+M+PL
unhão	unhão+N+M+SG
unhãozinho	unhão+N+DIM+M+SG
unhões	unhão+N+M+PL
unhõezinhos	unhão+N+DIM+M+PL
uniangularidade	uniangularidade+N+F+SG
uniangularidades	uniangularidade+N+F+PL
uniangularidadezinha	uniangularidade+N+DIM+F+SG
uniangularidadezinhas	uniangularidade+N+DIM+F+PL
uniangularidadinha	uniangularidade+N+DIM+F+SG
uniangularidadinhas	uniangularidade+N+DIM+F+PL
uniaxialidade	uniaxialidade+N+F+SG
uniaxialidades	uniaxialidade+N+F+PL
uniaxialidadezinha	uniaxialidade+N+DIM+F+SG
uniaxialidadezinhas	uniaxialidade+N+DIM+F+PL
uniaxialidadinha	uniaxialidade+N+DIM+F+SG
uniaxialidadinhas	uniaxialidade+N+DIM+F+PL
unicameralidade	unicameralidade+N+F+SG
unicameralidades	unicameralidade+N+F+PL
unicameralidadezinha	unicameralidade+N+DIM+F+SG
unicameralidadezinhas	unicameralidade+N+DIM+F+PL
unicameralidadinha	unicameralidade+N+DIM+F+SG
unicameralidadinhas	unicameralidade+N+DIM+F+PL
unicapsularidade	unicapsularidade+N+F+SG
unicapsularidades	unicapsularidade+N+F+PL
unicapsularidadezinha	unicapsularidade+N+DIM+F+SG
unicapsularidadezinhas	unicapsularidade+N+DIM+F+PL
unicapsularidadinha	unicapsularidade+N+DIM+F+SG
unicapsularidadinhas	unicapsularidade+N+DIM+F+PL
unicarpelaridade	unicarpelaridade+N+F+SG
unicarpelaridades	unicarpelaridade+N+F+PL
unicarpelaridadezinha	unicarpelaridade+N+DIM+F+SG
unicarpelaridadezinhas	unicarpelaridade+N+DIM+F+PL
unicarpelaridadinha	unicarpelaridade+N+DIM+F+SG
unicarpelaridadinhas	unicarpelaridade+N+DIM+F+PL
unicelularidade	unicelularidade+N+F+SG
unicelularidades	unicelularidade+N+F+PL
unicelularidadezinha	unicelularidade+N+DIM+F+SG
unicelularidadezinhas	unicelularidade+N+DIM+F+PL
unicelularidadinha	unicelularidade+N+DIM+F+SG
unicelularidadinhas	unicelularidade+N+DIM+F+PL
unicidade	unicidade+N+F+SG
unicidades	unicidade+N+F+PL
unicidadezinha	unicidade+N+DIM+F+SG
unicidadezinhas	unicidade+N+DIM+F+PL
unicidadinha	unicidade+N+DIM+F+SG
unicidadinhas	unicidade+N+DIM+F+PL
uniciliaridade	uniciliaridade+N+F+SG
uniciliaridades	uniciliaridade+N+F+PL
uniciliaridadezinha	uniciliaridade+N+DIM+F+SG
uniciliaridadezinhas	uniciliaridade+N+DIM+F+PL
uniciliaridadinha	uniciliaridade+N+DIM+F+SG
uniciliaridadinhas	uniciliaridade+N+DIM+F+PL
unicultor	unicultor+N+M+SG
unicultora	unicultor+N+F+SG
unicultoras	unicultor+N+F+PL
unicultorazinha	unicultor+N+DIM+F+SG
unicultorazinhas	unicultor+N+DIM+F+PL
unicultores	unicultor+N+M+PL
unicultorezinhos	unicultor+N+DIM+M+PL
unicultorinha	unicultor+N+DIM+F+SG
unicultorinhas	unicultor+N+DIM+F+PL
unicultorzinho	unicultor+N+DIM+M+SG
unicultorzinhos	unicultor+N+DIM+M+PL
unicorninho	unicórnio+N+DIM+M+SG
unicorninhos	unicórnio+N+DIM+M+PL
unicorniozinho	unicórnio+N+DIM+M+SG
unicorniozinhos	unicórnio+N+DIM+M+PL
unicórnio	unicórnio+N+M+SG
unicórnios	unicórnio+N+M+PL
unidade	unidade+N+F+SG
unidades	unidade+N+F+PL
unidadezinha	unidade+N+DIM+F+SG
unidadezinhas	unidade+N+DIM+F+PL
unidadinha	unidade+N+DIM+F+SG
unidadinhas	unidade+N+DIM+F+PL
unidade-pilotinho	unidade-piloto+N+DIM+F+SG
unidade-pilotinhos	unidade-piloto+N+DIM+F+PL
unidade-piloto	unidade-piloto+N+F+SG
unidade-pilotozinha	unidade-piloto+N+DIM+F+SG
unidades-piloto	unidade-piloto+N+F+PL
unidades-pilotozinhas	unidade-piloto+N+DIM+F+PL
unidimensionalidade	unidimensionalidade+N+F+SG
unidimensionalidades	unidimensionalidade+N+F+PL
unidimensionalidadezinha	unidimensionalidade+N+DIM+F+SG
unidimensionalidadezinhas	unidimensionalidade+N+DIM+F+PL
unidimensionalidadinha	unidimensionalidade+N+DIM+F+SG
unidimensionalidadinhas	unidimensionalidade+N+DIM+F+PL
unidireccionalidade	unidireccionalidade+N+F+SG
unidireccionalidades	unidireccionalidade+N+F+PL
unidireccionalidadezinha	unidireccionalidade+N+DIM+F+SG
unidireccionalidadezinhas	unidireccionalidade+N+DIM+F+PL
unidireccionalidadinha	unidireccionalidade+N+DIM+F+SG
unidireccionalidadinhas	unidireccionalidade+N+DIM+F+PL
unidirecionalidade	unidirecionalidade+N+F+SG
unidirecionalidades	unidirecionalidade+N+F+PL
unidirecionalidadezinha	unidirecionalidade+N+DIM+F+SG
unidirecionalidadezinhas	unidirecionalidade+N+DIM+F+PL
unidirecionalidadinha	unidirecionalidade+N+DIM+F+SG
unidirecionalidadinhas	unidirecionalidade+N+DIM+F+PL
unifacialidade	unifacialidade+N+F+SG
unifacialidades	unifacialidade+N+F+PL
unifacialidadezinha	unifacialidade+N+DIM+F+SG
unifacialidadezinhas	unifacialidade+N+DIM+F+PL
unifacialidadinha	unifacialidade+N+DIM+F+SG
unifacialidadinhas	unifacialidade+N+DIM+F+PL
unificabilidade	unificabilidade+N+F+SG
unificabilidades	unificabilidade+N+F+PL
unificabilidadezinha	unificabilidade+N+DIM+F+SG
unificabilidadezinhas	unificabilidade+N+DIM+F+PL
unificabilidadinha	unificabilidade+N+DIM+F+SG
unificabilidadinhas	unificabilidade+N+DIM+F+PL
unificador	unificador+N+M+SG
unificadora	unificador+N+F+SG
unificadoras	unificador+N+F+PL
unificadorazinha	unificador+N+DIM+F+SG
unificadorazinhas	unificador+N+DIM+F+PL
unificadores	unificador+N+M+PL
unificadorezinhos	unificador+N+DIM+M+PL
unificadorinha	unificador+N+DIM+F+SG
unificadorinhas	unificador+N+DIM+F+PL
unificadorzinho	unificador+N+DIM+M+SG
unificadorzinhos	unificador+N+DIM+M+PL
unificação	unificação+N+F+SG
unificaçãozinha	unificação+N+DIM+F+SG
unificações	unificação+N+F+PL
unificaçõezinhas	unificação+N+DIM+F+PL
unifilaridade	unifilaridade+N+F+SG
unifilaridades	unifilaridade+N+F+PL
unifilaridadezinha	unifilaridade+N+DIM+F+SG
unifilaridadezinhas	unifilaridade+N+DIM+F+PL
unifilaridadinha	unifilaridade+N+DIM+F+SG
unifilaridadinhas	unifilaridade+N+DIM+F+PL
unifocalidade	unifocalidade+N+F+SG
unifocalidades	unifocalidade+N+F+PL
unifocalidadezinha	unifocalidade+N+DIM+F+SG
unifocalidadezinhas	unifocalidade+N+DIM+F+PL
unifocalidadinha	unifocalidade+N+DIM+F+SG
unifocalidadinhas	unifocalidade+N+DIM+F+PL
uniformabilidade	uniformabilidade+N+F+SG
uniformabilidades	uniformabilidade+N+F+PL
uniformabilidadezinha	uniformabilidade+N+DIM+F+SG
uniformabilidadezinhas	uniformabilidade+N+DIM+F+PL
uniformabilidadinha	uniformabilidade+N+DIM+F+SG
uniformabilidadinhas	uniformabilidade+N+DIM+F+PL
uniforme	uniforme+N+SG
uniformes	uniforme+N+PL
uniformezinha	uniforme+N+DIM+F+SG
uniformezinhas	uniforme+N+DIM+F+PL
uniformezinho	uniforme+N+DIM+M+SG
uniformezinhos	uniforme+N+DIM+M+PL
uniforminha	uniforme+N+DIM+F+SG
uniforminhas	uniforme+N+DIM+F+PL
uniforminho	uniforme+N+DIM+M+SG
uniforminhos	uniforme+N+DIM+M+PL
uniformidade	uniformidade+N+F+SG
uniformidades	uniformidade+N+F+PL
uniformidadezinha	uniformidade+N+DIM+F+SG
uniformidadezinhas	uniformidade+N+DIM+F+PL
uniformidadinha	uniformidade+N+DIM+F+SG
uniformidadinhas	uniformidade+N+DIM+F+PL
uniformizabilidade	uniformizabilidade+N+F+SG
uniformizabilidades	uniformizabilidade+N+F+PL
uniformizabilidadezinha	uniformizabilidade+N+DIM+F+SG
uniformizabilidadezinhas	uniformizabilidade+N+DIM+F+PL
uniformizabilidadinha	uniformizabilidade+N+DIM+F+SG
uniformizabilidadinhas	uniformizabilidade+N+DIM+F+PL
uniformizador	uniformizador+N+M+SG
uniformizadora	uniformizador+N+F+SG
uniformizadoras	uniformizador+N+F+PL
uniformizadorazinha	uniformizador+N+DIM+F+SG
uniformizadorazinhas	uniformizador+N+DIM+F+PL
uniformizadores	uniformizador+N+M+PL
uniformizadorezinhos	uniformizador+N+DIM+M+PL
uniformizadorinha	uniformizador+N+DIM+F+SG
uniformizadorinhas	uniformizador+N+DIM+F+PL
uniformizadorzinho	uniformizador+N+DIM+M+SG
uniformizadorzinhos	uniformizador+N+DIM+M+PL
uniformização	uniformização+N+F+SG
uniformizaçãozinha	uniformização+N+DIM+F+SG
uniformizações	uniformização+N+F+PL
uniformizaçõezinhas	uniformização+N+DIM+F+PL
unigamia	unigamia+N+F+SG
unigamias	unigamia+N+F+PL
unigamiazinha	unigamia+N+DIM+F+SG
unigamiazinhas	unigamia+N+DIM+F+PL
unigaminha	unigamia+N+DIM+F+SG
unigaminhas	unigamia+N+DIM+F+PL
unigenitazinha	unigénito+N+DIM+F+SG
unigenitazinhas	unigénito+N+DIM+F+PL
unigenitinha	unigénito+N+DIM+F+SG
unigenitinhas	unigénito+N+DIM+F+PL
unigenitinho	unigénito+N+DIM+M+SG
unigenitinhos	unigénito+N+DIM+M+PL
unigenitozinho	unigénito+N+DIM+M+SG
unigenitozinhos	unigénito+N+DIM+M+PL
unigénita	unigénito+N+F+SG
unigénitas	unigénito+N+F+PL
unigénito	unigénito+N+M+SG
unigénitos	unigénito+N+M+PL
unilateralidade	unilateralidade+N+F+SG
unilateralidades	unilateralidade+N+F+PL
unilateralidadezinha	unilateralidade+N+DIM+F+SG
unilateralidadezinhas	unilateralidade+N+DIM+F+PL
unilateralidadinha	unilateralidade+N+DIM+F+SG
unilateralidadinhas	unilateralidade+N+DIM+F+PL
unilateralisminho	unilateralismo+N+DIM+M+SG
unilateralisminhos	unilateralismo+N+DIM+M+PL
unilateralismo	unilateralismo+N+M+SG
unilateralismos	unilateralismo+N+M+PL
unilateralismozinho	unilateralismo+N+DIM+M+SG
unilateralismozinhos	unilateralismo+N+DIM+M+PL
unilinearidade	unilinearidade+N+F+SG
unilinearidades	unilinearidade+N+F+PL
unilinearidadezinha	unilinearidade+N+DIM+F+SG
unilinearidadezinhas	unilinearidade+N+DIM+F+PL
unilinearidadinha	unilinearidade+N+DIM+F+SG
unilinearidadinhas	unilinearidade+N+DIM+F+PL
uniliteralidade	uniliteralidade+N+F+SG
uniliteralidades	uniliteralidade+N+F+PL
uniliteralidadezinha	uniliteralidade+N+DIM+F+SG
uniliteralidadezinhas	uniliteralidade+N+DIM+F+PL
uniliteralidadinha	uniliteralidade+N+DIM+F+SG
uniliteralidadinhas	uniliteralidade+N+DIM+F+PL
unilocularidade	unilocularidade+N+F+SG
unilocularidades	unilocularidade+N+F+PL
unilocularidadezinha	unilocularidade+N+DIM+F+SG
unilocularidadezinhas	unilocularidade+N+DIM+F+PL
unilocularidadinha	unilocularidade+N+DIM+F+SG
unilocularidadinhas	unilocularidade+N+DIM+F+PL
unilseptinho	unilséptio+N+DIM+M+SG
unilseptinhos	unilséptio+N+DIM+M+PL
unilseptiozinho	unilséptio+N+DIM+M+SG
unilseptiozinhos	unilséptio+N+DIM+M+PL
unilséptio	unilséptio+N+M+SG
unilséptios	unilséptio+N+M+PL
unileninho	unilénio+N+DIM+M+SG
unileninhos	unilénio+N+DIM+M+PL
unileniozinho	unilénio+N+DIM+M+SG
unileniozinhos	unilénio+N+DIM+M+PL
unilénio	unilénio+N+M+SG
unilénios	unilénio+N+M+PL
unileninho	unilênio+N+DIM+M+SG
unileninhos	unilênio+N+DIM+M+PL
unileniozinho	unilênio+N+DIM+M+SG
unileniozinhos	unilênio+N+DIM+M+PL
unilênio	unilênio+N+M+SG
unilênios	unilênio+N+M+PL
uniloctinho	unilóctio+N+DIM+M+SG
uniloctinhos	unilóctio+N+DIM+M+PL
uniloctiozinho	unilóctio+N+DIM+M+SG
uniloctiozinhos	unilóctio+N+DIM+M+PL
unilóctio	unilóctio+N+M+SG
unilóctios	unilóctio+N+M+PL
unimama	unimama+N+F+SG
unimamas	unimama+N+F+PL
unimamazinha	unimama+N+DIM+F+SG
unimamazinhas	unimama+N+DIM+F+PL
unimaminha	unimama+N+DIM+F+SG
unimaminhas	unimama+N+DIM+F+PL
unimetalisminho	unimetalismo+N+DIM+M+SG
unimetalisminhos	unimetalismo+N+DIM+M+PL
unimetalismo	unimetalismo+N+M+SG
unimetalismos	unimetalismo+N+M+PL
unimetalismozinho	unimetalismo+N+DIM+M+SG
unimetalismozinhos	unimetalismo+N+DIM+M+PL
uninominalidade	uninominalidade+N+F+SG
uninominalidades	uninominalidade+N+F+PL
uninominalidadezinha	uninominalidade+N+DIM+F+SG
uninominalidadezinhas	uninominalidade+N+DIM+F+PL
uninominalidadinha	uninominalidade+N+DIM+F+SG
uninominalidadinhas	uninominalidade+N+DIM+F+PL
uninuclearidade	uninuclearidade+N+F+SG
uninuclearidades	uninuclearidade+N+F+PL
uninuclearidadezinha	uninuclearidade+N+DIM+F+SG
uninuclearidadezinhas	uninuclearidade+N+DIM+F+PL
uninuclearidadinha	uninuclearidade+N+DIM+F+SG
uninuclearidadinhas	uninuclearidade+N+DIM+F+PL
unionisminho	unionismo+N+DIM+M+SG
unionisminhos	unionismo+N+DIM+M+PL
unionismo	unionismo+N+M+SG
unionismos	unionismo+N+M+PL
unionismozinho	unionismo+N+DIM+M+SG
unionismozinhos	unionismo+N+DIM+M+PL
unionista	unionista+N+SG
unionistas	unionista+N+PL
unionistazinha	unionista+N+DIM+F+SG
unionistazinhas	unionista+N+DIM+F+PL
unionistazinho	unionista+N+DIM+M+SG
unionistazinhos	unionista+N+DIM+M+PL
unionistinha	unionista+N+DIM+SG
unionistinhas	unionista+N+DIM+PL
unionideinho	unionídeo+N+DIM+M+SG
unionideinhos	unionídeo+N+DIM+M+PL
unionideozinho	unionídeo+N+DIM+M+SG
unionideozinhos	unionídeo+N+DIM+M+PL
unionídeo	unionídeo+N+M+SG
unionídeos	unionídeo+N+M+PL
uniovularidade	uniovularidade+N+F+SG
uniovularidades	uniovularidade+N+F+PL
uniovularidadezinha	uniovularidade+N+DIM+F+SG
uniovularidadezinhas	uniovularidade+N+DIM+F+PL
uniovularidadinha	uniovularidade+N+DIM+F+SG
uniovularidadinhas	uniovularidade+N+DIM+F+PL
uniparidade	uniparidade+N+F+SG
uniparidades	uniparidade+N+F+PL
uniparidadezinha	uniparidade+N+DIM+F+SG
uniparidadezinhas	uniparidade+N+DIM+F+PL
uniparidadinha	uniparidade+N+DIM+F+SG
uniparidadinhas	uniparidade+N+DIM+F+PL
unipedalidade	unipedalidade+N+F+SG
unipedalidades	unipedalidade+N+F+PL
unipedalidadezinha	unipedalidade+N+DIM+F+SG
unipedalidadezinhas	unipedalidade+N+DIM+F+PL
unipedalidadinha	unipedalidade+N+DIM+F+SG
unipedalidadinhas	unipedalidade+N+DIM+F+PL
unipessoalidade	unipessoalidade+N+F+SG
unipessoalidades	unipessoalidade+N+F+PL
unipessoalidadezinha	unipessoalidade+N+DIM+F+SG
unipessoalidadezinhas	unipessoalidade+N+DIM+F+PL
unipessoalidadinha	unipessoalidade+N+DIM+F+SG
unipessoalidadinhas	unipessoalidade+N+DIM+F+PL
unipolaridade	unipolaridade+N+F+SG
unipolaridades	unipolaridade+N+F+PL
unipolaridadezinha	unipolaridade+N+DIM+F+SG
unipolaridadezinhas	unipolaridade+N+DIM+F+PL
unipolaridadinha	unipolaridade+N+DIM+F+SG
unipolaridadinhas	unipolaridade+N+DIM+F+PL
unispermicidade	unispermicidade+N+F+SG
unispermicidades	unispermicidade+N+F+PL
unispermicidadezinha	unispermicidade+N+DIM+F+SG
unispermicidadezinhas	unispermicidade+N+DIM+F+PL
unispermicidadinha	unispermicidade+N+DIM+F+SG
unispermicidadinhas	unispermicidade+N+DIM+F+PL
unissexualidade	unissexualidade+N+F+SG
unissexualidades	unissexualidade+N+F+PL
unissexualidadezinha	unissexualidade+N+DIM+F+SG
unissexualidadezinhas	unissexualidade+N+DIM+F+PL
unissexualidadinha	unissexualidade+N+DIM+F+SG
unissexualidadinhas	unissexualidade+N+DIM+F+PL
unissexualisminho	unissexualismo+N+DIM+M+SG
unissexualisminhos	unissexualismo+N+DIM+M+PL
unissexualismo	unissexualismo+N+M+SG
unissexualismos	unissexualismo+N+M+PL
unissexualismozinho	unissexualismo+N+DIM+M+SG
unissexualismozinhos	unissexualismo+N+DIM+M+PL
unissonanciazinha	unissonância+N+DIM+F+SG
unissonanciazinhas	unissonância+N+DIM+F+PL
unissonancinha	unissonância+N+DIM+F+SG
unissonancinhas	unissonância+N+DIM+F+PL
unissonância	unissonância+N+F+SG
unissonâncias	unissonância+N+F+PL
unitarisma	unitarismo+N+F+SG
unitarismas	unitarismo+N+F+PL
unitarismazinha	unitarismo+N+DIM+F+SG
unitarismazinhas	unitarismo+N+DIM+F+PL
unitarisminha	unitarismo+N+DIM+F+SG
unitarisminhas	unitarismo+N+DIM+F+PL
unitarisminho	unitarismo+N+DIM+M+SG
unitarisminhos	unitarismo+N+DIM+M+PL
unitarismo	unitarismo+N+M+SG
unitarismos	unitarismo+N+M+PL
unitarismozinho	unitarismo+N+DIM+M+SG
unitarismozinhos	unitarismo+N+DIM+M+PL
unitarista	unitarista+N+SG
unitaristas	unitarista+N+PL
unitaristazinha	unitarista+N+DIM+F+SG
unitaristazinhas	unitarista+N+DIM+F+PL
unitaristazinho	unitarista+N+DIM+M+SG
unitaristazinhos	unitarista+N+DIM+M+PL
unitaristinha	unitarista+N+DIM+SG
unitaristinhas	unitarista+N+DIM+PL
unitividade	unitividade+N+F+SG
unitividades	unitividade+N+F+PL
unitividadezinha	unitividade+N+DIM+F+SG
unitividadezinhas	unitividade+N+DIM+F+PL
unitividadinha	unitividade+N+DIM+F+SG
unitividadinhas	unitividade+N+DIM+F+PL
univalvularidade	univalvularidade+N+F+SG
univalvularidades	univalvularidade+N+F+PL
univalvularidadezinha	univalvularidade+N+DIM+F+SG
univalvularidadezinhas	univalvularidade+N+DIM+F+PL
univalvularidadinha	univalvularidade+N+DIM+F+SG
univalvularidadinhas	univalvularidade+N+DIM+F+PL
univalenciazinha	univalência+N+DIM+F+SG
univalenciazinhas	univalência+N+DIM+F+PL
univalencinha	univalência+N+DIM+F+SG
univalencinhas	univalência+N+DIM+F+PL
univalência	univalência+N+F+SG
univalências	univalência+N+F+PL
universais	universal+N+PL
universaizinhas	universal+N+DIM+F+PL
universaizinhos	universal+N+DIM+M+PL
universal	universal+N+SG
universalzinha	universal+N+DIM+F+SG
universalzinho	universal+N+DIM+M+SG
universalidade	universalidade+N+F+SG
universalidades	universalidade+N+F+PL
universalidadezinha	universalidade+N+DIM+F+SG
universalidadezinhas	universalidade+N+DIM+F+PL
universalidadinha	universalidade+N+DIM+F+SG
universalidadinhas	universalidade+N+DIM+F+PL
universalisabilidade	universalisabilidade+N+F+SG
universalisabilidades	universalisabilidade+N+F+PL
universalisabilidadezinha	universalisabilidade+N+DIM+F+SG
universalisabilidadezinhas	universalisabilidade+N+DIM+F+PL
universalisabilidadinha	universalisabilidade+N+DIM+F+SG
universalisabilidadinhas	universalisabilidade+N+DIM+F+PL
universalisminho	universalismo+N+DIM+M+SG
universalisminhos	universalismo+N+DIM+M+PL
universalismo	universalismo+N+M+SG
universalismos	universalismo+N+M+PL
universalismozinho	universalismo+N+DIM+M+SG
universalismozinhos	universalismo+N+DIM+M+PL
universalista	universalista+N+SG
universalistas	universalista+N+PL
universalistazinha	universalista+N+DIM+F+SG
universalistazinhas	universalista+N+DIM+F+PL
universalistazinho	universalista+N+DIM+M+SG
universalistazinhos	universalista+N+DIM+M+PL
universalistinha	universalista+N+DIM+SG
universalistinhas	universalista+N+DIM+PL
universalizabilidade	universalizabilidade+N+F+SG
universalizabilidades	universalizabilidade+N+F+PL
universalizabilidadezinha	universalizabilidade+N+DIM+F+SG
universalizabilidadezinhas	universalizabilidade+N+DIM+F+PL
universalizabilidadinha	universalizabilidade+N+DIM+F+SG
universalizabilidadinhas	universalizabilidade+N+DIM+F+PL
universalização	universalização+N+F+SG
universalizaçãozinha	universalização+N+DIM+F+SG
universalizações	universalização+N+F+PL
universalizaçõezinhas	universalização+N+DIM+F+PL
universidade	universidade+N+F+SG
universidades	universidade+N+F+PL
universidadezinha	universidade+N+DIM+F+SG
universidadezinhas	universidade+N+DIM+F+PL
universidadinha	universidade+N+DIM+F+SG
universidadinhas	universidade+N+DIM+F+PL
universitariazinha	universitário+N+DIM+F+SG
universitariazinhas	universitário+N+DIM+F+PL
universitarinha	universitário+N+DIM+F+SG
universitarinhas	universitário+N+DIM+F+PL
universitarinho	universitário+N+DIM+M+SG
universitarinhos	universitário+N+DIM+M+PL
universitariozinho	universitário+N+DIM+M+SG
universitariozinhos	universitário+N+DIM+M+PL
universitária	universitário+N+F+SG
universitárias	universitário+N+F+PL
universitário	universitário+N+M+SG
universitários	universitário+N+M+PL
universa	universo+N+F+SG
universas	universo+N+F+PL
universazinha	universo+N+DIM+F+SG
universazinhas	universo+N+DIM+F+PL
universinha	universo+N+DIM+F+SG
universinhas	universo+N+DIM+F+PL
universinho	universo+N+DIM+M+SG
universinhos	universo+N+DIM+M+PL
universo	universo+N+M+SG
universos	universo+N+M+PL
universozinho	universo+N+DIM+M+SG
universozinhos	universo+N+DIM+M+PL
univocação	univocação+N+F+SG
univocaçãozinha	univocação+N+DIM+F+SG
univocações	univocação+N+F+PL
univocaçõezinhas	univocação+N+DIM+F+PL
univocidade	univocidade+N+F+SG
univocidades	univocidade+N+F+PL
univocidadezinha	univocidade+N+DIM+F+SG
univocidadezinhas	univocidade+N+DIM+F+PL
univocidadinha	univocidade+N+DIM+F+SG
univocidadinhas	univocidade+N+DIM+F+PL
união	união+N+F+SG
uniãozinha	união+N+DIM+F+SG
uniões	união+N+F+PL
uniõezinhas	união+N+DIM+F+PL
unionidazinha	uniónida+N+DIM+F+SG
unionidazinhas	uniónida+N+DIM+F+PL
unionidinha	uniónida+N+DIM+F+SG
unionidinhas	uniónida+N+DIM+F+PL
uniónida	uniónida+N+F+SG
uniónidas	uniónida+N+F+PL
untabilidade	untabilidade+N+F+SG
untabilidades	untabilidade+N+F+PL
untabilidadezinha	untabilidade+N+DIM+F+SG
untabilidadezinhas	untabilidade+N+DIM+F+PL
untabilidadinha	untabilidade+N+DIM+F+SG
untabilidadinhas	untabilidade+N+DIM+F+PL
untadela	untadela+N+F+SG
untadelas	untadela+N+F+PL
untadelazinha	untadela+N+DIM+F+SG
untadelazinhas	untadela+N+DIM+F+PL
untadelinha	untadela+N+DIM+F+SG
untadelinhas	untadela+N+DIM+F+PL
untador	untador+N+M+SG
untadora	untador+N+F+SG
untadoras	untador+N+F+PL
untadorazinha	untador+N+DIM+F+SG
untadorazinhas	untador+N+DIM+F+PL
untadores	untador+N+M+PL
untadorezinhos	untador+N+DIM+M+PL
untadorinha	untador+N+DIM+F+SG
untadorinhas	untador+N+DIM+F+PL
untadorzinho	untador+N+DIM+M+SG
untadorzinhos	untador+N+DIM+M+PL
untadura	untadura+N+F+SG
untaduras	untadura+N+F+PL
untadurazinha	untadura+N+DIM+F+SG
untadurazinhas	untadura+N+DIM+F+PL
untadurinha	untadura+N+DIM+F+SG
untadurinhas	untadura+N+DIM+F+PL
untanha	untanha+N+F+SG
untanhas	untanha+N+F+PL
untanhazinha	untanha+N+DIM+F+SG
untanhazinhas	untanha+N+DIM+F+PL
untanhinha	untanha+N+DIM+F+SG
untanhinhas	untanha+N+DIM+F+PL
untitabilidade	untitabilidade+N+F+SG
untitabilidades	untitabilidade+N+F+PL
untitabilidadezinha	untitabilidade+N+DIM+F+SG
untitabilidadezinhas	untitabilidade+N+DIM+F+PL
untitabilidadinha	untitabilidade+N+DIM+F+SG
untitabilidadinhas	untitabilidade+N+DIM+F+PL
untinho	unto+N+DIM+M+SG
untinhos	unto+N+DIM+M+PL
unto	unto+N+M+SG
untos	unto+N+M+PL
untozinho	unto+N+DIM+M+SG
untozinhos	unto+N+DIM+M+PL
untuosidade	untuosidade+N+F+SG
untuosidades	untuosidade+N+F+PL
untuosidadezinha	untuosidade+N+DIM+F+SG
untuosidadezinhas	untuosidade+N+DIM+F+PL
untuosidadinha	untuosidade+N+DIM+F+SG
untuosidadinhas	untuosidade+N+DIM+F+PL
untura	untura+N+F+SG
unturas	untura+N+F+PL
unturazinha	untura+N+DIM+F+SG
unturazinhas	untura+N+DIM+F+PL
unturinha	untura+N+DIM+F+SG
unturinhas	untura+N+DIM+F+PL
untorinho	untório+N+DIM+M+SG
untorinhos	untório+N+DIM+M+PL
untoriozinho	untório+N+DIM+M+SG
untoriozinhos	untório+N+DIM+M+PL
untório	untório+N+M+SG
untórios	untório+N+M+PL
unção	unção+N+F+SG
unçãozinha	unção+N+DIM+F+SG
unções	unção+N+F+PL
unçõezinhas	unção+N+DIM+F+PL
unigamazinha	unígamo+N+DIM+F+SG
unigamazinhas	unígamo+N+DIM+F+PL
unigaminha	unígamo+N+DIM+F+SG
unigaminhas	unígamo+N+DIM+F+PL
unigaminho	unígamo+N+DIM+M+SG
unigaminhos	unígamo+N+DIM+M+PL
unigamozinho	unígamo+N+DIM+M+SG
unigamozinhos	unígamo+N+DIM+M+PL
unígama	unígamo+N+F+SG
unígamas	unígamo+N+F+PL
unígamo	unígamo+N+M+SG
unígamos	unígamo+N+M+PL
unissonazinha	uníssono+N+DIM+F+SG
unissonazinhas	uníssono+N+DIM+F+PL
unissoninha	uníssono+N+DIM+F+SG
unissoninhas	uníssono+N+DIM+F+PL
unissoninho	uníssono+N+DIM+M+SG
unissoninhos	uníssono+N+DIM+M+PL
unissonozinho	uníssono+N+DIM+M+SG
unissonozinhos	uníssono+N+DIM+M+PL
uníssona	uníssono+N+F+SG
uníssonas	uníssono+N+F+PL
uníssono	uníssono+N+M+SG
uníssonos	uníssono+N+M+PL
upa	upa+N+F+SG
upas	upa+N+F+PL
upazinha	upa+N+DIM+F+SG
upazinhas	upa+N+DIM+F+PL
upinha	upa+N+DIM+F+SG
upinhas	upa+N+DIM+F+PL
upabilidade	upabilidade+N+F+SG
upabilidades	upabilidade+N+F+PL
upabilidadezinha	upabilidade+N+DIM+F+SG
upabilidadezinhas	upabilidade+N+DIM+F+PL
upabilidadinha	upabilidade+N+DIM+F+SG
upabilidadinhas	upabilidade+N+DIM+F+PL
upanda	upanda+N+F+SG
upandas	upanda+N+F+PL
upandazinha	upanda+N+DIM+F+SG
upandazinhas	upanda+N+DIM+F+PL
upandinha	upanda+N+DIM+F+SG
upandinhas	upanda+N+DIM+F+PL
upgrade	upgrade+N+M+SG
upgrades	upgrade+N+M+PL
upgradezinho	upgrade+N+DIM+M+SG
upgradezinhos	upgrade+N+DIM+M+PL
upgradinho	upgrade+N+DIM+M+SG
upgradinhos	upgrade+N+DIM+M+PL
upupideinho	upupídeo+N+DIM+M+SG
upupideinhos	upupídeo+N+DIM+M+PL
upupideozinho	upupídeo+N+DIM+M+SG
upupideozinhos	upupídeo+N+DIM+M+PL
upupídeo	upupídeo+N+M+SG
upupídeos	upupídeo+N+M+PL
upupidazinho	upúpida+N+DIM+M+SG
upupidazinhos	upúpida+N+DIM+M+PL
upupidinha	upúpida+N+DIM+M+SG
upupidinhas	upúpida+N+DIM+M+PL
upúpida	upúpida+N+M+SG
upúpidas	upúpida+N+M+PL
ura	ura+N+F+SG
uras	ura+N+F+PL
urazinha	ura+N+DIM+F+SG
urazinhas	ura+N+DIM+F+PL
urinha	ura+N+DIM+F+SG
urinhas	ura+N+DIM+F+PL
uraca	uraca+N+F+SG
uracas	uraca+N+F+PL
uracazinha	uraca+N+DIM+F+SG
uracazinhas	uraca+N+DIM+F+PL
uraquinha	uraca+N+DIM+F+SG
uraquinhas	uraca+N+DIM+F+PL
uracila	uracila+N+F+SG
uracilas	uracila+N+F+PL
uracilazinha	uracila+N+DIM+F+SG
uracilazinhas	uracila+N+DIM+F+PL
uracilinha	uracila+N+DIM+F+SG
uracilinhas	uracila+N+DIM+F+PL
uraliana	uraliano+N+F+SG
uralianas	uraliano+N+F+PL
uralianazinha	uraliano+N+DIM+F+SG
uralianazinhas	uraliano+N+DIM+F+PL
uralianinha	uraliano+N+DIM+F+SG
uralianinhas	uraliano+N+DIM+F+PL
uralianinho	uraliano+N+DIM+M+SG
uralianinhos	uraliano+N+DIM+M+PL
uraliano	uraliano+N+M+SG
uralianos	uraliano+N+M+PL
uralianozinho	uraliano+N+DIM+M+SG
uralianozinhos	uraliano+N+DIM+M+PL
uralite	uralite+N+F+SG
uralites	uralite+N+F+PL
uralitezinha	uralite+N+DIM+F+SG
uralitezinhas	uralite+N+DIM+F+PL
uralitinha	uralite+N+DIM+F+SG
uralitinhas	uralite+N+DIM+F+PL
uralitização	uralitização+N+F+SG
uralitizaçãozinha	uralitização+N+DIM+F+SG
uralitizações	uralitização+N+F+PL
uralitizaçõezinhas	uralitização+N+DIM+F+PL
uranelideinho	uranelídeo+N+DIM+M+SG
uranelideinhos	uranelídeo+N+DIM+M+PL
uranelideozinho	uranelídeo+N+DIM+M+SG
uranelideozinhos	uranelídeo+N+DIM+M+PL
uranelídeo	uranelídeo+N+M+SG
uranelídeos	uranelídeo+N+M+PL
uranicidade	uranicidade+N+F+SG
uranicidades	uranicidade+N+F+PL
uranicidadezinha	uranicidade+N+DIM+F+SG
uranicidadezinhas	uranicidade+N+DIM+F+PL
uranicidadinha	uranicidade+N+DIM+F+SG
uranicidadinhas	uranicidade+N+DIM+F+PL
uraninita	uraninita+N+F+SG
uraninitas	uraninita+N+F+PL
uraninitazinha	uraninita+N+DIM+F+SG
uraninitazinhas	uraninita+N+DIM+F+PL
uraninitinha	uraninita+N+DIM+F+SG
uraninitinhas	uraninita+N+DIM+F+PL
uraninite	uraninite+N+F+SG
uraninites	uraninite+N+F+PL
uraninitezinha	uraninite+N+DIM+F+SG
uraninitezinhas	uraninite+N+DIM+F+PL
uraninitinha	uraninite+N+DIM+F+SG
uraninitinhas	uraninite+N+DIM+F+PL
uranisminho	uranismo+N+DIM+M+SG
uranisminhos	uranismo+N+DIM+M+PL
uranismo	uranismo+N+M+SG
uranismos	uranismo+N+M+PL
uranismozinho	uranismo+N+DIM+M+SG
uranismozinhos	uranismo+N+DIM+M+PL
uranista	uranista+N+SG
uranistas	uranista+N+PL
uranistazinha	uranista+N+DIM+F+SG
uranistazinhas	uranista+N+DIM+F+PL
uranistazinho	uranista+N+DIM+M+SG
uranistazinhos	uranista+N+DIM+M+PL
uranistinha	uranista+N+DIM+SG
uranistinhas	uranista+N+DIM+PL
uranite	uranite+N+F+SG
uranites	uranite+N+F+PL
uranitezinha	uranite+N+DIM+F+SG
uranitezinhas	uranite+N+DIM+F+PL
uranitinha	uranite+N+DIM+F+SG
uranitinhas	uranite+N+DIM+F+PL
uraninho	urano+N+DIM+M+SG
uraninhos	urano+N+DIM+M+PL
urano	urano+N+M+SG
uranos	urano+N+M+PL
uranozinho	urano+N+DIM+M+SG
uranozinhos	urano+N+DIM+M+PL
uranografia	uranografia+N+F+SG
uranografias	uranografia+N+F+PL
uranografiazinha	uranografia+N+DIM+F+SG
uranografiazinhas	uranografia+N+DIM+F+PL
uranografinha	uranografia+N+DIM+F+SG
uranografinhas	uranografia+N+DIM+F+PL
uranograficidade	uranograficidade+N+F+SG
uranograficidades	uranograficidade+N+F+PL
uranograficidadezinha	uranograficidade+N+DIM+F+SG
uranograficidadezinhas	uranograficidade+N+DIM+F+PL
uranograficidadinha	uranograficidade+N+DIM+F+SG
uranograficidadinhas	uranograficidade+N+DIM+F+PL
uranologia	uranologia+N+F+SG
uranologias	uranologia+N+F+PL
uranologiazinha	uranologia+N+DIM+F+SG
uranologiazinhas	uranologia+N+DIM+F+PL
uranologinha	uranologia+N+DIM+F+SG
uranologinhas	uranologia+N+DIM+F+PL
uranologicidade	uranologicidade+N+F+SG
uranologicidades	uranologicidade+N+F+PL
uranologicidadezinha	uranologicidade+N+DIM+F+SG
uranologicidadezinhas	uranologicidade+N+DIM+F+PL
uranologicidadinha	uranologicidade+N+DIM+F+SG
uranologicidadinhas	uranologicidade+N+DIM+F+PL
uranometria	uranometria+N+F+SG
uranometrias	uranometria+N+F+PL
uranometriazinha	uranometria+N+DIM+F+SG
uranometriazinhas	uranometria+N+DIM+F+PL
uranometrinha	uranometria+N+DIM+F+SG
uranometrinhas	uranometria+N+DIM+F+PL
uranometricidade	uranometricidade+N+F+SG
uranometricidades	uranometricidade+N+F+PL
uranometricidadezinha	uranometricidade+N+DIM+F+SG
uranometricidadezinhas	uranometricidade+N+DIM+F+PL
uranometricidadinha	uranometricidade+N+DIM+F+SG
uranometricidadinhas	uranometricidade+N+DIM+F+PL
uranoplastia	uranoplastia+N+F+SG
uranoplastias	uranoplastia+N+F+PL
uranoplastiazinha	uranoplastia+N+DIM+F+SG
uranoplastiazinhas	uranoplastia+N+DIM+F+PL
uranoplastinha	uranoplastia+N+DIM+F+SG
uranoplastinhas	uranoplastia+N+DIM+F+PL
uranorama	uranorama+N+M+SG
uranoramas	uranorama+N+M+PL
uranoramazinho	uranorama+N+DIM+M+SG
uranoramazinhos	uranorama+N+DIM+M+PL
uranoraminha	uranorama+N+DIM+M+SG
uranoraminhas	uranorama+N+DIM+M+PL
uranoscopia	uranoscopia+N+F+SG
uranoscopias	uranoscopia+N+F+PL
uranoscopiazinha	uranoscopia+N+DIM+F+SG
uranoscopiazinhas	uranoscopia+N+DIM+F+PL
uranoscopinha	uranoscopia+N+DIM+F+SG
uranoscopinhas	uranoscopia+N+DIM+F+PL
uranofanazinha	uranófano+N+DIM+F+SG
uranofanazinhas	uranófano+N+DIM+F+PL
uranofaninha	uranófano+N+DIM+F+SG
uranofaninhas	uranófano+N+DIM+F+PL
uranofaninho	uranófano+N+DIM+M+SG
uranofaninhos	uranófano+N+DIM+M+PL
uranofanozinho	uranófano+N+DIM+M+SG
uranofanozinhos	uranófano+N+DIM+M+PL
uranófana	uranófano+N+F+SG
uranófanas	uranófano+N+F+PL
uranófano	uranófano+N+M+SG
uranófanos	uranófano+N+M+PL
uranografinho	uranógrafo+N+DIM+M+SG
uranografinhos	uranógrafo+N+DIM+M+PL
uranografozinho	uranógrafo+N+DIM+M+SG
uranografozinhos	uranógrafo+N+DIM+M+PL
uranógrafo	uranógrafo+N+M+SG
uranógrafos	uranógrafo+N+M+PL
uranolitinho	uranólito+N+DIM+M+SG
uranolitinhos	uranólito+N+DIM+M+PL
uranolitozinho	uranólito+N+DIM+M+SG
uranolitozinhos	uranólito+N+DIM+M+PL
uranólito	uranólito+N+M+SG
uranólitos	uranólito+N+M+PL
uranometrinho	uranômetro+N+DIM+M+SG
uranometrinhos	uranômetro+N+DIM+M+PL
uranometrozinho	uranômetro+N+DIM+M+SG
uranometrozinhos	uranômetro+N+DIM+M+PL
uranômetro	uranômetro+N+M+SG
uranômetros	uranômetro+N+M+PL
uraparazinho	urapará+N+DIM+M+SG
uraparazinhos	urapará+N+DIM+M+PL
urapará	urapará+N+M+SG
uraparás	urapará+N+M+PL
uraquitã	uraquitã+N+M+SG
uraquitãs	uraquitã+N+M+PL
uraquitãzinho	uraquitã+N+DIM+M+SG
uraquitãzinhos	uraquitã+N+DIM+M+PL
uratemicidade	uratemicidade+N+F+SG
uratemicidades	uratemicidade+N+F+PL
uratemicidadezinha	uratemicidade+N+DIM+F+SG
uratemicidadezinhas	uratemicidade+N+DIM+F+PL
uratemicidadinha	uratemicidade+N+DIM+F+SG
uratemicidadinhas	uratemicidade+N+DIM+F+PL
uratinho	urato+N+DIM+M+SG
uratinhos	urato+N+DIM+M+PL
urato	urato+N+M+SG
uratos	urato+N+M+PL
uratozinho	urato+N+DIM+M+SG
uratozinhos	urato+N+DIM+M+PL
urbanidade	urbanidade+N+F+SG
urbanidades	urbanidade+N+F+PL
urbanidadezinha	urbanidade+N+DIM+F+SG
urbanidadezinhas	urbanidade+N+DIM+F+PL
urbanidadinha	urbanidade+N+DIM+F+SG
urbanidadinhas	urbanidade+N+DIM+F+PL
urbanisminho	urbanismo+N+DIM+M+SG
urbanisminhos	urbanismo+N+DIM+M+PL
urbanismo	urbanismo+N+M+SG
urbanismos	urbanismo+N+M+PL
urbanismozinho	urbanismo+N+DIM+M+SG
urbanismozinhos	urbanismo+N+DIM+M+PL
urbanista	urbanista+N+SG
urbanistas	urbanista+N+PL
urbanistazinha	urbanista+N+DIM+F+SG
urbanistazinhas	urbanista+N+DIM+F+PL
urbanistazinho	urbanista+N+DIM+M+SG
urbanistazinhos	urbanista+N+DIM+M+PL
urbanistinha	urbanista+N+DIM+SG
urbanistinhas	urbanista+N+DIM+PL
urbanisticidade	urbanisticidade+N+F+SG
urbanisticidades	urbanisticidade+N+F+PL
urbanisticidadezinha	urbanisticidade+N+DIM+F+SG
urbanisticidadezinhas	urbanisticidade+N+DIM+F+PL
urbanisticidadinha	urbanisticidade+N+DIM+F+SG
urbanisticidadinhas	urbanisticidade+N+DIM+F+PL
urbanita	urbanita+N+SG
urbanitas	urbanita+N+PL
urbanitazinha	urbanita+N+DIM+F+SG
urbanitazinhas	urbanita+N+DIM+F+PL
urbanitazinho	urbanita+N+DIM+M+SG
urbanitazinhos	urbanita+N+DIM+M+PL
urbanitinha	urbanita+N+DIM+SG
urbanitinhas	urbanita+N+DIM+PL
urbanizabilidade	urbanizabilidade+N+F+SG
urbanizabilidades	urbanizabilidade+N+F+PL
urbanizabilidadezinha	urbanizabilidade+N+DIM+F+SG
urbanizabilidadezinhas	urbanizabilidade+N+DIM+F+PL
urbanizabilidadinha	urbanizabilidade+N+DIM+F+SG
urbanizabilidadinhas	urbanizabilidade+N+DIM+F+PL
urbanização	urbanização+N+F+SG
urbanizaçãozinha	urbanização+N+DIM+F+SG
urbanizações	urbanização+N+F+PL
urbanizaçõezinhas	urbanização+N+DIM+F+PL
urbe	urbe+N+F+SG
urbes	urbe+N+F+PL
urbezinha	urbe+N+DIM+F+SG
urbezinhas	urbe+N+DIM+F+PL
urbinha	urbe+N+DIM+F+SG
urbinhas	urbe+N+DIM+F+PL
urbicolazinha	urbícola+N+DIM+F+SG
urbicolazinhas	urbícola+N+DIM+F+PL
urbicolazinho	urbícola+N+DIM+M+SG
urbicolazinhos	urbícola+N+DIM+M+PL
urbicolinha	urbícola+N+DIM+SG
urbicolinhas	urbícola+N+DIM+PL
urbícola	urbícola+N+SG
urbícolas	urbícola+N+PL
urbigenazinha	urbígena+N+DIM+F+SG
urbigenazinhas	urbígena+N+DIM+F+PL
urbigenazinho	urbígena+N+DIM+M+SG
urbigenazinhos	urbígena+N+DIM+M+PL
urbigeninha	urbígena+N+DIM+SG
urbigeninhas	urbígena+N+DIM+PL
urbígena	urbígena+N+SG
urbígenas	urbígena+N+PL
urca	urca+N+F+SG
urcas	urca+N+F+PL
urcazinha	urca+N+DIM+F+SG
urcazinhas	urca+N+DIM+F+PL
urquinha	urca+N+DIM+F+SG
urquinhas	urca+N+DIM+F+PL
urceolaridade	urceolaridade+N+F+SG
urceolaridades	urceolaridade+N+F+PL
urceolaridadezinha	urceolaridade+N+DIM+F+SG
urceolaridadezinhas	urceolaridade+N+DIM+F+PL
urceolaridadinha	urceolaridade+N+DIM+F+SG
urceolaridadinhas	urceolaridade+N+DIM+F+PL
urchila	urchila+N+F+SG
urchilas	urchila+N+F+PL
urchilazinha	urchila+N+DIM+F+SG
urchilazinhas	urchila+N+DIM+F+PL
urchilinha	urchila+N+DIM+F+SG
urchilinhas	urchila+N+DIM+F+PL
urcholha	urcholha+N+F+SG
urcholhas	urcholha+N+F+PL
urcholhazinha	urcholha+N+DIM+F+SG
urcholhazinhas	urcholha+N+DIM+F+PL
urcholhinha	urcholha+N+DIM+F+SG
urcholhinhas	urcholha+N+DIM+F+PL
urco	urco+N+M+SG
urcos	urco+N+M+PL
urcozinho	urco+N+DIM+M+SG
urcozinhos	urco+N+DIM+M+PL
urquinho	urco+N+DIM+M+SG
urquinhos	urco+N+DIM+M+PL
urceolazinha	urcéola+N+DIM+F+SG
urceolazinhas	urcéola+N+DIM+F+PL
urceolinha	urcéola+N+DIM+F+SG
urceolinhas	urcéola+N+DIM+F+PL
urcéola	urcéola+N+F+SG
urcéolas	urcéola+N+F+PL
urceolinho	urcéolo+N+DIM+M+SG
urceolinhos	urcéolo+N+DIM+M+PL
urceolozinho	urcéolo+N+DIM+M+SG
urceolozinhos	urcéolo+N+DIM+M+PL
urcéolo	urcéolo+N+M+SG
urcéolos	urcéolo+N+M+PL
urdedinho	urdedo+N+DIM+M+SG
urdedinhos	urdedo+N+DIM+M+PL
urdedo	urdedo+N+M+SG
urdedos	urdedo+N+M+PL
urdedozinho	urdedo+N+DIM+M+SG
urdedozinhos	urdedo+N+DIM+M+PL
urdideira	urdideira+N+F+SG
urdideiras	urdideira+N+F+PL
urdideirazinha	urdideira+N+DIM+F+SG
urdideirazinhas	urdideira+N+DIM+F+PL
urdideirinha	urdideira+N+DIM+F+SG
urdideirinhas	urdideira+N+DIM+F+PL
urdidor	urdidor+N+M+SG
urdidora	urdidor+N+F+SG
urdidoras	urdidor+N+F+PL
urdidorazinha	urdidor+N+DIM+F+SG
urdidorazinhas	urdidor+N+DIM+F+PL
urdidores	urdidor+N+M+PL
urdidorezinhos	urdidor+N+DIM+M+PL
urdidorinha	urdidor+N+DIM+F+SG
urdidorinhas	urdidor+N+DIM+F+PL
urdidorzinho	urdidor+N+DIM+M+SG
urdidorzinhos	urdidor+N+DIM+M+PL
urdidura	urdidura+N+F+SG
urdiduras	urdidura+N+F+PL
urdidurazinha	urdidura+N+DIM+F+SG
urdidurazinhas	urdidura+N+DIM+F+PL
urdidurinha	urdidura+N+DIM+F+SG
urdidurinhas	urdidura+N+DIM+F+PL
urdimalas	urdimalas+N
urdimalasinha	urdimalas+N+DIM+F+SG
urdimalasinhas	urdimalas+N+DIM+F+PL
urdimalasinho	urdimalas+N+DIM+M+SG
urdimalasinhos	urdimalas+N+DIM+M+PL
urdimaças	urdimaças+N
urdimaçasinha	urdimaças+N+DIM+F+SG
urdimaçasinhas	urdimaças+N+DIM+F+PL
urdimaçasinho	urdimaças+N+DIM+M+SG
urdimaçasinhos	urdimaças+N+DIM+M+PL
urdimenta	urdimenta+N+F+SG
urdimentas	urdimenta+N+F+PL
urdimentazinha	urdimenta+N+DIM+F+SG
urdimentazinhas	urdimenta+N+DIM+F+PL
urdimentinha	urdimenta+N+DIM+F+SG
urdimentinhas	urdimenta+N+DIM+F+PL
urdimentinho	urdimento+N+DIM+M+SG
urdimentinhos	urdimento+N+DIM+M+PL
urdimento	urdimento+N+M+SG
urdimentos	urdimento+N+M+PL
urdimentozinho	urdimento+N+DIM+M+SG
urdimentozinhos	urdimento+N+DIM+M+PL
urdu	urdu+N+M+SG
urdus	urdu+N+M+PL
urduzinho	urdu+N+DIM+M+SG
urduzinhos	urdu+N+DIM+M+PL
urdume	urdume+N+M+SG
urdumes	urdume+N+M+PL
urdumezinho	urdume+N+DIM+M+SG
urdumezinhos	urdume+N+DIM+M+PL
urduminho	urdume+N+DIM+M+SG
urduminhos	urdume+N+DIM+M+PL
urease	urease+N+F+SG
ureases	urease+N+F+PL
ureasezinha	urease+N+DIM+F+SG
ureasezinhas	urease+N+DIM+F+PL
ureasinha	urease+N+DIM+F+SG
ureasinhas	urease+N+DIM+F+PL
uredinho	uredo+N+DIM+M+SG
uredinhos	uredo+N+DIM+M+PL
uredo	uredo+N+M+SG
uredos	uredo+N+M+PL
uredozinho	uredo+N+DIM+M+SG
uredozinhos	uredo+N+DIM+M+PL
uredineazinha	uredínea+N+DIM+F+SG
uredineazinhas	uredínea+N+DIM+F+PL
uredineinha	uredínea+N+DIM+F+SG
uredineinhas	uredínea+N+DIM+F+PL
uredínea	uredínea+N+F+SG
uredíneas	uredínea+N+F+PL
uredosporinho	uredósporo+N+DIM+M+SG
uredosporinhos	uredósporo+N+DIM+M+PL
uredosporozinho	uredósporo+N+DIM+M+SG
uredosporozinhos	uredósporo+N+DIM+M+PL
uredósporo	uredósporo+N+M+SG
uredósporos	uredósporo+N+M+PL
ureia	ureia+N+F+SG
ureias	ureia+N+F+PL
ureiazinha	ureia+N+DIM+F+SG
ureiazinhas	ureia+N+DIM+F+PL
ureinha	ureia+N+DIM+F+SG
ureinhas	ureia+N+DIM+F+PL
uremia	uremia+N+F+SG
uremias	uremia+N+F+PL
uremiazinha	uremia+N+DIM+F+SG
uremiazinhas	uremia+N+DIM+F+PL
ureminha	uremia+N+DIM+F+SG
ureminhas	uremia+N+DIM+F+PL
uremicidade	uremicidade+N+F+SG
uremicidades	uremicidade+N+F+PL
uremicidadezinha	uremicidade+N+DIM+F+SG
uremicidadezinhas	uremicidade+N+DIM+F+PL
uremicidadinha	uremicidade+N+DIM+F+SG
uremicidadinhas	uremicidade+N+DIM+F+PL
ureometria	ureometria+N+F+SG
ureometrias	ureometria+N+F+PL
ureometriazinha	ureometria+N+DIM+F+SG
ureometriazinhas	ureometria+N+DIM+F+PL
ureometrinha	ureometria+N+DIM+F+SG
ureometrinhas	ureometria+N+DIM+F+PL
ureotelicidade	ureotelicidade+N+F+SG
ureotelicidades	ureotelicidade+N+F+PL
ureotelicidadezinha	ureotelicidade+N+DIM+F+SG
ureotelicidadezinhas	ureotelicidade+N+DIM+F+PL
ureotelicidadinha	ureotelicidade+N+DIM+F+SG
ureotelicidadinhas	ureotelicidade+N+DIM+F+PL
uretalgia	uretalgia+N+F+SG
uretalgias	uretalgia+N+F+PL
uretalgiazinha	uretalgia+N+DIM+F+SG
uretalgiazinhas	uretalgia+N+DIM+F+PL
uretalginha	uretalgia+N+DIM+F+SG
uretalginhas	uretalgia+N+DIM+F+PL
uretalgicidade	uretalgicidade+N+F+SG
uretalgicidades	uretalgicidade+N+F+PL
uretalgicidadezinha	uretalgicidade+N+DIM+F+SG
uretalgicidadezinhas	uretalgicidade+N+DIM+F+PL
uretalgicidadinha	uretalgicidade+N+DIM+F+SG
uretalgicidadinhas	uretalgicidade+N+DIM+F+PL
uretaninho	uretano+N+DIM+M+SG
uretaninhos	uretano+N+DIM+M+PL
uretano	uretano+N+M+SG
uretanos	uretano+N+M+PL
uretanozinho	uretano+N+DIM+M+SG
uretanozinhos	uretano+N+DIM+M+PL
ureter	ureter+N+M+SG
ureteres	ureter+N+M+PL
ureterezinhos	ureter+N+DIM+M+PL
ureterzinho	ureter+N+DIM+M+SG
ureterzinhos	ureter+N+DIM+M+PL
ureteralgia	ureteralgia+N+F+SG
ureteralgias	ureteralgia+N+F+PL
ureteralgiazinha	ureteralgia+N+DIM+F+SG
ureteralgiazinhas	ureteralgia+N+DIM+F+PL
ureteralginha	ureteralgia+N+DIM+F+SG
ureteralginhas	ureteralgia+N+DIM+F+PL
ureteralidade	ureteralidade+N+F+SG
ureteralidades	ureteralidade+N+F+PL
ureteralidadezinha	ureteralidade+N+DIM+F+SG
ureteralidadezinhas	ureteralidade+N+DIM+F+PL
ureteralidadinha	ureteralidade+N+DIM+F+SG
ureteralidadinhas	ureteralidade+N+DIM+F+PL
ureterectomia	ureterectomia+N+F+SG
ureterectomias	ureterectomia+N+F+PL
ureterectomiazinha	ureterectomia+N+DIM+F+SG
ureterectomiazinhas	ureterectomia+N+DIM+F+PL
ureterectominha	ureterectomia+N+DIM+F+SG
ureterectominhas	ureterectomia+N+DIM+F+PL
ureterectomicidade	ureterectomicidade+N+F+SG
ureterectomicidades	ureterectomicidade+N+F+PL
ureterectomicidadezinha	ureterectomicidade+N+DIM+F+SG
ureterectomicidadezinhas	ureterectomicidade+N+DIM+F+PL
ureterectomicidadinha	ureterectomicidade+N+DIM+F+SG
ureterectomicidadinhas	ureterectomicidade+N+DIM+F+PL
ureterenfracticidade	ureterenfracticidade+N+F+SG
ureterenfracticidades	ureterenfracticidade+N+F+PL
ureterenfracticidadezinha	ureterenfracticidade+N+DIM+F+SG
ureterenfracticidadezinhas	ureterenfracticidade+N+DIM+F+PL
ureterenfracticidadinha	ureterenfracticidade+N+DIM+F+SG
ureterenfracticidadinhas	ureterenfracticidade+N+DIM+F+PL
ureterenfraticidade	ureterenfraticidade+N+F+SG
ureterenfraticidades	ureterenfraticidade+N+F+PL
ureterenfraticidadezinha	ureterenfraticidade+N+DIM+F+SG
ureterenfraticidadezinhas	ureterenfraticidade+N+DIM+F+PL
ureterenfraticidadinha	ureterenfraticidade+N+DIM+F+SG
ureterenfraticidadinhas	ureterenfraticidade+N+DIM+F+PL
uretericidade	uretericidade+N+F+SG
uretericidades	uretericidade+N+F+PL
uretericidadezinha	uretericidade+N+DIM+F+SG
uretericidadezinhas	uretericidade+N+DIM+F+PL
uretericidadinha	uretericidade+N+DIM+F+SG
uretericidadinhas	uretericidade+N+DIM+F+PL
ureterite	ureterite+N+F+SG
ureterites	ureterite+N+F+PL
ureteritezinha	ureterite+N+DIM+F+SG
ureteritezinhas	ureterite+N+DIM+F+PL
ureteritinha	ureterite+N+DIM+F+SG
ureteritinhas	ureterite+N+DIM+F+PL
ureterografia	ureterografia+N+F+SG
ureterografias	ureterografia+N+F+PL
ureterografiazinha	ureterografia+N+DIM+F+SG
ureterografiazinhas	ureterografia+N+DIM+F+PL
ureterografinha	ureterografia+N+DIM+F+SG
ureterografinhas	ureterografia+N+DIM+F+PL
ureterotomia	ureterotomia+N+F+SG
ureterotomias	ureterotomia+N+F+PL
ureterotomiazinha	ureterotomia+N+DIM+F+SG
ureterotomiazinhas	ureterotomia+N+DIM+F+PL
ureterotominha	ureterotomia+N+DIM+F+SG
ureterotominhas	ureterotomia+N+DIM+F+PL
ureterotomicidade	ureterotomicidade+N+F+SG
ureterotomicidades	ureterotomicidade+N+F+PL
ureterotomicidadezinha	ureterotomicidade+N+DIM+F+SG
ureterotomicidadezinhas	ureterotomicidade+N+DIM+F+PL
ureterotomicidadinha	ureterotomicidade+N+DIM+F+SG
ureterotomicidadinhas	ureterotomicidade+N+DIM+F+PL
ureticidade	ureticidade+N+F+SG
ureticidades	ureticidade+N+F+PL
ureticidadezinha	ureticidade+N+DIM+F+SG
ureticidadezinhas	ureticidade+N+DIM+F+PL
ureticidadinha	ureticidade+N+DIM+F+SG
ureticidadinhas	ureticidade+N+DIM+F+PL
uretra	uretra+N+F+SG
uretras	uretra+N+F+PL
uretrazinha	uretra+N+DIM+F+SG
uretrazinhas	uretra+N+DIM+F+PL
uretrinha	uretra+N+DIM+F+SG
uretrinhas	uretra+N+DIM+F+PL
uretralgia	uretralgia+N+F+SG
uretralgias	uretralgia+N+F+PL
uretralgiazinha	uretralgia+N+DIM+F+SG
uretralgiazinhas	uretralgia+N+DIM+F+PL
uretralginha	uretralgia+N+DIM+F+SG
uretralginhas	uretralgia+N+DIM+F+PL
uretralgicidade	uretralgicidade+N+F+SG
uretralgicidades	uretralgicidade+N+F+PL
uretralgicidadezinha	uretralgicidade+N+DIM+F+SG
uretralgicidadezinhas	uretralgicidade+N+DIM+F+PL
uretralgicidadinha	uretralgicidade+N+DIM+F+SG
uretralgicidadinhas	uretralgicidade+N+DIM+F+PL
uretralidade	uretralidade+N+F+SG
uretralidades	uretralidade+N+F+PL
uretralidadezinha	uretralidade+N+DIM+F+SG
uretralidadezinhas	uretralidade+N+DIM+F+PL
uretralidadinha	uretralidade+N+DIM+F+SG
uretralidadinhas	uretralidade+N+DIM+F+PL
uretrectomia	uretrectomia+N+F+SG
uretrectomias	uretrectomia+N+F+PL
uretrectomiazinha	uretrectomia+N+DIM+F+SG
uretrectomiazinhas	uretrectomia+N+DIM+F+PL
uretrectominha	uretrectomia+N+DIM+F+SG
uretrectominhas	uretrectomia+N+DIM+F+PL
uretrectomicidade	uretrectomicidade+N+F+SG
uretrectomicidades	uretrectomicidade+N+F+PL
uretrectomicidadezinha	uretrectomicidade+N+DIM+F+SG
uretrectomicidadezinhas	uretrectomicidade+N+DIM+F+PL
uretrectomicidadinha	uretrectomicidade+N+DIM+F+SG
uretrectomicidadinhas	uretrectomicidade+N+DIM+F+PL
uretricidade	uretricidade+N+F+SG
uretricidades	uretricidade+N+F+PL
uretricidadezinha	uretricidade+N+DIM+F+SG
uretricidadezinhas	uretricidade+N+DIM+F+PL
uretricidadinha	uretricidade+N+DIM+F+SG
uretricidadinhas	uretricidade+N+DIM+F+PL
uretrite	uretrite+N+F+SG
uretrites	uretrite+N+F+PL
uretritezinha	uretrite+N+DIM+F+SG
uretritezinhas	uretrite+N+DIM+F+PL
uretritinha	uretrite+N+DIM+F+SG
uretritinhas	uretrite+N+DIM+F+PL
uretrocistotomia	uretrocistotomia+N+F+SG
uretrocistotomias	uretrocistotomia+N+F+PL
uretrocistotomiazinha	uretrocistotomia+N+DIM+F+SG
uretrocistotomiazinhas	uretrocistotomia+N+DIM+F+PL
uretrocistotominha	uretrocistotomia+N+DIM+F+SG
uretrocistotominhas	uretrocistotomia+N+DIM+F+PL
uretrocistotomicidade	uretrocistotomicidade+N+F+SG
uretrocistotomicidades	uretrocistotomicidade+N+F+PL
uretrocistotomicidadezinha	uretrocistotomicidade+N+DIM+F+SG
uretrocistotomicidadezinhas	uretrocistotomicidade+N+DIM+F+PL
uretrocistotomicidadinha	uretrocistotomicidade+N+DIM+F+SG
uretrocistotomicidadinhas	uretrocistotomicidade+N+DIM+F+PL
uretrodinia	uretrodinia+N+F+SG
uretrodinias	uretrodinia+N+F+PL
uretrodiniazinha	uretrodinia+N+DIM+F+SG
uretrodiniazinhas	uretrodinia+N+DIM+F+PL
uretrodininha	uretrodinia+N+DIM+F+SG
uretrodininhas	uretrodinia+N+DIM+F+PL
uretrofracticidade	uretrofracticidade+N+F+SG
uretrofracticidades	uretrofracticidade+N+F+PL
uretrofracticidadezinha	uretrofracticidade+N+DIM+F+SG
uretrofracticidadezinhas	uretrofracticidade+N+DIM+F+PL
uretrofracticidadinha	uretrofracticidade+N+DIM+F+SG
uretrofracticidadinhas	uretrofracticidade+N+DIM+F+PL
uretrofraticidade	uretrofraticidade+N+F+SG
uretrofraticidades	uretrofraticidade+N+F+PL
uretrofraticidadezinha	uretrofraticidade+N+DIM+F+SG
uretrofraticidadezinhas	uretrofraticidade+N+DIM+F+PL
uretrofraticidadinha	uretrofraticidade+N+DIM+F+SG
uretrofraticidadinhas	uretrofraticidade+N+DIM+F+PL
uretrofraxia	uretrofraxia+N+F+SG
uretrofraxias	uretrofraxia+N+F+PL
uretrofraxiazinha	uretrofraxia+N+DIM+F+SG
uretrofraxiazinhas	uretrofraxia+N+DIM+F+PL
uretrofraxinha	uretrofraxia+N+DIM+F+SG
uretrofraxinhas	uretrofraxia+N+DIM+F+PL
uretrorragia	uretrorragia+N+F+SG
uretrorragias	uretrorragia+N+F+PL
uretrorragiazinha	uretrorragia+N+DIM+F+SG
uretrorragiazinhas	uretrorragia+N+DIM+F+PL
uretrorraginha	uretrorragia+N+DIM+F+SG
uretrorraginhas	uretrorragia+N+DIM+F+PL
uretrorrectalidade	uretrorrectalidade+N+F+SG
uretrorrectalidades	uretrorrectalidade+N+F+PL
uretrorrectalidadezinha	uretrorrectalidade+N+DIM+F+SG
uretrorrectalidadezinhas	uretrorrectalidade+N+DIM+F+PL
uretrorrectalidadinha	uretrorrectalidade+N+DIM+F+SG
uretrorrectalidadinhas	uretrorrectalidade+N+DIM+F+PL
uretrorreia	uretrorreia+N+F+SG
uretrorreias	uretrorreia+N+F+PL
uretrorreiazinha	uretrorreia+N+DIM+F+SG
uretrorreiazinhas	uretrorreia+N+DIM+F+PL
uretrorreinha	uretrorreia+N+DIM+F+SG
uretrorreinhas	uretrorreia+N+DIM+F+PL
uretrorretalidade	uretrorretalidade+N+F+SG
uretrorretalidades	uretrorretalidade+N+F+PL
uretrorretalidadezinha	uretrorretalidade+N+DIM+F+SG
uretrorretalidadezinhas	uretrorretalidade+N+DIM+F+PL
uretrorretalidadinha	uretrorretalidade+N+DIM+F+SG
uretrorretalidadinhas	uretrorretalidade+N+DIM+F+PL
uretroscopia	uretroscopia+N+F+SG
uretroscopias	uretroscopia+N+F+PL
uretroscopiazinha	uretroscopia+N+DIM+F+SG
uretroscopiazinhas	uretroscopia+N+DIM+F+PL
uretroscopinha	uretroscopia+N+DIM+F+SG
uretroscopinhas	uretroscopia+N+DIM+F+PL
uretroscopicidade	uretroscopicidade+N+F+SG
uretroscopicidades	uretroscopicidade+N+F+PL
uretroscopicidadezinha	uretroscopicidade+N+DIM+F+SG
uretroscopicidadezinhas	uretroscopicidade+N+DIM+F+PL
uretroscopicidadinha	uretroscopicidade+N+DIM+F+SG
uretroscopicidadinhas	uretroscopicidade+N+DIM+F+PL
uretroscopinho	uretroscópio+N+DIM+M+SG
uretroscopinhos	uretroscópio+N+DIM+M+PL
uretroscopiozinho	uretroscópio+N+DIM+M+SG
uretroscopiozinhos	uretroscópio+N+DIM+M+PL
uretroscópio	uretroscópio+N+M+SG
uretroscópios	uretroscópio+N+M+PL
uretrostenia	uretrostenia+N+F+SG
uretrostenias	uretrostenia+N+F+PL
uretrosteniazinha	uretrostenia+N+DIM+F+SG
uretrosteniazinhas	uretrostenia+N+DIM+F+PL
uretrosteninha	uretrostenia+N+DIM+F+SG
uretrosteninhas	uretrostenia+N+DIM+F+PL
uretrostenicidade	uretrostenicidade+N+F+SG
uretrostenicidades	uretrostenicidade+N+F+PL
uretrostenicidadezinha	uretrostenicidade+N+DIM+F+SG
uretrostenicidadezinhas	uretrostenicidade+N+DIM+F+PL
uretrostenicidadinha	uretrostenicidade+N+DIM+F+SG
uretrostenicidadinhas	uretrostenicidade+N+DIM+F+PL
uretrostenose	uretrostenose+N+F+SG
uretrostenoses	uretrostenose+N+F+PL
uretrostenosezinha	uretrostenose+N+DIM+F+SG
uretrostenosezinhas	uretrostenose+N+DIM+F+PL
uretrostenosinha	uretrostenose+N+DIM+F+SG
uretrostenosinhas	uretrostenose+N+DIM+F+PL
uretrostomia	uretrostomia+N+F+SG
uretrostomias	uretrostomia+N+F+PL
uretrostomiazinha	uretrostomia+N+DIM+F+SG
uretrostomiazinhas	uretrostomia+N+DIM+F+PL
uretrostominha	uretrostomia+N+DIM+F+SG
uretrostominhas	uretrostomia+N+DIM+F+PL
uretrotomia	uretrotomia+N+F+SG
uretrotomias	uretrotomia+N+F+PL
uretrotomiazinha	uretrotomia+N+DIM+F+SG
uretrotomiazinhas	uretrotomia+N+DIM+F+PL
uretrotominha	uretrotomia+N+DIM+F+SG
uretrotominhas	uretrotomia+N+DIM+F+PL
uretrotomicidade	uretrotomicidade+N+F+SG
uretrotomicidades	uretrotomicidade+N+F+PL
uretrotomicidadezinha	uretrotomicidade+N+DIM+F+SG
uretrotomicidadezinhas	uretrotomicidade+N+DIM+F+PL
uretrotomicidadinha	uretrotomicidade+N+DIM+F+SG
uretrotomicidadinhas	uretrotomicidade+N+DIM+F+PL
uretrovaginalidade	uretrovaginalidade+N+F+SG
uretrovaginalidades	uretrovaginalidade+N+F+PL
uretrovaginalidadezinha	uretrovaginalidade+N+DIM+F+SG
uretrovaginalidadezinhas	uretrovaginalidade+N+DIM+F+PL
uretrovaginalidadinha	uretrovaginalidade+N+DIM+F+SG
uretrovaginalidadinhas	uretrovaginalidade+N+DIM+F+PL
uretrovesicalidade	uretrovesicalidade+N+F+SG
uretrovesicalidades	uretrovesicalidade+N+F+PL
uretrovesicalidadezinha	uretrovesicalidade+N+DIM+F+SG
uretrovesicalidadezinhas	uretrovesicalidade+N+DIM+F+PL
uretrovesicalidadinha	uretrovesicalidade+N+DIM+F+SG
uretrovesicalidadinhas	uretrovesicalidade+N+DIM+F+PL
ureometrinho	ureómetro+N+DIM+M+SG
ureometrinhos	ureómetro+N+DIM+M+PL
ureometrozinho	ureómetro+N+DIM+M+SG
ureometrozinhos	ureómetro+N+DIM+M+PL
ureómetro	ureómetro+N+M+SG
ureómetros	ureómetro+N+M+PL
ureometrinho	ureômetro+N+DIM+M+SG
ureometrinhos	ureômetro+N+DIM+M+PL
ureometrozinho	ureômetro+N+DIM+M+SG
ureometrozinhos	ureômetro+N+DIM+M+PL
ureômetro	ureômetro+N+M+SG
ureômetros	ureômetro+N+M+PL
urgebão	urgebão+N+M+SG
urgebãozinho	urgebão+N+DIM+M+SG
urgebões	urgebão+N+M+PL
urgebõezinhos	urgebão+N+DIM+M+PL
urgemanta	urgemanta+N+F+SG
urgemantas	urgemanta+N+F+PL
urgemantazinha	urgemanta+N+DIM+F+SG
urgemantazinhas	urgemanta+N+DIM+F+PL
urgemantinha	urgemanta+N+DIM+F+SG
urgemantinhas	urgemanta+N+DIM+F+PL
urgevão	urgevão+N+M+SG
urgevãozinho	urgevão+N+DIM+M+SG
urgevões	urgevão+N+M+PL
urgevõezinhos	urgevão+N+DIM+M+PL
urgueira	urgueira+N+F+SG
urgueiras	urgueira+N+F+PL
urgueirazinha	urgueira+N+DIM+F+SG
urgueirazinhas	urgueira+N+DIM+F+PL
urgueirinha	urgueira+N+DIM+F+SG
urgueirinhas	urgueira+N+DIM+F+PL
urgueirais	urgueiral+N+M+PL
urgueiraizinhos	urgueiral+N+DIM+M+PL
urgueiral	urgueiral+N+M+SG
urgueiralzinho	urgueiral+N+DIM+M+SG
urgenciazinha	urgência+N+DIM+F+SG
urgenciazinhas	urgência+N+DIM+F+PL
urgencinha	urgência+N+DIM+F+SG
urgencinhas	urgência+N+DIM+F+PL
urgência	urgência+N+F+SG
urgências	urgência+N+F+PL
uri	uri+N+M+SG
uris	uri+N+M+PL
urizinho	uri+N+DIM+M+SG
urizinhos	uri+N+DIM+M+PL
uricana	uricana+N+F+SG
uricanas	uricana+N+F+PL
uricanazinha	uricana+N+DIM+F+SG
uricanazinhas	uricana+N+DIM+F+PL
uricaninha	uricana+N+DIM+F+SG
uricaninhas	uricana+N+DIM+F+PL
uricemia	uricemia+N+F+SG
uricemias	uricemia+N+F+PL
uricemiazinha	uricemia+N+DIM+F+SG
uricemiazinhas	uricemia+N+DIM+F+PL
uriceminha	uricemia+N+DIM+F+SG
uriceminhas	uricemia+N+DIM+F+PL
uricemicidade	uricemicidade+N+F+SG
uricemicidades	uricemicidade+N+F+PL
uricemicidadezinha	uricemicidade+N+DIM+F+SG
uricemicidadezinhas	uricemicidade+N+DIM+F+PL
uricemicidadinha	uricemicidade+N+DIM+F+SG
uricemicidadinhas	uricemicidade+N+DIM+F+PL
uricidade	uricidade+N+F+SG
uricidades	uricidade+N+F+PL
uricidadezinha	uricidade+N+DIM+F+SG
uricidadezinhas	uricidade+N+DIM+F+PL
uricidadinha	uricidade+N+DIM+F+SG
uricidadinhas	uricidade+N+DIM+F+PL
uridina	uridina+N+F+SG
uridinas	uridina+N+F+PL
uridinazinha	uridina+N+DIM+F+SG
uridinazinhas	uridina+N+DIM+F+PL
uridininha	uridina+N+DIM+F+SG
uridininhas	uridina+N+DIM+F+PL
urina	urina+N+F+SG
urinas	urina+N+F+PL
urinazinha	urina+N+DIM+F+SG
urinazinhas	urina+N+DIM+F+PL
urininha	urina+N+DIM+F+SG
urininhas	urina+N+DIM+F+PL
urinabilidade	urinabilidade+N+F+SG
urinabilidades	urinabilidade+N+F+PL
urinabilidadezinha	urinabilidade+N+DIM+F+SG
urinabilidadezinhas	urinabilidade+N+DIM+F+PL
urinabilidadinha	urinabilidade+N+DIM+F+SG
urinabilidadinhas	urinabilidade+N+DIM+F+PL
urinação	urinação+N+F+SG
urinaçãozinha	urinação+N+DIM+F+SG
urinações	urinação+N+F+PL
urinaçõezinhas	urinação+N+DIM+F+PL
urinoizinhos	urinol+N+DIM+M+PL
urinol	urinol+N+M+SG
urinolzinho	urinol+N+DIM+M+SG
urinóis	urinol+N+M+PL
urinosidade	urinosidade+N+F+SG
urinosidades	urinosidade+N+F+PL
urinosidadezinha	urinosidade+N+DIM+F+SG
urinosidadezinhas	urinosidade+N+DIM+F+PL
urinosidadinha	urinosidade+N+DIM+F+SG
urinosidadinhas	urinosidade+N+DIM+F+PL
uritutu	uritutu+N+M+SG
uritutus	uritutu+N+M+PL
uritutuzinho	uritutu+N+DIM+M+SG
uritutuzinhos	uritutu+N+DIM+M+PL
urna	urna+N+F+SG
urnas	urna+N+F+PL
urnazinha	urna+N+DIM+F+SG
urnazinhas	urna+N+DIM+F+PL
urninha	urna+N+DIM+F+SG
urninhas	urna+N+DIM+F+PL
urnarinho	urnário+N+DIM+M+SG
urnarinhos	urnário+N+DIM+M+PL
urnariozinho	urnário+N+DIM+M+SG
urnariozinhos	urnário+N+DIM+M+PL
urnário	urnário+N+M+SG
urnários	urnário+N+M+PL
urinho	uro+N+DIM+M+SG
urinhos	uro+N+DIM+M+PL
uro	uro+N+M+SG
uros	uro+N+M+PL
urozinho	uro+N+DIM+M+SG
urozinhos	uro+N+DIM+M+PL
urobilina	urobilina+N+F+SG
urobilinas	urobilina+N+F+PL
urobilinazinha	urobilina+N+DIM+F+SG
urobilinazinhas	urobilina+N+DIM+F+PL
urobilininha	urobilina+N+DIM+F+SG
urobilininhas	urobilina+N+DIM+F+PL
urociste	urociste+N+F+SG
urocistes	urociste+N+F+PL
urocistezinha	urociste+N+DIM+F+SG
urocistezinhas	urociste+N+DIM+F+PL
urocistinha	urociste+N+DIM+F+SG
urocistinhas	urociste+N+DIM+F+PL
urocistite	urocistite+N+F+SG
urocistites	urocistite+N+F+PL
urocistitezinha	urocistite+N+DIM+F+SG
urocistitezinhas	urocistite+N+DIM+F+PL
urocistitinha	urocistite+N+DIM+F+SG
urocistitinhas	urocistite+N+DIM+F+PL
urocistinho	urocisto+N+DIM+M+SG
urocistinhos	urocisto+N+DIM+M+PL
urocisto	urocisto+N+M+SG
urocistos	urocisto+N+M+PL
urocistozinho	urocisto+N+DIM+M+SG
urocistozinhos	urocisto+N+DIM+M+PL
urocordadinho	urocordado+N+DIM+M+SG
urocordadinhos	urocordado+N+DIM+M+PL
urocordado	urocordado+N+M+SG
urocordados	urocordado+N+M+PL
urocordadozinho	urocordado+N+DIM+M+SG
urocordadozinhos	urocordado+N+DIM+M+PL
urocrisia	urocrisia+N+F+SG
urocrisias	urocrisia+N+F+PL
urocrisiazinha	urocrisia+N+DIM+F+SG
urocrisiazinhas	urocrisia+N+DIM+F+PL
urocrisinha	urocrisia+N+DIM+F+SG
urocrisinhas	urocrisia+N+DIM+F+PL
urocriticidade	urocriticidade+N+F+SG
urocriticidades	urocriticidade+N+F+PL
urocriticidadezinha	urocriticidade+N+DIM+F+SG
urocriticidadezinhas	urocriticidade+N+DIM+F+PL
urocriticidadinha	urocriticidade+N+DIM+F+SG
urocriticidadinhas	urocriticidade+N+DIM+F+PL
urocroma	urocroma+N+M+SG
urocromas	urocroma+N+M+PL
urocromazinho	urocroma+N+DIM+M+SG
urocromazinhos	urocroma+N+DIM+M+PL
urocrominha	urocroma+N+DIM+M+SG
urocrominhas	urocroma+N+DIM+M+PL
urocultura	urocultura+N+F+SG
uroculturas	urocultura+N+F+PL
uroculturazinha	urocultura+N+DIM+F+SG
uroculturazinhas	urocultura+N+DIM+F+PL
uroculturinha	urocultura+N+DIM+F+SG
uroculturinhas	urocultura+N+DIM+F+PL
urodelinho	urodelo+N+DIM+M+SG
urodelinhos	urodelo+N+DIM+M+PL
urodelo	urodelo+N+M+SG
urodelos	urodelo+N+M+PL
urodelozinho	urodelo+N+DIM+M+SG
urodelozinhos	urodelo+N+DIM+M+PL
urodinia	urodinia+N+F+SG
urodinias	urodinia+N+F+PL
urodiniazinha	urodinia+N+DIM+F+SG
urodiniazinhas	urodinia+N+DIM+F+PL
urodininha	urodinia+N+DIM+F+SG
urodininhas	urodinia+N+DIM+F+PL
urofilia	urofilia+N+F+SG
urofilias	urofilia+N+F+PL
urofiliazinha	urofilia+N+DIM+F+SG
urofiliazinhas	urofilia+N+DIM+F+PL
urofilinha	urofilia+N+DIM+F+SG
urofilinhas	urofilia+N+DIM+F+PL
urogenitalidade	urogenitalidade+N+F+SG
urogenitalidades	urogenitalidade+N+F+PL
urogenitalidadezinha	urogenitalidade+N+DIM+F+SG
urogenitalidadezinhas	urogenitalidade+N+DIM+F+PL
urogenitalidadinha	urogenitalidade+N+DIM+F+SG
urogenitalidadinhas	urogenitalidade+N+DIM+F+PL
urografia	urografia+N+F+SG
urografias	urografia+N+F+PL
urografiazinha	urografia+N+DIM+F+SG
urografiazinhas	urografia+N+DIM+F+PL
urografinha	urografia+N+DIM+F+SG
urografinhas	urografia+N+DIM+F+PL
urologia	urologia+N+F+SG
urologias	urologia+N+F+PL
urologiazinha	urologia+N+DIM+F+SG
urologiazinhas	urologia+N+DIM+F+PL
urologinha	urologia+N+DIM+F+SG
urologinhas	urologia+N+DIM+F+PL
urologicidade	urologicidade+N+F+SG
urologicidades	urologicidade+N+F+PL
urologicidadezinha	urologicidade+N+DIM+F+SG
urologicidadezinhas	urologicidade+N+DIM+F+PL
urologicidadinha	urologicidade+N+DIM+F+SG
urologicidadinhas	urologicidade+N+DIM+F+PL
urologista	urologista+N+SG
urologistas	urologista+N+PL
urologistazinha	urologista+N+DIM+F+SG
urologistazinhas	urologista+N+DIM+F+PL
urologistazinho	urologista+N+DIM+M+SG
urologistazinhos	urologista+N+DIM+M+PL
urologistinha	urologista+N+DIM+SG
urologistinhas	urologista+N+DIM+PL
uropigialidade	uropigialidade+N+F+SG
uropigialidades	uropigialidade+N+F+PL
uropigialidadezinha	uropigialidade+N+DIM+F+SG
uropigialidadezinhas	uropigialidade+N+DIM+F+PL
uropigialidadinha	uropigialidade+N+DIM+F+SG
uropigialidadinhas	uropigialidade+N+DIM+F+PL
uropoese	uropoese+N+F+SG
uropoeses	uropoese+N+F+PL
uropoesezinha	uropoese+N+DIM+F+SG
uropoesezinhas	uropoese+N+DIM+F+PL
uropoesinha	uropoese+N+DIM+F+SG
uropoesinhas	uropoese+N+DIM+F+PL
uropoiese	uropoiese+N+F+SG
uropoieses	uropoiese+N+F+PL
uropoiesezinha	uropoiese+N+DIM+F+SG
uropoiesezinhas	uropoiese+N+DIM+F+PL
uropoiesinha	uropoiese+N+DIM+F+SG
uropoiesinhas	uropoiese+N+DIM+F+PL
uropiginho	uropígio+N+DIM+M+SG
uropiginhos	uropígio+N+DIM+M+PL
uropigiozinho	uropígio+N+DIM+M+SG
uropigiozinhos	uropígio+N+DIM+M+PL
uropígio	uropígio+N+M+SG
uropígios	uropígio+N+M+PL
uropodinho	uropódio+N+DIM+M+SG
uropodinhos	uropódio+N+DIM+M+PL
uropodiozinho	uropódio+N+DIM+M+SG
uropodiozinhos	uropódio+N+DIM+M+PL
uropódio	uropódio+N+M+SG
uropódios	uropódio+N+M+PL
uroquinase	uroquinase+N+F+SG
uroquinases	uroquinase+N+F+PL
uroquinasezinha	uroquinase+N+DIM+F+SG
uroquinasezinhas	uroquinase+N+DIM+F+PL
uroquinasinha	uroquinase+N+DIM+F+SG
uroquinasinhas	uroquinase+N+DIM+F+PL
uroquesiazinha	uroquésia+N+DIM+F+SG
uroquesiazinhas	uroquésia+N+DIM+F+PL
uroquesinha	uroquésia+N+DIM+F+SG
uroquesinhas	uroquésia+N+DIM+F+PL
uroquésia	uroquésia+N+F+SG
uroquésias	uroquésia+N+F+PL
urorragia	urorragia+N+F+SG
urorragias	urorragia+N+F+PL
urorragiazinha	urorragia+N+DIM+F+SG
urorragiazinhas	urorragia+N+DIM+F+PL
urorraginha	urorragia+N+DIM+F+SG
urorraginhas	urorragia+N+DIM+F+PL
urorreia	urorreia+N+F+SG
urorreias	urorreia+N+F+PL
urorreiazinha	urorreia+N+DIM+F+SG
urorreiazinhas	urorreia+N+DIM+F+PL
urorreinha	urorreia+N+DIM+F+SG
urorreinhas	urorreia+N+DIM+F+PL
uroscopia	uroscopia+N+F+SG
uroscopias	uroscopia+N+F+PL
uroscopiazinha	uroscopia+N+DIM+F+SG
uroscopiazinhas	uroscopia+N+DIM+F+PL
uroscopinha	uroscopia+N+DIM+F+SG
uroscopinhas	uroscopia+N+DIM+F+PL
uroscopicidade	uroscopicidade+N+F+SG
uroscopicidades	uroscopicidade+N+F+PL
uroscopicidadezinha	uroscopicidade+N+DIM+F+SG
uroscopicidadezinhas	uroscopicidade+N+DIM+F+PL
uroscopicidadinha	uroscopicidade+N+DIM+F+SG
uroscopicidadinhas	uroscopicidade+N+DIM+F+PL
urostilinho	urostilo+N+DIM+M+SG
urostilinhos	urostilo+N+DIM+M+PL
urostilo	urostilo+N+M+SG
urostilos	urostilo+N+M+PL
urostilozinho	urostilo+N+DIM+M+SG
urostilozinhos	urostilo+N+DIM+M+PL
urotropina	urotropina+N+F+SG
urotropinas	urotropina+N+F+PL
urotropinazinha	urotropina+N+DIM+F+SG
urotropinazinhas	urotropina+N+DIM+F+PL
urotropininha	urotropina+N+DIM+F+SG
urotropininhas	urotropina+N+DIM+F+PL
uroxantina	uroxantina+N+F+SG
uroxantinas	uroxantina+N+F+PL
uroxantinazinha	uroxantina+N+DIM+F+SG
uroxantinazinhas	uroxantina+N+DIM+F+PL
uroxantininha	uroxantina+N+DIM+F+SG
uroxantininhas	uroxantina+N+DIM+F+PL
urrabilidade	urrabilidade+N+F+SG
urrabilidades	urrabilidade+N+F+PL
urrabilidadezinha	urrabilidade+N+DIM+F+SG
urrabilidadezinhas	urrabilidade+N+DIM+F+PL
urrabilidadinha	urrabilidade+N+DIM+F+SG
urrabilidadinhas	urrabilidade+N+DIM+F+PL
urraca	urraca+N+F+SG
urracas	urraca+N+F+PL
urracazinha	urraca+N+DIM+F+SG
urracazinhas	urraca+N+DIM+F+PL
urraquinha	urraca+N+DIM+F+SG
urraquinhas	urraca+N+DIM+F+PL
urrador	urrador+N+M+SG
urradora	urrador+N+F+SG
urradoras	urrador+N+F+PL
urradorazinha	urrador+N+DIM+F+SG
urradorazinhas	urrador+N+DIM+F+PL
urradores	urrador+N+M+PL
urradorezinhos	urrador+N+DIM+M+PL
urradorinha	urrador+N+DIM+F+SG
urradorinhas	urrador+N+DIM+F+PL
urradorzinho	urrador+N+DIM+M+SG
urradorzinhos	urrador+N+DIM+M+PL
urrinho	urro+N+DIM+M+SG
urrinhos	urro+N+DIM+M+PL
urro	urro+N+M+SG
urros	urro+N+M+PL
urrozinho	urro+N+DIM+M+SG
urrozinhos	urro+N+DIM+M+PL
ursada	ursada+N+F+SG
ursadas	ursada+N+F+PL
ursadazinha	ursada+N+DIM+F+SG
ursadazinhas	ursada+N+DIM+F+PL
ursadinha	ursada+N+DIM+F+SG
ursadinhas	ursada+N+DIM+F+PL
ursa	urso+N+F+SG
ursas	urso+N+F+PL
ursazinha	urso+N+DIM+F+SG
ursazinhas	urso+N+DIM+F+PL
ursinha	urso+N+DIM+F+SG
ursinhas	urso+N+DIM+F+PL
ursinho	urso+N+DIM+M+SG
ursinhos	urso+N+DIM+M+PL
ursita	urso+N+DIM+F+SG
ursitas	urso+N+DIM+F+PL
ursito	urso+N+DIM+M+SG
ursitos	urso+N+DIM+M+PL
urso	urso+N+M+SG
ursos	urso+N+M+PL
ursozinho	urso+N+DIM+M+SG
ursozinhos	urso+N+DIM+M+PL
ursulina	ursulina+N+F+SG
ursulinas	ursulina+N+F+PL
ursulinazinha	ursulina+N+DIM+F+SG
ursulinazinhas	ursulina+N+DIM+F+PL
ursulininha	ursulina+N+DIM+F+SG
ursulininhas	ursulina+N+DIM+F+PL
ursideazinha	ursídeo+N+DIM+F+SG
ursideazinhas	ursídeo+N+DIM+F+PL
ursideinha	ursídeo+N+DIM+F+SG
ursideinhas	ursídeo+N+DIM+F+PL
ursideinho	ursídeo+N+DIM+M+SG
ursideinhos	ursídeo+N+DIM+M+PL
ursideozinho	ursídeo+N+DIM+M+SG
ursideozinhos	ursídeo+N+DIM+M+PL
ursídea	ursídeo+N+F+SG
ursídeas	ursídeo+N+F+PL
ursídeo	ursídeo+N+M+SG
ursídeos	ursídeo+N+M+PL
urticabilidade	urticabilidade+N+F+SG
urticabilidades	urticabilidade+N+F+PL
urticabilidadezinha	urticabilidade+N+DIM+F+SG
urticabilidadezinhas	urticabilidade+N+DIM+F+PL
urticabilidadinha	urticabilidade+N+DIM+F+SG
urticabilidadinhas	urticabilidade+N+DIM+F+PL
urticale	urticale+N+F+SG
urticales	urticale+N+F+PL
urticalezinha	urticale+N+DIM+F+SG
urticalezinhas	urticale+N+DIM+F+PL
urticalinha	urticale+N+DIM+F+SG
urticalinhas	urticale+N+DIM+F+PL
urticação	urticação+N+F+SG
urticaçãozinha	urticação+N+DIM+F+SG
urticações	urticação+N+F+PL
urticaçõezinhas	urticação+N+DIM+F+PL
urticaceazinha	urticácea+N+DIM+F+SG
urticaceazinhas	urticácea+N+DIM+F+PL
urticaceinha	urticácea+N+DIM+F+SG
urticaceinhas	urticácea+N+DIM+F+PL
urticácea	urticácea+N+F+SG
urticáceas	urticácea+N+F+PL
urticariazinha	urticária+N+DIM+F+SG
urticariazinhas	urticária+N+DIM+F+PL
urticarinha	urticária+N+DIM+F+SG
urticarinhas	urticária+N+DIM+F+PL
urticária	urticária+N+F+SG
urticárias	urticária+N+F+PL
urtiga	urtiga+N+F+SG
urtigas	urtiga+N+F+PL
urtigazinha	urtiga+N+DIM+F+SG
urtigazinhas	urtiga+N+DIM+F+PL
urtiguinha	urtiga+N+DIM+F+SG
urtiguinhas	urtiga+N+DIM+F+PL
urtigão	urtiga+N+AUG+M+SG
urtigãozinho	urtiga+N+AUG+DIM+M+SG
urtigões	urtiga+N+AUG+M+PL
urtigõezinhos	urtiga+N+AUG+DIM+M+PL
urtigabilidade	urtigabilidade+N+F+SG
urtigabilidades	urtigabilidade+N+F+PL
urtigabilidadezinha	urtigabilidade+N+DIM+F+SG
urtigabilidadezinhas	urtigabilidade+N+DIM+F+PL
urtigabilidadinha	urtigabilidade+N+DIM+F+SG
urtigabilidadinhas	urtigabilidade+N+DIM+F+PL
urtigada	urtigada+N+F+SG
urtigadas	urtigada+N+F+PL
urtigadazinha	urtigada+N+DIM+F+SG
urtigadazinhas	urtigada+N+DIM+F+PL
urtigadinha	urtigada+N+DIM+F+SG
urtigadinhas	urtigada+N+DIM+F+PL
urtigais	urtigal+N+M+PL
urtigaizinhos	urtigal+N+DIM+M+PL
urtigal	urtigal+N+M+SG
urtigalzinho	urtigal+N+DIM+M+SG
urtigação	urtigação+N+F+SG
urtigaçãozinha	urtigação+N+DIM+F+SG
urtigações	urtigação+N+F+PL
urtigaçõezinhas	urtigação+N+DIM+F+PL
urtigão	urtigão+N+M+SG
urtigãozinho	urtigão+N+DIM+M+SG
urtigões	urtigão+N+M+PL
urtigõezinhos	urtigão+N+DIM+M+PL
urticeazinha	urtícea+N+DIM+F+SG
urticeazinhas	urtícea+N+DIM+F+PL
urticeinha	urtícea+N+DIM+F+SG
urticeinhas	urtícea+N+DIM+F+PL
urtícea	urtícea+N+F+SG
urtíceas	urtícea+N+F+PL
uru	uru+N+M+SG
urus	uru+N+M+PL
uruzinho	uru+N+DIM+M+SG
uruzinhos	uru+N+DIM+M+PL
urubu	urubu+N+M+SG
urubus	urubu+N+M+PL
urubuzinho	urubu+N+DIM+M+SG
urubuzinhos	urubu+N+DIM+M+PL
urubuzinhinho	urubuzinho+N+DIM+M+SG
urubuzinhinhos	urubuzinho+N+DIM+M+PL
urubuzinho	urubuzinho+N+M+SG
urubuzinhos	urubuzinho+N+M+PL
urubuzinhozinho	urubuzinho+N+DIM+M+SG
urubuzinhozinhos	urubuzinho+N+DIM+M+PL
urucari	urucari+N+M+SG
urucaris	urucari+N+M+PL
urucarizinho	urucari+N+DIM+M+SG
urucarizinhos	urucari+N+DIM+M+PL
urucu	urucu+N+M+SG
urucus	urucu+N+M+PL
urucuzinho	urucu+N+DIM+M+SG
urucuzinhos	urucu+N+DIM+M+PL
urucubaca	urucubaca+N+F+SG
urucubacas	urucubaca+N+F+PL
urucubacazinha	urucubaca+N+DIM+F+SG
urucubacazinhas	urucubaca+N+DIM+F+PL
urucubaquinha	urucubaca+N+DIM+F+SG
urucubaquinhas	urucubaca+N+DIM+F+PL
urucueirinho	urucueiro+N+DIM+M+SG
urucueirinhos	urucueiro+N+DIM+M+PL
urucueiro	urucueiro+N+M+SG
urucueiros	urucueiro+N+M+PL
urucueirozinho	urucueiro+N+DIM+M+SG
urucueirozinhos	urucueiro+N+DIM+M+PL
urucum	urucum+N+M+SG
urucuns	urucum+N+M+PL
urucunzinho	urucum+N+DIM+M+SG
urucunzinhos	urucum+N+DIM+M+PL
urucuri	urucuri+N+M+SG
urucuris	urucuri+N+M+PL
urucurizinho	urucuri+N+DIM+M+SG
urucurizinhos	urucuri+N+DIM+M+PL
urucuuba	urucuuba+N+F+SG
urucuubas	urucuuba+N+F+PL
urucuubazinha	urucuuba+N+DIM+F+SG
urucuubazinhas	urucuuba+N+DIM+F+PL
urucuubinha	urucuuba+N+DIM+F+SG
urucuubinhas	urucuuba+N+DIM+F+PL
urucuzeirinho	urucuzeiro+N+DIM+M+SG
urucuzeirinhos	urucuzeiro+N+DIM+M+PL
urucuzeiro	urucuzeiro+N+M+SG
urucuzeiros	urucuzeiro+N+M+PL
urucuzeirozinho	urucuzeiro+N+DIM+M+SG
urucuzeirozinhos	urucuzeiro+N+DIM+M+PL
uruguaia	uruguaio+N+F+SG
uruguaias	uruguaio+N+F+PL
uruguaiazinha	uruguaio+N+DIM+F+SG
uruguaiazinhas	uruguaio+N+DIM+F+PL
uruguainha	uruguaio+N+DIM+F+SG
uruguainhas	uruguaio+N+DIM+F+PL
uruguainho	uruguaio+N+DIM+M+SG
uruguainhos	uruguaio+N+DIM+M+PL
uruguaio	uruguaio+N+M+SG
uruguaios	uruguaio+N+M+PL
uruguaiozinho	uruguaio+N+DIM+M+SG
uruguaiozinhos	uruguaio+N+DIM+M+PL
urumbeba	urumbeba+N+M+SG
urumbebas	urumbeba+N+M+PL
urumbebazinho	urumbeba+N+DIM+M+SG
urumbebazinhos	urumbeba+N+DIM+M+PL
urumbebinha	urumbeba+N+DIM+M+SG
urumbebinhas	urumbeba+N+DIM+M+PL
urumbeva	urumbeva+N+M+SG
urumbevas	urumbeva+N+M+PL
urumbevazinho	urumbeva+N+DIM+M+SG
urumbevazinhos	urumbeva+N+DIM+M+PL
urumbevinha	urumbeva+N+DIM+M+SG
urumbevinhas	urumbeva+N+DIM+M+PL
urupema	urupema+N+F+SG
urupemas	urupema+N+F+PL
urupemazinha	urupema+N+DIM+F+SG
urupemazinhas	urupema+N+DIM+F+PL
urupeminha	urupema+N+DIM+F+SG
urupeminhas	urupema+N+DIM+F+PL
urupemba	urupemba+N+F+SG
urupembas	urupemba+N+F+PL
urupembazinha	urupemba+N+DIM+F+SG
urupembazinhas	urupemba+N+DIM+F+PL
urupembinha	urupemba+N+DIM+F+SG
urupembinhas	urupemba+N+DIM+F+PL
urupuca	urupuca+N+F+SG
urupucas	urupuca+N+F+PL
urupucazinha	urupuca+N+DIM+F+SG
urupucazinhas	urupuca+N+DIM+F+PL
urupuquinha	urupuca+N+DIM+F+SG
urupuquinhas	urupuca+N+DIM+F+PL
urupezinho	urupê+N+DIM+M+SG
urupezinhos	urupê+N+DIM+M+PL
urupê	urupê+N+M+SG
urupês	urupê+N+M+PL
ururuguaia	ururuguaio+N+F+SG
ururuguaias	ururuguaio+N+F+PL
ururuguaiazinha	ururuguaio+N+DIM+F+SG
ururuguaiazinhas	ururuguaio+N+DIM+F+PL
ururuguainha	ururuguaio+N+DIM+F+SG
ururuguainhas	ururuguaio+N+DIM+F+PL
ururuguainho	ururuguaio+N+DIM+M+SG
ururuguainhos	ururuguaio+N+DIM+M+PL
ururuguaio	ururuguaio+N+M+SG
ururuguaios	ururuguaio+N+M+PL
ururuguaiozinho	ururuguaio+N+DIM+M+SG
ururuguaiozinhos	ururuguaio+N+DIM+M+PL
urutagua	urutagua+N+F+SG
urutaguas	urutagua+N+F+PL
urutaguazinha	urutagua+N+DIM+F+SG
urutaguazinhas	urutagua+N+DIM+F+PL
urutaguinha	urutagua+N+DIM+F+SG
urutaguinhas	urutagua+N+DIM+F+PL
urutau	urutau+N+M+SG
urutaus	urutau+N+M+PL
urutauzinho	urutau+N+DIM+M+SG
urutauzinhos	urutau+N+DIM+M+PL
urutu	urutu+N+SG
urutus	urutu+N+PL
urutuzinha	urutu+N+DIM+F+SG
urutuzinhas	urutu+N+DIM+F+PL
urutuzinho	urutu+N+DIM+M+SG
urutuzinhos	urutu+N+DIM+M+PL
uruçu	uruçu+N+M+SG
uruçus	uruçu+N+M+PL
uruçuzinho	uruçu+N+DIM+M+SG
uruçuzinhos	uruçu+N+DIM+M+PL
uruçumirim	uruçumirim+N+M+SG
uruçumirins	uruçumirim+N+M+PL
uruçumirinzinho	uruçumirim+N+DIM+M+SG
uruçumirinzinhos	uruçumirim+N+DIM+M+PL
urzais	urzal+N+M+PL
urzaizinhos	urzal+N+DIM+M+PL
urzal	urzal+N+M+SG
urzalzinho	urzal+N+DIM+M+SG
urze	urze+N+F+SG
urzes	urze+N+F+PL
urzezinha	urze+N+DIM+F+SG
urzezinhas	urze+N+DIM+F+PL
urzinha	urze+N+DIM+F+SG
urzinhas	urze+N+DIM+F+PL
urzedinho	urzedo+N+DIM+M+SG
urzedinhos	urzedo+N+DIM+M+PL
urzedo	urzedo+N+M+SG
urzedos	urzedo+N+M+PL
urzedozinho	urzedo+N+DIM+M+SG
urzedozinhos	urzedo+N+DIM+M+PL
urzeira	urzeira+N+F+SG
urzeiras	urzeira+N+F+PL
urzeirazinha	urzeira+N+DIM+F+SG
urzeirazinhas	urzeira+N+DIM+F+PL
urzeirinha	urzeira+N+DIM+F+SG
urzeirinhas	urzeira+N+DIM+F+PL
urzela	urzela+N+F+SG
urzelas	urzela+N+F+PL
urzelazinha	urzela+N+DIM+F+SG
urzelazinhas	urzela+N+DIM+F+PL
urzelinha	urzela+N+DIM+F+SG
urzelinhas	urzela+N+DIM+F+PL
urzelina	urzelina+N+F+SG
urzelinas	urzelina+N+F+PL
urzelinazinha	urzelina+N+DIM+F+SG
urzelinazinhas	urzelina+N+DIM+F+PL
urzelininha	urzelina+N+DIM+F+SG
urzelininhas	urzelina+N+DIM+F+PL
urzibelha	urzibelha+N+F+SG
urzibelhas	urzibelha+N+F+PL
urzibelhazinha	urzibelha+N+DIM+F+SG
urzibelhazinhas	urzibelha+N+DIM+F+PL
urzibelhinha	urzibelha+N+DIM+F+SG
urzibelhinhas	urzibelha+N+DIM+F+PL
uraniazinha	urânia+N+DIM+F+SG
uraniazinhas	urânia+N+DIM+F+PL
uraninha	urânia+N+DIM+F+SG
uraninhas	urânia+N+DIM+F+PL
urânia	urânia+N+F+SG
urânias	urânia+N+F+PL
uraniazinha	urânio+N+DIM+F+SG
uraniazinhas	urânio+N+DIM+F+PL
uraninha	urânio+N+DIM+F+SG
uraninhas	urânio+N+DIM+F+PL
uraninho	urânio+N+DIM+M+SG
uraninhos	urânio+N+DIM+M+PL
uraniozinho	urânio+N+DIM+M+SG
uraniozinhos	urânio+N+DIM+M+PL
urânia	urânio+N+F+SG
urânias	urânio+N+F+PL
urânio	urânio+N+M+SG
urânios	urânio+N+M+PL
ureasezinha	uréase+N+DIM+F+SG
ureasezinhas	uréase+N+DIM+F+PL
ureasinha	uréase+N+DIM+F+SG
ureasinhas	uréase+N+DIM+F+PL
uréase	uréase+N+F+SG
uréases	uréase+N+F+PL
ureiazinha	uréia+N+DIM+F+SG
ureiazinhas	uréia+N+DIM+F+PL
ureinha	uréia+N+DIM+F+SG
ureinhas	uréia+N+DIM+F+PL
uréia	uréia+N+F+SG
uréias	uréia+N+F+PL
ureterezinhos	uréter+N+DIM+M+PL
ureterzinho	uréter+N+DIM+M+SG
ureterzinhos	uréter+N+DIM+M+PL
uréter	uréter+N+M+SG
uréteres	uréter+N+M+PL
urenciazinha	urência+N+DIM+F+SG
urenciazinhas	urência+N+DIM+F+PL
urencinha	urência+N+DIM+F+SG
urencinhas	urência+N+DIM+F+PL
urência	urência+N+F+SG
urências	urência+N+F+PL
urolitinho	urólito+N+DIM+M+SG
urolitinhos	urólito+N+DIM+M+PL
urolitozinho	urólito+N+DIM+M+SG
urolitozinhos	urólito+N+DIM+M+PL
urólito	urólito+N+M+SG
urólitos	urólito+N+M+PL
urologazinha	urólogo+N+DIM+F+SG
urologazinhas	urólogo+N+DIM+F+PL
urologozinho	urólogo+N+DIM+M+SG
urologozinhos	urólogo+N+DIM+M+PL
urologuinha	urólogo+N+DIM+F+SG
urologuinhas	urólogo+N+DIM+F+PL
urologuinho	urólogo+N+DIM+M+SG
urologuinhos	urólogo+N+DIM+M+PL
uróloga	urólogo+N+F+SG
urólogas	urólogo+N+F+PL
urólogo	urólogo+N+M+SG
urólogos	urólogo+N+M+PL
uromelinho	urómelo+N+DIM+M+SG
uromelinhos	urómelo+N+DIM+M+PL
uromelozinho	urómelo+N+DIM+M+SG
uromelozinhos	urómelo+N+DIM+M+PL
urómelo	urómelo+N+M+SG
urómelos	urómelo+N+M+PL
urometrinho	urómetro+N+DIM+M+SG
urometrinhos	urómetro+N+DIM+M+PL
urometrozinho	urómetro+N+DIM+M+SG
urometrozinhos	urómetro+N+DIM+M+PL
urómetro	urómetro+N+M+SG
urómetros	urómetro+N+M+PL
uropodezinho	urópode+N+DIM+M+SG
uropodezinhos	urópode+N+DIM+M+PL
uropodinho	urópode+N+DIM+M+SG
uropodinhos	urópode+N+DIM+M+PL
urópode	urópode+N+M+SG
urópodes	urópode+N+M+PL
uromelinho	urômelo+N+DIM+M+SG
uromelinhos	urômelo+N+DIM+M+PL
uromelozinho	urômelo+N+DIM+M+SG
uromelozinhos	urômelo+N+DIM+M+PL
urômelo	urômelo+N+M+SG
urômelos	urômelo+N+M+PL
urometrinho	urômetro+N+DIM+M+SG
urometrinhos	urômetro+N+DIM+M+PL
urometrozinho	urômetro+N+DIM+M+SG
urometrozinhos	urômetro+N+DIM+M+PL
urômetro	urômetro+N+M+SG
urômetros	urômetro+N+M+PL
usabilidade	usabilidade+N+F+SG
usabilidades	usabilidade+N+F+PL
usabilidadezinha	usabilidade+N+DIM+F+SG
usabilidadezinhas	usabilidade+N+DIM+F+PL
usabilidadinha	usabilidade+N+DIM+F+SG
usabilidadinhas	usabilidade+N+DIM+F+PL
usagre	usagre+N+M+SG
usagres	usagre+N+M+PL
usagrezinho	usagre+N+DIM+M+SG
usagrezinhos	usagre+N+DIM+M+PL
usagrinho	usagre+N+DIM+M+SG
usagrinhos	usagre+N+DIM+M+PL
usancinha	usança+N+DIM+F+SG
usancinhas	usança+N+DIM+F+PL
usança	usança+N+F+SG
usanças	usança+N+F+PL
usançazinha	usança+N+DIM+F+SG
usançazinhas	usança+N+DIM+F+PL
usga	usga+N+F+SG
usgas	usga+N+F+PL
usgazinha	usga+N+DIM+F+SG
usgazinhas	usga+N+DIM+F+PL
usguinha	usga+N+DIM+F+SG
usguinhas	usga+N+DIM+F+PL
usina	usina+N+F+SG
usinas	usina+N+F+PL
usinazinha	usina+N+DIM+F+SG
usinazinhas	usina+N+DIM+F+PL
usininha	usina+N+DIM+F+SG
usininhas	usina+N+DIM+F+PL
usinagem	usinagem+N+F+SG
usinagens	usinagem+N+F+PL
usinagenzinha	usinagem+N+DIM+F+SG
usinagenzinhas	usinagem+N+DIM+F+PL
usineira	usineiro+N+F+SG
usineiras	usineiro+N+F+PL
usineirazinha	usineiro+N+DIM+F+SG
usineirazinhas	usineiro+N+DIM+F+PL
usineirinha	usineiro+N+DIM+F+SG
usineirinhas	usineiro+N+DIM+F+PL
usineirinho	usineiro+N+DIM+M+SG
usineirinhos	usineiro+N+DIM+M+PL
usineiro	usineiro+N+M+SG
usineiros	usineiro+N+M+PL
usineirozinho	usineiro+N+DIM+M+SG
usineirozinhos	usineiro+N+DIM+M+PL
usneaceazinha	usneácea+N+DIM+F+SG
usneaceazinhas	usneácea+N+DIM+F+PL
usneaceinha	usneácea+N+DIM+F+SG
usneaceinhas	usneácea+N+DIM+F+PL
usneácea	usneácea+N+F+SG
usneáceas	usneácea+N+F+PL
usinho	uso+N+DIM+M+SG
usinhos	uso+N+DIM+M+PL
uso	uso+N+M+SG
usos	uso+N+M+PL
usozinho	uso+N+DIM+M+SG
usozinhos	uso+N+DIM+M+PL
ussa	ussa+N+F+SG
ussas	ussa+N+F+PL
ussazinha	ussa+N+DIM+F+SG
ussazinhas	ussa+N+DIM+F+PL
ussinha	ussa+N+DIM+F+SG
ussinhas	ussa+N+DIM+F+PL
ussa	usso+N+F+SG
ussas	usso+N+F+PL
ussazinha	usso+N+DIM+F+SG
ussazinhas	usso+N+DIM+F+PL
ussinha	usso+N+DIM+F+SG
ussinhas	usso+N+DIM+F+PL
ussinho	usso+N+DIM+M+SG
ussinhos	usso+N+DIM+M+PL
usso	usso+N+M+SG
ussos	usso+N+M+PL
ussozinho	usso+N+DIM+M+SG
ussozinhos	usso+N+DIM+M+PL
uste	uste+N+M+SG
ustes	uste+N+M+PL
ustezinho	uste+N+DIM+M+SG
ustezinhos	uste+N+DIM+M+PL
ustinho	uste+N+DIM+M+SG
ustinhos	uste+N+DIM+M+PL
ustrina	ustrina+N+F+SG
ustrinas	ustrina+N+F+PL
ustrinazinha	ustrina+N+DIM+F+SG
ustrinazinhas	ustrina+N+DIM+F+PL
ustrininha	ustrina+N+DIM+F+SG
ustrininhas	ustrina+N+DIM+F+PL
ustulabilidade	ustulabilidade+N+F+SG
ustulabilidades	ustulabilidade+N+F+PL
ustulabilidadezinha	ustulabilidade+N+DIM+F+SG
ustulabilidadezinhas	ustulabilidade+N+DIM+F+PL
ustulabilidadinha	ustulabilidade+N+DIM+F+SG
ustulabilidadinhas	ustulabilidade+N+DIM+F+PL
ustulação	ustulação+N+F+SG
ustulaçãozinha	ustulação+N+DIM+F+SG
ustulações	ustulação+N+F+PL
ustulaçõezinhas	ustulação+N+DIM+F+PL
ustão	ustão+N+F+SG
ustãozinha	ustão+N+DIM+F+SG
ustões	ustão+N+F+PL
ustõezinhas	ustão+N+DIM+F+PL
usualidade	usualidade+N+F+SG
usualidades	usualidade+N+F+PL
usualidadezinha	usualidade+N+DIM+F+SG
usualidadezinhas	usualidade+N+DIM+F+PL
usualidadinha	usualidade+N+DIM+F+SG
usualidadinhas	usualidade+N+DIM+F+PL
usucapiente	usucapiente+N+SG
usucapientes	usucapiente+N+PL
usucapientezinha	usucapiente+N+DIM+F+SG
usucapientezinhas	usucapiente+N+DIM+F+PL
usucapientezinho	usucapiente+N+DIM+M+SG
usucapientezinhos	usucapiente+N+DIM+M+PL
usucapientinha	usucapiente+N+DIM+F+SG
usucapientinhas	usucapiente+N+DIM+F+PL
usucapientinho	usucapiente+N+DIM+M+SG
usucapientinhos	usucapiente+N+DIM+M+PL
usucapião	usucapião+N+F+SG
usucapiãozinha	usucapião+N+DIM+F+SG
usucapiões	usucapião+N+F+PL
usucapiõezinhas	usucapião+N+DIM+F+PL
usufruidor	usufruidor+N+M+SG
usufruidora	usufruidor+N+F+SG
usufruidoras	usufruidor+N+F+PL
usufruidorazinha	usufruidor+N+DIM+F+SG
usufruidorazinhas	usufruidor+N+DIM+F+PL
usufruidores	usufruidor+N+M+PL
usufruidorezinhos	usufruidor+N+DIM+M+PL
usufruidorinha	usufruidor+N+DIM+F+SG
usufruidorinhas	usufruidor+N+DIM+F+PL
usufruidorzinho	usufruidor+N+DIM+M+SG
usufruidorzinhos	usufruidor+N+DIM+M+PL
usufruição	usufruição+N+F+SG
usufruiçãozinha	usufruição+N+DIM+F+SG
usufruições	usufruição+N+F+PL
usufruiçõezinhas	usufruição+N+DIM+F+PL
usufrutinho	usufruto+N+DIM+M+SG
usufrutinhos	usufruto+N+DIM+M+PL
usufruto	usufruto+N+M+SG
usufrutos	usufruto+N+M+PL
usufrutozinho	usufruto+N+DIM+M+SG
usufrutozinhos	usufruto+N+DIM+M+PL
usufrutuabilidade	usufrutuabilidade+N+F+SG
usufrutuabilidades	usufrutuabilidade+N+F+PL
usufrutuabilidadezinha	usufrutuabilidade+N+DIM+F+SG
usufrutuabilidadezinhas	usufrutuabilidade+N+DIM+F+PL
usufrutuabilidadinha	usufrutuabilidade+N+DIM+F+SG
usufrutuabilidadinhas	usufrutuabilidade+N+DIM+F+PL
usufrutuariazinha	usufrutuário+N+DIM+F+SG
usufrutuariazinhas	usufrutuário+N+DIM+F+PL
usufrutuarinha	usufrutuário+N+DIM+F+SG
usufrutuarinhas	usufrutuário+N+DIM+F+PL
usufrutuarinho	usufrutuário+N+DIM+M+SG
usufrutuarinhos	usufrutuário+N+DIM+M+PL
usufrutuariozinho	usufrutuário+N+DIM+M+SG
usufrutuariozinhos	usufrutuário+N+DIM+M+PL
usufrutuária	usufrutuário+N+F+SG
usufrutuárias	usufrutuário+N+F+PL
usufrutuário	usufrutuário+N+M+SG
usufrutuários	usufrutuário+N+M+PL
usura	usura+N+F+SG
usuras	usura+N+F+PL
usurazinha	usura+N+DIM+F+SG
usurazinhas	usura+N+DIM+F+PL
usurinha	usura+N+DIM+F+SG
usurinhas	usura+N+DIM+F+PL
usurpabilidade	usurpabilidade+N+F+SG
usurpabilidades	usurpabilidade+N+F+PL
usurpabilidadezinha	usurpabilidade+N+DIM+F+SG
usurpabilidadezinhas	usurpabilidade+N+DIM+F+PL
usurpabilidadinha	usurpabilidade+N+DIM+F+SG
usurpabilidadinhas	usurpabilidade+N+DIM+F+PL
usurpador	usurpador+N+M+SG
usurpadora	usurpador+N+F+SG
usurpadoras	usurpador+N+F+PL
usurpadorazinha	usurpador+N+DIM+F+SG
usurpadorazinhas	usurpador+N+DIM+F+PL
usurpadores	usurpador+N+M+PL
usurpadorezinhos	usurpador+N+DIM+M+PL
usurpadorinha	usurpador+N+DIM+F+SG
usurpadorinhas	usurpador+N+DIM+F+PL
usurpadorzinho	usurpador+N+DIM+M+SG
usurpadorzinhos	usurpador+N+DIM+M+PL
usurpação	usurpação+N+F+SG
usurpaçãozinha	usurpação+N+DIM+F+SG
usurpações	usurpação+N+F+PL
usurpaçõezinhas	usurpação+N+DIM+F+PL
usurariazinha	usurário+N+DIM+F+SG
usurariazinhas	usurário+N+DIM+F+PL
usurarinha	usurário+N+DIM+F+SG
usurarinhas	usurário+N+DIM+F+PL
usurarinho	usurário+N+DIM+M+SG
usurarinhos	usurário+N+DIM+M+PL
usurariozinho	usurário+N+DIM+M+SG
usurariozinhos	usurário+N+DIM+M+PL
usurária	usurário+N+F+SG
usurárias	usurário+N+F+PL
usurário	usurário+N+M+SG
usurários	usurário+N+M+PL
usuariazinha	usuário+N+DIM+F+SG
usuariazinhas	usuário+N+DIM+F+PL
usuarinha	usuário+N+DIM+F+SG
usuarinhas	usuário+N+DIM+F+PL
usuarinho	usuário+N+DIM+M+SG
usuarinhos	usuário+N+DIM+M+PL
usuariozinho	usuário+N+DIM+M+SG
usuariozinhos	usuário+N+DIM+M+PL
usuária	usuário+N+F+SG
usuárias	usuário+N+F+PL
usuário	usuário+N+M+SG
usuários	usuário+N+M+PL
ut	ut+N+M+SG
uts	ut+N+M+PL
utzinho	ut+N+DIM+M+SG
utzinhos	ut+N+DIM+M+PL
uta	uta+N+F+SG
utas	uta+N+F+PL
utazinha	uta+N+DIM+F+SG
utazinhas	uta+N+DIM+F+PL
utinha	uta+N+DIM+F+SG
utinhas	uta+N+DIM+F+PL
utena	utena+N+F+SG
utenas	utena+N+F+PL
utenazinha	utena+N+DIM+F+SG
utenazinhas	utena+N+DIM+F+PL
uteninha	utena+N+DIM+F+SG
uteninhas	utena+N+DIM+F+PL
utensilagem	utensilagem+N+F+SG
utensilagens	utensilagem+N+F+PL
utensilagenzinha	utensilagem+N+DIM+F+SG
utensilagenzinhas	utensilagem+N+DIM+F+PL
utensilidade	utensilidade+N+F+SG
utensilidades	utensilidade+N+F+PL
utensilidadezinha	utensilidade+N+DIM+F+SG
utensilidadezinhas	utensilidade+N+DIM+F+PL
utensilidadinha	utensilidade+N+DIM+F+SG
utensilidadinhas	utensilidade+N+DIM+F+PL
utensilinho	utensílio+N+DIM+M+SG
utensilinhos	utensílio+N+DIM+M+PL
utensiliozinho	utensílio+N+DIM+M+SG
utensiliozinhos	utensílio+N+DIM+M+PL
utensílio	utensílio+N+M+SG
utensílios	utensílio+N+M+PL
utente	utente+N+SG
utentes	utente+N+PL
utentezinha	utente+N+DIM+F+SG
utentezinhas	utente+N+DIM+F+PL
utentezinho	utente+N+DIM+M+SG
utentezinhos	utente+N+DIM+M+PL
utentinha	utente+N+DIM+F+SG
utentinhas	utente+N+DIM+F+PL
utentinho	utente+N+DIM+M+SG
utentinhos	utente+N+DIM+M+PL
uteralgia	uteralgia+N+F+SG
uteralgias	uteralgia+N+F+PL
uteralgiazinha	uteralgia+N+DIM+F+SG
uteralgiazinhas	uteralgia+N+DIM+F+PL
uteralginha	uteralgia+N+DIM+F+SG
uteralginhas	uteralgia+N+DIM+F+PL
uteremia	uteremia+N+F+SG
uteremias	uteremia+N+F+PL
uteremiazinha	uteremia+N+DIM+F+SG
uteremiazinhas	uteremia+N+DIM+F+PL
utereminha	uteremia+N+DIM+F+SG
utereminhas	uteremia+N+DIM+F+PL
uteremicidade	uteremicidade+N+F+SG
uteremicidades	uteremicidade+N+F+PL
uteremicidadezinha	uteremicidade+N+DIM+F+SG
uteremicidadezinhas	uteremicidade+N+DIM+F+PL
uteremicidadinha	uteremicidade+N+DIM+F+SG
uteremicidadinhas	uteremicidade+N+DIM+F+PL
uterisminho	uterismo+N+DIM+M+SG
uterisminhos	uterismo+N+DIM+M+PL
uterismo	uterismo+N+M+SG
uterismos	uterismo+N+M+PL
uterismozinho	uterismo+N+DIM+M+SG
uterismozinhos	uterismo+N+DIM+M+PL
uterite	uterite+N+F+SG
uterites	uterite+N+F+PL
uteritezinha	uterite+N+DIM+F+SG
uteritezinhas	uterite+N+DIM+F+PL
uteritinha	uterite+N+DIM+F+SG
uteritinhas	uterite+N+DIM+F+PL
uterodinia	uterodinia+N+F+SG
uterodinias	uterodinia+N+F+PL
uterodiniazinha	uterodinia+N+DIM+F+SG
uterodiniazinhas	uterodinia+N+DIM+F+PL
uterodininha	uterodinia+N+DIM+F+SG
uterodininhas	uterodinia+N+DIM+F+PL
uteromania	uteromania+N+F+SG
uteromanias	uteromania+N+F+PL
uteromaniazinha	uteromania+N+DIM+F+SG
uteromaniazinhas	uteromania+N+DIM+F+PL
uteromaninha	uteromania+N+DIM+F+SG
uteromaninhas	uteromania+N+DIM+F+PL
uterorragia	uterorragia+N+F+SG
uterorragias	uterorragia+N+F+PL
uterorragiazinha	uterorragia+N+DIM+F+SG
uterorragiazinhas	uterorragia+N+DIM+F+PL
uterorraginha	uterorragia+N+DIM+F+SG
uterorraginhas	uterorragia+N+DIM+F+PL
uteroscopia	uteroscopia+N+F+SG
uteroscopias	uteroscopia+N+F+PL
uteroscopiazinha	uteroscopia+N+DIM+F+SG
uteroscopiazinhas	uteroscopia+N+DIM+F+PL
uteroscopinha	uteroscopia+N+DIM+F+SG
uteroscopinhas	uteroscopia+N+DIM+F+PL
uteroscopinho	uteroscópio+N+DIM+F+SG
uteroscopinhos	uteroscópio+N+DIM+F+PL
uteroscopiozinha	uteroscópio+N+DIM+F+SG
uteroscopiozinhas	uteroscópio+N+DIM+F+PL
uteroscópio	uteroscópio+N+F+SG
uteroscópios	uteroscópio+N+F+PL
uterotomia	uterotomia+N+F+SG
uterotomias	uterotomia+N+F+PL
uterotomiazinha	uterotomia+N+DIM+F+SG
uterotomiazinhas	uterotomia+N+DIM+F+PL
uterotominha	uterotomia+N+DIM+F+SG
uterotominhas	uterotomia+N+DIM+F+PL
uterotomicidade	uterotomicidade+N+F+SG
uterotomicidades	uterotomicidade+N+F+PL
uterotomicidadezinha	uterotomicidade+N+DIM+F+SG
uterotomicidadezinhas	uterotomicidade+N+DIM+F+PL
uterotomicidadinha	uterotomicidade+N+DIM+F+SG
uterotomicidadinhas	uterotomicidade+N+DIM+F+PL
uterotominho	uterótomo+N+DIM+M+SG
uterotominhos	uterótomo+N+DIM+M+PL
uterotomozinho	uterótomo+N+DIM+M+SG
uterotomozinhos	uterótomo+N+DIM+M+PL
uterótomo	uterótomo+N+M+SG
uterótomos	uterótomo+N+M+PL
uticense	uticense+N+SG
uticenses	uticense+N+PL
uticensezinha	uticense+N+DIM+F+SG
uticensezinhas	uticense+N+DIM+F+PL
uticensezinho	uticense+N+DIM+M+SG
uticensezinhos	uticense+N+DIM+M+PL
uticensinha	uticense+N+DIM+F+SG
uticensinhas	uticense+N+DIM+F+PL
uticensinho	uticense+N+DIM+M+SG
uticensinhos	uticense+N+DIM+M+PL
utilidade	utilidade+N+F+SG
utilidades	utilidade+N+F+PL
utilidadezinha	utilidade+N+DIM+F+SG
utilidadezinhas	utilidade+N+DIM+F+PL
utilidadinha	utilidade+N+DIM+F+SG
utilidadinhas	utilidade+N+DIM+F+PL
utilitarisminho	utilitarismo+N+DIM+M+SG
utilitarisminhos	utilitarismo+N+DIM+M+PL
utilitarismo	utilitarismo+N+M+SG
utilitarismos	utilitarismo+N+M+PL
utilitarismozinho	utilitarismo+N+DIM+M+SG
utilitarismozinhos	utilitarismo+N+DIM+M+PL
utilitarista	utilitarista+N+SG
utilitaristas	utilitarista+N+PL
utilitaristazinha	utilitarista+N+DIM+F+SG
utilitaristazinhas	utilitarista+N+DIM+F+PL
utilitaristazinho	utilitarista+N+DIM+M+SG
utilitaristazinhos	utilitarista+N+DIM+M+PL
utilitaristinha	utilitarista+N+DIM+SG
utilitaristinhas	utilitarista+N+DIM+PL
utilitariazinha	utilitário+N+DIM+F+SG
utilitariazinhas	utilitário+N+DIM+F+PL
utilitarinha	utilitário+N+DIM+F+SG
utilitarinhas	utilitário+N+DIM+F+PL
utilitarinho	utilitário+N+DIM+M+SG
utilitarinhos	utilitário+N+DIM+M+PL
utilitariozinho	utilitário+N+DIM+M+SG
utilitariozinhos	utilitário+N+DIM+M+PL
utilitária	utilitário+N+F+SG
utilitárias	utilitário+N+F+PL
utilitário	utilitário+N+M+SG
utilitários	utilitário+N+M+PL
utilizabilidade	utilizabilidade+N+F+SG
utilizabilidades	utilizabilidade+N+F+PL
utilizabilidadezinha	utilizabilidade+N+DIM+F+SG
utilizabilidadezinhas	utilizabilidade+N+DIM+F+PL
utilizabilidadinha	utilizabilidade+N+DIM+F+SG
utilizabilidadinhas	utilizabilidade+N+DIM+F+PL
utilizador	utilizador+N+M+SG
utilizadora	utilizador+N+F+SG
utilizadoras	utilizador+N+F+PL
utilizadorazinha	utilizador+N+DIM+F+SG
utilizadorazinhas	utilizador+N+DIM+F+PL
utilizadores	utilizador+N+M+PL
utilizadorezinhos	utilizador+N+DIM+M+PL
utilizadorinha	utilizador+N+DIM+F+SG
utilizadorinhas	utilizador+N+DIM+F+PL
utilizadorzinho	utilizador+N+DIM+M+SG
utilizadorzinhos	utilizador+N+DIM+M+PL
utilização	utilização+N+F+SG
utilizaçãozinha	utilização+N+DIM+F+SG
utilizações	utilização+N+F+PL
utilizaçõezinhas	utilização+N+DIM+F+PL
utopia	utopia+N+F+SG
utopias	utopia+N+F+PL
utopiazinha	utopia+N+DIM+F+SG
utopiazinhas	utopia+N+DIM+F+PL
utopinha	utopia+N+DIM+F+SG
utopinhas	utopia+N+DIM+F+PL
utopicidade	utopicidade+N+F+SG
utopicidades	utopicidade+N+F+PL
utopicidadezinha	utopicidade+N+DIM+F+SG
utopicidadezinhas	utopicidade+N+DIM+F+PL
utopicidadinha	utopicidade+N+DIM+F+SG
utopicidadinhas	utopicidade+N+DIM+F+PL
utopista	utopista+N+SG
utopistas	utopista+N+PL
utopistazinha	utopista+N+DIM+F+SG
utopistazinhas	utopista+N+DIM+F+PL
utopistazinho	utopista+N+DIM+M+SG
utopistazinhos	utopista+N+DIM+M+PL
utopistinha	utopista+N+DIM+SG
utopistinhas	utopista+N+DIM+PL
utricularidade	utricularidade+N+F+SG
utricularidades	utricularidade+N+F+PL
utricularidadezinha	utricularidade+N+DIM+F+SG
utricularidadezinhas	utricularidade+N+DIM+F+PL
utricularidadinha	utricularidade+N+DIM+F+SG
utricularidadinhas	utricularidade+N+DIM+F+PL
utriculariaceazinha	utriculariácea+N+DIM+F+SG
utriculariaceazinhas	utriculariácea+N+DIM+F+PL
utriculariaceinha	utriculariácea+N+DIM+F+SG
utriculariaceinhas	utriculariácea+N+DIM+F+PL
utriculariácea	utriculariácea+N+F+SG
utriculariáceas	utriculariácea+N+F+PL
utriculosidade	utriculosidade+N+F+SG
utriculosidades	utriculosidade+N+F+PL
utriculosidadezinha	utriculosidade+N+DIM+F+SG
utriculosidadezinhas	utriculosidade+N+DIM+F+PL
utriculosidadinha	utriculosidade+N+DIM+F+SG
utriculosidadinhas	utriculosidade+N+DIM+F+PL
utriculariazinha	utriculária+N+DIM+F+SG
utriculariazinhas	utriculária+N+DIM+F+PL
utricularinha	utriculária+N+DIM+F+SG
utricularinhas	utriculária+N+DIM+F+PL
utriculária	utriculária+N+F+SG
utriculárias	utriculária+N+F+PL
utrarinho	utrário+N+DIM+M+SG
utrarinhos	utrário+N+DIM+M+PL
utrariozinho	utrário+N+DIM+M+SG
utrariozinhos	utrário+N+DIM+M+PL
utrário	utrário+N+M+SG
utrários	utrário+N+M+PL
utriculinho	utrículo+N+DIM+M+SG
utriculinhos	utrículo+N+DIM+M+PL
utriculozinho	utrículo+N+DIM+M+SG
utriculozinhos	utrículo+N+DIM+M+PL
utrículo	utrículo+N+M+SG
utrículos	utrículo+N+M+PL
utuaba	utuaba+N+F+SG
utuabas	utuaba+N+F+PL
utuabazinha	utuaba+N+DIM+F+SG
utuabazinhas	utuaba+N+DIM+F+PL
utuabinha	utuaba+N+DIM+F+SG
utuabinhas	utuaba+N+DIM+F+PL
uterculinho	utérculo+N+DIM+M+SG
uterculinhos	utérculo+N+DIM+M+PL
uterculozinho	utérculo+N+DIM+M+SG
uterculozinhos	utérculo+N+DIM+M+PL
utérculo	utérculo+N+M+SG
utérculos	utérculo+N+M+PL
uva	uva+N+F+SG
uvas	uva+N+F+PL
uvazinha	uva+N+DIM+F+SG
uvazinhas	uva+N+DIM+F+PL
uvinha	uva+N+DIM+F+SG
uvinhas	uva+N+DIM+F+PL
uvita	uva+N+DIM+F+SG
uvitas	uva+N+DIM+F+PL
uvacupari	uvacupari+N+M+SG
uvacuparis	uvacupari+N+M+PL
uvacuparizinho	uvacupari+N+DIM+M+SG
uvacuparizinhos	uvacupari+N+DIM+M+PL
uvada	uvada+N+F+SG
uvadas	uvada+N+F+PL
uvadazinha	uvada+N+DIM+F+SG
uvadazinhas	uvada+N+DIM+F+PL
uvadinha	uvada+N+DIM+F+SG
uvadinhas	uvada+N+DIM+F+PL
uvaia	uvaia+N+F+SG
uvaias	uvaia+N+F+PL
uvaiazinha	uvaia+N+DIM+F+SG
uvaiazinhas	uvaia+N+DIM+F+PL
uvainha	uvaia+N+DIM+F+SG
uvainhas	uvaia+N+DIM+F+PL
uvaieira	uvaieira+N+F+SG
uvaieiras	uvaieira+N+F+PL
uvaieirazinha	uvaieira+N+DIM+F+SG
uvaieirazinhas	uvaieira+N+DIM+F+PL
uvaieirinha	uvaieira+N+DIM+F+SG
uvaieirinhas	uvaieira+N+DIM+F+PL
uvala	uvala+N+F+SG
uvalas	uvala+N+F+PL
uvalazinha	uvala+N+DIM+F+SG
uvalazinhas	uvala+N+DIM+F+PL
uvalinha	uvala+N+DIM+F+SG
uvalinhas	uvala+N+DIM+F+PL
uvalha	uvalha+N+F+SG
uvalhas	uvalha+N+F+PL
uvalhazinha	uvalha+N+DIM+F+SG
uvalhazinhas	uvalha+N+DIM+F+PL
uvalhinha	uvalha+N+DIM+F+SG
uvalhinhas	uvalha+N+DIM+F+PL
uvalheira	uvalheira+N+F+SG
uvalheiras	uvalheira+N+F+PL
uvalheirazinha	uvalheira+N+DIM+F+SG
uvalheirazinhas	uvalheira+N+DIM+F+PL
uvalheirinha	uvalheira+N+DIM+F+SG
uvalheirinhas	uvalheira+N+DIM+F+PL
uvalidade	uvalidade+N+F+SG
uvalidades	uvalidade+N+F+PL
uvalidadezinha	uvalidade+N+DIM+F+SG
uvalidadezinhas	uvalidade+N+DIM+F+PL
uvalidadinha	uvalidade+N+DIM+F+SG
uvalidadinhas	uvalidade+N+DIM+F+PL
uvacinha	uvaça+N+DIM+F+SG
uvacinhas	uvaça+N+DIM+F+PL
uvaça	uvaça+N+F+SG
uvaças	uvaça+N+F+PL
uvaçazinha	uvaça+N+DIM+F+SG
uvaçazinhas	uvaça+N+DIM+F+PL
uvicidade	uvicidade+N+F+SG
uvicidades	uvicidade+N+F+PL
uvicidadezinha	uvicidade+N+DIM+F+SG
uvicidadezinhas	uvicidade+N+DIM+F+PL
uvicidadinha	uvicidade+N+DIM+F+SG
uvicidadinhas	uvicidade+N+DIM+F+PL
uvularidade	uvularidade+N+F+SG
uvularidades	uvularidade+N+F+PL
uvularidadezinha	uvularidade+N+DIM+F+SG
uvularidadezinhas	uvularidade+N+DIM+F+PL
uvularidadinha	uvularidade+N+DIM+F+SG
uvularidadinhas	uvularidade+N+DIM+F+PL
uvulariaceazinha	uvulariácea+N+DIM+F+SG
uvulariaceazinhas	uvulariácea+N+DIM+F+PL
uvulariaceinha	uvulariácea+N+DIM+F+SG
uvulariaceinhas	uvulariácea+N+DIM+F+PL
uvulariácea	uvulariácea+N+F+SG
uvulariáceas	uvulariácea+N+F+PL
uvulite	uvulite+N+F+SG
uvulites	uvulite+N+F+PL
uvulitezinha	uvulite+N+DIM+F+SG
uvulitezinhas	uvulite+N+DIM+F+PL
uvulitinha	uvulite+N+DIM+F+SG
uvulitinhas	uvulite+N+DIM+F+PL
uxoricida	uxoricida+N+SG
uxoricidas	uxoricida+N+PL
uxoricidazinha	uxoricida+N+DIM+F+SG
uxoricidazinhas	uxoricida+N+DIM+F+PL
uxoricidazinho	uxoricida+N+DIM+M+SG
uxoricidazinhos	uxoricida+N+DIM+M+PL
uxoricidinha	uxoricida+N+DIM+SG
uxoricidinhas	uxoricida+N+DIM+PL
uxoricidinho	uxoricídio+N+DIM+M+SG
uxoricidinhos	uxoricídio+N+DIM+M+PL
uxoricidiozinho	uxoricídio+N+DIM+M+SG
uxoricidiozinhos	uxoricídio+N+DIM+M+PL
uxoricídio	uxoricídio+N+M+SG
uxoricídios	uxoricídio+N+M+PL
uzitense	uzitense+N+SG
uzitenses	uzitense+N+PL
uzitensezinha	uzitense+N+DIM+F+SG
uzitensezinhas	uzitense+N+DIM+F+PL
uzitensezinho	uzitense+N+DIM+M+SG
uzitensezinhos	uzitense+N+DIM+M+PL
uzitensinha	uzitense+N+DIM+F+SG
uzitensinhas	uzitense+N+DIM+F+PL
uzitensinho	uzitense+N+DIM+M+SG
uzitensinhos	uzitense+N+DIM+M+PL
uzifurezinhos	uzífur+N+DIM+M+PL
uzifurzinho	uzífur+N+DIM+M+SG
uzifurzinhos	uzífur+N+DIM+M+PL
uzífur	uzífur+N+M+SG
uzífures	uzífur+N+M+PL
uzifurinho	uzífuro+N+DIM+M+SG
uzifurinhos	uzífuro+N+DIM+M+PL
uzifurozinho	uzífuro+N+DIM+M+SG
uzifurozinhos	uzífuro+N+DIM+M+PL
uzífuro	uzífuro+N+M+SG
uzífuros	uzífuro+N+M+PL
uçazinho	uçá+N+DIM+M+SG
uçazinhos	uçá+N+DIM+M+PL
uçá	uçá+N+M+SG
uçás	uçá+N+M+PL
uisquezinho	uísque+N+DIM+M+SG
uisquezinhos	uísque+N+DIM+M+PL
uisquinho	uísque+N+DIM+M+SG
uisquinhos	uísque+N+DIM+M+PL
uísque	uísque+N+M+SG
uísques	uísque+N+M+PL
uberezinha	úbere+N+DIM+F+SG
uberezinhas	úbere+N+DIM+F+PL
uberezinho	úbere+N+DIM+M+SG
uberezinhos	úbere+N+DIM+M+PL
uberinha	úbere+N+DIM+F+SG
uberinhas	úbere+N+DIM+F+PL
uberinho	úbere+N+DIM+M+SG
uberinhos	úbere+N+DIM+M+PL
uberzinhas	úbere+N+DIM+F+PL
uberzinhos	úbere+N+DIM+M+PL
úbere	úbere+N+SG
úberes	úbere+N+PL
uberinho	úbero+N+DIM+M+SG
uberinhos	úbero+N+DIM+M+PL
uberozinho	úbero+N+DIM+M+SG
uberozinhos	úbero+N+DIM+M+PL
úbero	úbero+N+M+SG
úberos	úbero+N+M+PL
ulcerazinha	úlcera+N+DIM+F+SG
ulcerazinhas	úlcera+N+DIM+F+PL
ulcerinha	úlcera+N+DIM+F+SG
ulcerinhas	úlcera+N+DIM+F+PL
úlcera	úlcera+N+F+SG
úlceras	úlcera+N+F+PL
ultimazinha	última+N+DIM+F+SG
ultimazinhas	última+N+DIM+F+PL
ultiminha	última+N+DIM+F+SG
ultiminhas	última+N+DIM+F+PL
última	última+N+F+SG
últimas	última+N+F+PL
ultimazinha	último+N+DIM+F+SG
ultimazinhas	último+N+DIM+F+PL
ultiminha	último+N+DIM+F+SG
ultiminhas	último+N+DIM+F+PL
ultiminho	último+N+DIM+M+SG
ultiminhos	último+N+DIM+M+PL
ultimozinho	último+N+DIM+M+SG
ultimozinhos	último+N+DIM+M+PL
último	último+N+M+SG
últimos	último+N+M+PL
umbriazinha	úmbrio+N+DIM+F+SG
umbriazinhas	úmbrio+N+DIM+F+PL
umbrinha	úmbrio+N+DIM+F+SG
umbrinhas	úmbrio+N+DIM+F+PL
umbrinho	úmbrio+N+DIM+M+SG
umbrinhos	úmbrio+N+DIM+M+PL
umbriozinho	úmbrio+N+DIM+M+SG
umbriozinhos	úmbrio+N+DIM+M+PL
úmbria	úmbrio+N+F+SG
úmbrias	úmbrio+N+F+PL
úmbrio	úmbrio+N+M+SG
úmbrios	úmbrio+N+M+PL
umerinho	úmero+N+DIM+M+SG
umerinhos	úmero+N+DIM+M+PL
umerozinho	úmero+N+DIM+M+SG
umerozinhos	úmero+N+DIM+M+PL
úmero	úmero+N+M+SG
úmeros	úmero+N+M+PL
unguezinho	úngue+N+DIM+M+SG
unguezinhos	úngue+N+DIM+M+PL
unguinho	úngue+N+DIM+M+SG
unguinhos	úngue+N+DIM+M+PL
úngue	úngue+N+M+SG
úngues	úngue+N+M+PL
unguisinhas	únguis+N+DIM+F+PL
unguisinho	únguis+N+DIM+M+SG
unguisinhos	únguis+N+DIM+M+PL
únguis	únguis+N+M
ungulazinha	úngula+N+DIM+F+SG
ungulazinhas	úngula+N+DIM+F+PL
ungulinha	úngula+N+DIM+F+SG
ungulinhas	úngula+N+DIM+F+PL
úngula	úngula+N+F+SG
úngulas	úngula+N+F+PL
ungüezinho	úngüe+N+DIM+M+SG
ungüezinhos	úngüe+N+DIM+M+PL
ungüinho	úngüe+N+DIM+M+SG
ungüinhos	úngüe+N+DIM+M+PL
úngüe	úngüe+N+M+SG
úngües	úngüe+N+M+PL
unicazinha	único+N+DIM+F+SG
unicazinhas	único+N+DIM+F+PL
unicozinho	único+N+DIM+M+SG
unicozinhos	único+N+DIM+M+PL
uniquinha	único+N+DIM+F+SG
uniquinhas	único+N+DIM+F+PL
uniquinho	único+N+DIM+M+SG
uniquinhos	único+N+DIM+M+PL
única	único+N+F+SG
únicas	único+N+F+PL
único	único+N+M+SG
únicos	único+N+M+PL
urnulazinha	úrnula+N+DIM+F+SG
urnulazinhas	úrnula+N+DIM+F+PL
urnulinha	úrnula+N+DIM+F+SG
urnulinhas	úrnula+N+DIM+F+PL
úrnula	úrnula+N+F+SG
úrnulas	úrnula+N+F+PL
usneazinha	úsnea+N+DIM+F+SG
usneazinhas	úsnea+N+DIM+F+PL
usneinha	úsnea+N+DIM+F+SG
usneinhas	úsnea+N+DIM+F+PL
úsnea	úsnea+N+F+SG
úsneas	úsnea+N+F+PL
ustiazinha	ústia+N+DIM+F+SG
ustiazinhas	ústia+N+DIM+F+PL
ustinha	ústia+N+DIM+F+SG
ustinhas	ústia+N+DIM+F+PL
ústia	ústia+N+F+SG
ústias	ústia+N+F+PL
uterinho	útero+N+DIM+M+SG
uterinhos	útero+N+DIM+M+PL
uterozinho	útero+N+DIM+M+SG
uterozinhos	útero+N+DIM+M+PL
útero	útero+N+M+SG
úteros	útero+N+M+PL
uteizinhas	útil+N+DIM+F+PL
uteizinhos	útil+N+DIM+M+PL
utilzinha	útil+N+DIM+F+SG
utilzinho	útil+N+DIM+M+SG
úteis	útil+N+PL
útil	útil+N+SG
uvulazinha	úvula+N+DIM+F+SG
uvulazinhas	úvula+N+DIM+F+PL
uvulinha	úvula+N+DIM+F+SG
uvulinhas	úvula+N+DIM+F+PL
úvula	úvula+N+F+SG
úvulas	úvula+N+F+PL
