yttroceriticidadezinhas	yttroceriticidade+N+DIM+F+PL
yttroceriticidadinhas	yttroceriticidade+N+DIM+F+PL
yttroceriticidadezinha	yttroceriticidade+N+DIM+F+SG
yttroceriticidadinha	yttroceriticidade+N+DIM+F+SG
yttroceriticidades	yttroceriticidade+N+F+PL
yttroceriticidade	yttroceriticidade+N+F+SG
yttrocrasiticidadezinhas	yttrocrasiticidade+N+DIM+F+PL
yttrocrasiticidadinhas	yttrocrasiticidade+N+DIM+F+PL
yttrocrasiticidadezinha	yttrocrasiticidade+N+DIM+F+SG
yttrocrasiticidadinha	yttrocrasiticidade+N+DIM+F+SG
yttrocrasiticidades	yttrocrasiticidade+N+F+PL
yttrocrasiticidade	yttrocrasiticidade+N+F+SG
yttrofluoriticidadezinhas	yttrofluoriticidade+N+DIM+F+PL
yttrofluoriticidadinhas	yttrofluoriticidade+N+DIM+F+PL
yttrofluoriticidadezinha	yttrofluoriticidade+N+DIM+F+SG
yttrofluoriticidadinha	yttrofluoriticidade+N+DIM+F+SG
yttrofluoriticidades	yttrofluoriticidade+N+F+PL
yttrofluoriticidade	yttrofluoriticidade+N+F+SG
yugawaralitazinhas	yugawaralita+N+DIM+F+PL
yugawaralitinhas	yugawaralita+N+DIM+F+PL
yugawaralitazinha	yugawaralita+N+DIM+F+SG
yugawaralitinha	yugawaralita+N+DIM+F+SG
yugawaralitas	yugawaralita+N+F+PL
yugawaralita	yugawaralita+N+F+SG
yuksporitazinhas	yuksporita+N+DIM+F+PL
yuksporitinhas	yuksporita+N+DIM+F+PL
yuksporitazinha	yuksporita+N+DIM+F+SG
yuksporitinha	yuksporita+N+DIM+F+SG
yuksporitas	yuksporita+N+F+PL
yuksporita	yuksporita+N+F+SG
zezinhos	z+N+DIM+M+PL
zinhos	z+N+DIM+M+PL
zes	z+N+M+PL
zz	z+N+M+PL
z	z+N+M+SG
zabalezinhos	zabalé+N+DIM+M+PL
zabalezinho	zabalé+N+DIM+M+SG
zabalés	zabalé+N+M+PL
zabalé	zabalé+N+M+SG
zabelezinhas	zabelê+N+DIM+F+PL
zabelezinha	zabelê+N+DIM+F+SG
zabelezinhos	zabelê+N+DIM+M+PL
zabelezinho	zabelê+N+DIM+M+SG
zabelês	zabelê+N+PL
zabelê	zabelê+N+SG
zabermazinhos	zaberma+N+DIM+M+PL
zaberminhas	zaberma+N+DIM+M+PL
zabermazinho	zaberma+N+DIM+M+SG
zaberminha	zaberma+N+DIM+M+SG
zabermas	zaberma+N+M+PL
zaberma	zaberma+N+M+SG
zabianinhos	zabiano+N+DIM+M+PL
zabianozinhos	zabiano+N+DIM+M+PL
zabianinho	zabiano+N+DIM+M+SG
zabianozinho	zabiano+N+DIM+M+SG
zabianos	zabiano+N+M+PL
zabiano	zabiano+N+M+SG
zabiapungazinhos	zabiapunga+N+DIM+M+PL
zabiapunguinhas	zabiapunga+N+DIM+M+PL
zabiapungazinho	zabiapunga+N+DIM+M+SG
zabiapunguinha	zabiapunga+N+DIM+M+SG
zabiapungas	zabiapunga+N+M+PL
zabiapunga	zabiapunga+N+M+SG
zabocainhos	zabocaio+N+DIM+M+PL
zabocaiozinhos	zabocaio+N+DIM+M+PL
zabocainho	zabocaio+N+DIM+M+SG
zabocaiozinho	zabocaio+N+DIM+M+SG
zabocaios	zabocaio+N+M+PL
zabocaio	zabocaio+N+M+SG
zabonazinhas	zabona+N+DIM+F+PL
zaboninhas	zabona+N+DIM+F+PL
zabonazinha	zabona+N+DIM+F+SG
zaboninha	zabona+N+DIM+F+SG
zabonas	zabona+N+F+PL
zabona	zabona+N+F+SG
zabrazinhas	zabra+N+DIM+F+PL
zabrinhas	zabra+N+DIM+F+PL
zabrazinha	zabra+N+DIM+F+SG
zabrinha	zabra+N+DIM+F+SG
zabras	zabra+N+F+PL
zabra	zabra+N+F+SG
zabrinhos	zabro+N+DIM+M+PL
zabrozinhos	zabro+N+DIM+M+PL
zabrinho	zabro+N+DIM+M+SG
zabrozinho	zabro+N+DIM+M+SG
zabros	zabro+N+M+PL
zabro	zabro+N+M+SG
zabucainhos	zabucaio+N+DIM+M+PL
zabucaiozinhos	zabucaio+N+DIM+M+PL
zabucainho	zabucaio+N+DIM+M+SG
zabucaiozinho	zabucaio+N+DIM+M+SG
zabucaios	zabucaio+N+M+PL
zabucaio	zabucaio+N+M+SG
zabucaizinhos	zabucaí+N+DIM+M+PL
zabucaizinho	zabucaí+N+DIM+M+SG
zabucaís	zabucaí+N+M+PL
zabucaí	zabucaí+N+M+SG
zabumbazinhas	zabumba+N+DIM+F+PL
zabumbazinha	zabumba+N+DIM+F+SG
zabumbazinhos	zabumba+N+DIM+M+PL
zabumbazinho	zabumba+N+DIM+M+SG
zabumbinhas	zabumba+N+DIM+PL
zabumbinha	zabumba+N+DIM+SG
zabumbas	zabumba+N+PL
zabumba	zabumba+N+SG
zabumbeirazinhas	zabumbeiro+N+DIM+F+PL
zabumbeirinhas	zabumbeiro+N+DIM+F+PL
zabumbeirazinha	zabumbeiro+N+DIM+F+SG
zabumbeirinha	zabumbeiro+N+DIM+F+SG
zabumbeirinhos	zabumbeiro+N+DIM+M+PL
zabumbeirozinhos	zabumbeiro+N+DIM+M+PL
zabumbeirinho	zabumbeiro+N+DIM+M+SG
zabumbeirozinho	zabumbeiro+N+DIM+M+SG
zabumbeiras	zabumbeiro+N+F+PL
zabumbeira	zabumbeiro+N+F+SG
zabumbeiros	zabumbeiro+N+M+PL
zabumbeiro	zabumbeiro+N+M+SG
zaburreirazinhas	zaburreira+N+DIM+F+PL
zaburreirinhas	zaburreira+N+DIM+F+PL
zaburreirazinha	zaburreira+N+DIM+F+SG
zaburreirinha	zaburreira+N+DIM+F+SG
zaburreiras	zaburreira+N+F+PL
zaburreira	zaburreira+N+F+SG
zaburreirinhos	zaburreiro+N+DIM+M+PL
zaburreirozinhos	zaburreiro+N+DIM+M+PL
zaburreirinho	zaburreiro+N+DIM+M+SG
zaburreirozinho	zaburreiro+N+DIM+M+SG
zaburreiros	zaburreiro+N+M+PL
zaburreiro	zaburreiro+N+M+SG
zaburrinhos	zaburro+N+DIM+M+PL
zaburrozinhos	zaburro+N+DIM+M+PL
zaburrinho	zaburro+N+DIM+M+SG
zaburrozinho	zaburro+N+DIM+M+SG
zaburros	zaburro+N+M+PL
zaburro	zaburro+N+M+SG
zacazinhos	zaca+N+DIM+M+PL
zaquinhas	zaca+N+DIM+M+PL
zacazinho	zaca+N+DIM+M+SG
zaquinha	zaca+N+DIM+M+SG
zacas	zaca+N+M+PL
zaca	zaca+N+M+SG
zacintinhos	zacinto+N+DIM+M+PL
zacintozinhos	zacinto+N+DIM+M+PL
zacintinho	zacinto+N+DIM+M+SG
zacintozinho	zacinto+N+DIM+M+SG
zacintos	zacinto+N+M+PL
zacinto	zacinto+N+M+SG
zacozinhos	zaco+N+DIM+M+PL
zaquinhos	zaco+N+DIM+M+PL
zacozinho	zaco+N+DIM+M+SG
zaquinho	zaco+N+DIM+M+SG
zacos	zaco+N+M+PL
zaco	zaco+N+M+SG
zaconicidadezinhas	zaconicidade+N+DIM+F+PL
zaconicidadinhas	zaconicidade+N+DIM+F+PL
zaconicidadezinha	zaconicidade+N+DIM+F+SG
zaconicidadinha	zaconicidade+N+DIM+F+SG
zaconicidades	zaconicidade+N+F+PL
zaconicidade	zaconicidade+N+F+SG
zacunzinhos	zacum+N+DIM+M+PL
zacunzinho	zacum+N+DIM+M+SG
zacuns	zacum+N+M+PL
zacum	zacum+N+M+SG
zaconicozinhos	zacónico+N+DIM+M+PL
zaconiquinhos	zacónico+N+DIM+M+PL
zaconicozinho	zacónico+N+DIM+M+SG
zaconiquinho	zacónico+N+DIM+M+SG
zacónicos	zacónico+N+M+PL
zacónico	zacónico+N+M+SG
zaconicozinhos	zacônico+N+DIM+M+PL
zaconiquinhos	zacônico+N+DIM+M+PL
zaconicozinho	zacônico+N+DIM+M+SG
zaconiquinho	zacônico+N+DIM+M+SG
zacônicos	zacônico+N+M+PL
zacônico	zacônico+N+M+SG
zaconinhos	zacônio+N+DIM+M+PL
zaconiozinhos	zacônio+N+DIM+M+PL
zaconinho	zacônio+N+DIM+M+SG
zaconiozinho	zacônio+N+DIM+M+SG
zacônios	zacônio+N+M+PL
zacônio	zacônio+N+M+SG
zadonazinhas	zadona+N+DIM+F+PL
zadoninhas	zadona+N+DIM+F+PL
zadonazinha	zadona+N+DIM+F+SG
zadoninha	zadona+N+DIM+F+SG
zadonas	zadona+N+F+PL
zadona	zadona+N+F+SG
zadrezistazinhas	zadrezista+N+DIM+F+PL
zadrezistazinha	zadrezista+N+DIM+F+SG
zadrezistazinhos	zadrezista+N+DIM+M+PL
zadrezistazinho	zadrezista+N+DIM+M+SG
zadrezistinhas	zadrezista+N+DIM+PL
zadrezistinha	zadrezista+N+DIM+SG
zadrezistas	zadrezista+N+PL
zadrezista	zadrezista+N+SG
zadrugazinhas	zadruga+N+DIM+F+PL
zadruguinhas	zadruga+N+DIM+F+PL
zadrugazinha	zadruga+N+DIM+F+SG
zadruguinha	zadruga+N+DIM+F+SG
zadrugas	zadruga+N+F+PL
zadruga	zadruga+N+F+SG
zafarranchinhos	zafarrancho+N+DIM+M+PL
zafarranchozinhos	zafarrancho+N+DIM+M+PL
zafarranchinho	zafarrancho+N+DIM+M+SG
zafarranchozinho	zafarrancho+N+DIM+M+SG
zafarranchos	zafarrancho+N+M+PL
zafarrancho	zafarrancho+N+M+SG
zafirazinhas	zafira+N+DIM+F+PL
zafirinhas	zafira+N+DIM+F+PL
zafirazinha	zafira+N+DIM+F+SG
zafirinha	zafira+N+DIM+F+SG
zafiras	zafira+N+F+PL
zafira	zafira+N+F+SG
zagazinhas	zaga+N+DIM+F+PL
zaguinhas	zaga+N+DIM+F+PL
zagazinha	zaga+N+DIM+F+SG
zaguinha	zaga+N+DIM+F+SG
zagas	zaga+N+F+PL
zaga	zaga+N+F+SG
zagaiazinhas	zagaia+N+DIM+F+PL
zagainhas	zagaia+N+DIM+F+PL
zagaiazinha	zagaia+N+DIM+F+SG
zagainha	zagaia+N+DIM+F+SG
zagaias	zagaia+N+F+PL
zagaia	zagaia+N+F+SG
zagaiadazinhas	zagaiada+N+DIM+F+PL
zagaiadinhas	zagaiada+N+DIM+F+PL
zagaiadazinha	zagaiada+N+DIM+F+SG
zagaiadinha	zagaiada+N+DIM+F+SG
zagaiadas	zagaiada+N+F+PL
zagaiada	zagaiada+N+F+SG
zagaieirazinhas	zagaieiro+N+DIM+F+PL
zagaieirinhas	zagaieiro+N+DIM+F+PL
zagaieirazinha	zagaieiro+N+DIM+F+SG
zagaieirinha	zagaieiro+N+DIM+F+SG
zagaieirinhos	zagaieiro+N+DIM+M+PL
zagaieirozinhos	zagaieiro+N+DIM+M+PL
zagaieirinho	zagaieiro+N+DIM+M+SG
zagaieirozinho	zagaieiro+N+DIM+M+SG
zagaieiras	zagaieiro+N+F+PL
zagaieira	zagaieiro+N+F+SG
zagaieiros	zagaieiro+N+M+PL
zagaieiro	zagaieiro+N+M+SG
zagalazinhas	zagal+N+DIM+F+PL
zagalinhas	zagal+N+DIM+F+PL
zagalazinha	zagal+N+DIM+F+SG
zagalinha	zagal+N+DIM+F+SG
zagaizinhos	zagal+N+DIM+M+PL
zagalzinho	zagal+N+DIM+M+SG
zagalas	zagal+N+F+PL
zagala	zagal+N+F+SG
zagais	zagal+N+M+PL
zagal	zagal+N+M+SG
zagalejinhos	zagalejo+N+DIM+M+PL
zagalejozinhos	zagalejo+N+DIM+M+PL
zagalejinho	zagalejo+N+DIM+M+SG
zagalejozinho	zagalejo+N+DIM+M+SG
zagalejos	zagalejo+N+M+PL
zagalejo	zagalejo+N+M+SG
zagaletezinhos	zagalete+N+DIM+M+PL
zagaletinhos	zagalete+N+DIM+M+PL
zagaletezinho	zagalete+N+DIM+M+SG
zagaletinho	zagalete+N+DIM+M+SG
zagaletes	zagalete+N+M+PL
zagalete	zagalete+N+M+SG
zagaletinhos	zagaleto+N+DIM+M+PL
zagaletozinhos	zagaleto+N+DIM+M+PL
zagaletinho	zagaleto+N+DIM+M+SG
zagaletozinho	zagaleto+N+DIM+M+SG
zagaletos	zagaleto+N+M+PL
zagaleto	zagaleto+N+M+SG
zagalotezinhos	zagalote+N+DIM+M+PL
zagalotinhos	zagalote+N+DIM+M+PL
zagalotezinho	zagalote+N+DIM+M+SG
zagalotinho	zagalote+N+DIM+M+SG
zagalotes	zagalote+N+M+PL
zagalote	zagalote+N+M+SG
zagarizinhos	zagari+N+DIM+M+PL
zagarizinho	zagari+N+DIM+M+SG
zagaris	zagari+N+M+PL
zagari	zagari+N+M+SG
zagataizinhos	zagatai+N+DIM+M+PL
zagataizinho	zagatai+N+DIM+M+SG
zagatais	zagatai+N+M+PL
zagatai	zagatai+N+M+SG
zagatezinhos	zagaté+N+DIM+M+PL
zagatezinho	zagaté+N+DIM+M+SG
zagatés	zagaté+N+M+PL
zagaté	zagaté+N+M+SG
zaglossinhos	zaglosso+N+DIM+M+PL
zaglossozinhos	zaglosso+N+DIM+M+PL
zaglossinho	zaglosso+N+DIM+M+SG
zaglossozinho	zaglosso+N+DIM+M+SG
zaglossos	zaglosso+N+M+PL
zaglosso	zaglosso+N+M+SG
zagonaizinhos	zagonal+N+DIM+M+PL
zagonalzinho	zagonal+N+DIM+M+SG
zagonais	zagonal+N+M+PL
zagonal	zagonal+N+M+SG
zagorazinhas	zagor+N+DIM+F+PL
zagorinhas	zagor+N+DIM+F+PL
zagorazinha	zagor+N+DIM+F+SG
zagorinha	zagor+N+DIM+F+SG
zagorezinhos	zagor+N+DIM+M+PL
zagorzinhos	zagor+N+DIM+M+PL
zagorzinho	zagor+N+DIM+M+SG
zagoras	zagor+N+F+PL
zagora	zagor+N+F+SG
zagores	zagor+N+M+PL
zagor	zagor+N+M+SG
zagorrinazinhas	zagorrino+N+DIM+F+PL
zagorrininhas	zagorrino+N+DIM+F+PL
zagorrinazinha	zagorrino+N+DIM+F+SG
zagorrininha	zagorrino+N+DIM+F+SG
zagorrininhos	zagorrino+N+DIM+M+PL
zagorrinozinhos	zagorrino+N+DIM+M+PL
zagorrininho	zagorrino+N+DIM+M+SG
zagorrinozinho	zagorrino+N+DIM+M+SG
zagorrinas	zagorrino+N+F+PL
zagorrina	zagorrino+N+F+SG
zagorrinos	zagorrino+N+M+PL
zagorrino	zagorrino+N+M+SG
zagorrazinhas	zagorro+N+DIM+F+PL
zagorrinhas	zagorro+N+DIM+F+PL
zagorrazinha	zagorro+N+DIM+F+SG
zagorrinha	zagorro+N+DIM+F+SG
zagorrinhos	zagorro+N+DIM+M+PL
zagorrozinhos	zagorro+N+DIM+M+PL
zagorrinho	zagorro+N+DIM+M+SG
zagorrozinho	zagorro+N+DIM+M+SG
zagorras	zagorro+N+F+PL
zagorra	zagorro+N+F+SG
zagorros	zagorro+N+M+PL
zagorro	zagorro+N+M+SG
zagraisminhos	zagraísmo+N+DIM+M+PL
zagraismozinhos	zagraísmo+N+DIM+M+PL
zagraisminho	zagraísmo+N+DIM+M+SG
zagraismozinho	zagraísmo+N+DIM+M+SG
zagraísmos	zagraísmo+N+M+PL
zagraísmo	zagraísmo+N+M+SG
zagrezinhos	zagre+N+DIM+M+PL
zagrinhos	zagre+N+DIM+M+PL
zagrezinho	zagre+N+DIM+M+SG
zagrinho	zagre+N+DIM+M+SG
zagres	zagre+N+M+PL
zagre	zagre+N+M+SG
zagrõezinhos	zagrão+N+DIM+M+PL
zagrãozinho	zagrão+N+DIM+M+SG
zagrões	zagrão+N+M+PL
zagrão	zagrão+N+M+SG
zaguzinhos	zagu+N+DIM+M+PL
zaguzinho	zagu+N+DIM+M+SG
zagus	zagu+N+M+PL
zagu	zagu+N+M+SG
zagueirinhos	zagueiro+N+DIM+M+PL
zagueirozinhos	zagueiro+N+DIM+M+PL
zagueirinho	zagueiro+N+DIM+M+SG
zagueirozinho	zagueiro+N+DIM+M+SG
zagueiros	zagueiro+N+M+PL
zagueiro	zagueiro+N+M+SG
zagunchadazinhas	zagunchada+N+DIM+F+PL
zagunchadinhas	zagunchada+N+DIM+F+PL
zagunchadazinha	zagunchada+N+DIM+F+SG
zagunchadinha	zagunchada+N+DIM+F+SG
zagunchadas	zagunchada+N+F+PL
zagunchada	zagunchada+N+F+SG
zagunchinhos	zaguncho+N+DIM+M+PL
zagunchozinhos	zaguncho+N+DIM+M+PL
zagunchinho	zaguncho+N+DIM+M+SG
zagunchozinho	zaguncho+N+DIM+M+SG
zagunchos	zaguncho+N+M+PL
zaguncho	zaguncho+N+M+SG
zagõezinhos	zagão+N+DIM+M+PL
zagãozinho	zagão+N+DIM+M+SG
zagões	zagão+N+M+PL
zagão	zagão+N+M+SG
zaibatsuzinhos	zaibatsu+N+DIM+M+PL
zaibatsuzinho	zaibatsu+N+DIM+M+SG
zaibatsus	zaibatsu+N+M+PL
zaibatsu	zaibatsu+N+M+SG
zaidazinhas	zaida+N+DIM+F+PL
zaidinhas	zaida+N+DIM+F+PL
zaidazinha	zaida+N+DIM+F+SG
zaidinha	zaida+N+DIM+F+SG
zaidas	zaida+N+F+PL
zaida	zaida+N+F+SG
zaidizinhos	zaidi+N+DIM+M+PL
zaidizinho	zaidi+N+DIM+M+SG
zaidis	zaidi+N+M+PL
zaidi	zaidi+N+M+SG
zaiminhos	zaimo+N+DIM+M+PL
zaimozinhos	zaimo+N+DIM+M+PL
zaiminho	zaimo+N+DIM+M+SG
zaimozinho	zaimo+N+DIM+M+SG
zaimos	zaimo+N+M+PL
zaimo	zaimo+N+M+SG
zainazinhas	zaina+N+DIM+F+PL
zaininhas	zaina+N+DIM+F+PL
zainazinha	zaina+N+DIM+F+SG
zaininha	zaina+N+DIM+F+SG
zainas	zaina+N+F+PL
zaina	zaina+N+F+SG
zainezinhos	zaine+N+DIM+M+PL
zaininhos	zaine+N+DIM+M+PL
zainezinho	zaine+N+DIM+M+SG
zaininho	zaine+N+DIM+M+SG
zaines	zaine+N+M+PL
zaine	zaine+N+M+SG
zainfezinhas	zainfe+N+DIM+F+PL
zainfinhas	zainfe+N+DIM+F+PL
zainfezinha	zainfe+N+DIM+F+SG
zainfinha	zainfe+N+DIM+F+SG
zainfes	zainfe+N+F+PL
zainfe	zainfe+N+F+SG
zainazinhas	zaino+N+DIM+F+PL
zaininhas	zaino+N+DIM+F+PL
zainazinha	zaino+N+DIM+F+SG
zaininha	zaino+N+DIM+F+SG
zaininhos	zaino+N+DIM+M+PL
zainozinhos	zaino+N+DIM+M+PL
zaininho	zaino+N+DIM+M+SG
zainozinho	zaino+N+DIM+M+SG
zainas	zaino+N+F+PL
zaina	zaino+N+F+SG
zainos	zaino+N+M+PL
zaino	zaino+N+M+SG
zaipanazinhos	zaipana+N+DIM+M+PL
zaipaninhas	zaipana+N+DIM+M+PL
zaipanazinho	zaipana+N+DIM+M+SG
zaipaninha	zaipana+N+DIM+M+SG
zaipanas	zaipana+N+M+PL
zaipana	zaipana+N+M+SG
zairazinhas	zaira+N+DIM+F+PL
zairinhas	zaira+N+DIM+F+PL
zairazinha	zaira+N+DIM+F+SG
zairinha	zaira+N+DIM+F+SG
zairas	zaira+N+F+PL
zaira	zaira+N+F+SG
zairensezinhas	zairense+N+DIM+F+PL
zairensinhas	zairense+N+DIM+F+PL
zairensezinha	zairense+N+DIM+F+SG
zairensinha	zairense+N+DIM+F+SG
zairensezinhos	zairense+N+DIM+M+PL
zairensinhos	zairense+N+DIM+M+PL
zairensezinho	zairense+N+DIM+M+SG
zairensinho	zairense+N+DIM+M+SG
zairenses	zairense+N+PL
zairense	zairense+N+SG
zairisminhos	zairismo+N+DIM+M+PL
zairismozinhos	zairismo+N+DIM+M+PL
zairisminho	zairismo+N+DIM+M+SG
zairismozinho	zairismo+N+DIM+M+SG
zairismos	zairismo+N+M+PL
zairismo	zairismo+N+M+SG
zaizinhos	zal+N+DIM+M+PL
zalzinho	zal+N+DIM+M+SG
zais	zal+N+M+PL
zal	zal+N+M+SG
zalacazinhas	zalaca+N+DIM+F+PL
zalaquinhas	zalaca+N+DIM+F+PL
zalacazinha	zalaca+N+DIM+F+SG
zalaquinha	zalaca+N+DIM+F+SG
zalacas	zalaca+N+F+PL
zalaca	zalaca+N+F+SG
zalcibatinazinhas	zalcibatina+N+DIM+F+PL
zalcibatininhas	zalcibatina+N+DIM+F+PL
zalcibatinazinha	zalcibatina+N+DIM+F+SG
zalcibatininha	zalcibatina+N+DIM+F+SG
zalcibatinas	zalcibatina+N+F+PL
zalcibatina	zalcibatina+N+F+SG
zaluandazinhas	zaluanda+N+DIM+F+PL
zaluandinhas	zaluanda+N+DIM+F+PL
zaluandazinha	zaluanda+N+DIM+F+SG
zaluandinha	zaluanda+N+DIM+F+SG
zaluandas	zaluanda+N+F+PL
zaluanda	zaluanda+N+F+SG
zaluzaniazinhas	zaluzânia+N+DIM+F+PL
zaluzaninhas	zaluzânia+N+DIM+F+PL
zaluzaniazinha	zaluzânia+N+DIM+F+SG
zaluzaninha	zaluzânia+N+DIM+F+SG
zaluzânias	zaluzânia+N+F+PL
zaluzânia	zaluzânia+N+F+SG
zamazinhas	zama+N+DIM+F+PL
zamazinha	zama+N+DIM+F+SG
zamazinhos	zama+N+DIM+M+PL
zamazinho	zama+N+DIM+M+SG
zaminhas	zama+N+DIM+PL
zaminha	zama+N+DIM+SG
zamas	zama+N+PL
zama	zama+N+SG
zamakzinhos	zamak+N+DIM+M+PL
zamakzinho	zamak+N+DIM+M+SG
zamaks	zamak+N+M+PL
zamak	zamak+N+M+SG
zamaquezinhos	zamaque+N+DIM+M+PL
zamaquinhos	zamaque+N+DIM+M+PL
zamaquezinho	zamaque+N+DIM+M+SG
zamaquinho	zamaque+N+DIM+M+SG
zamaques	zamaque+N+M+PL
zamaque	zamaque+N+M+SG
zambazinhas	zamba+N+DIM+F+PL
zambinhas	zamba+N+DIM+F+PL
zambazinha	zamba+N+DIM+F+SG
zambinha	zamba+N+DIM+F+SG
zambas	zamba+N+F+PL
zamba	zamba+N+F+SG
zambanazinhos	zambana+N+DIM+M+PL
zambaninhas	zambana+N+DIM+M+PL
zambanazinho	zambana+N+DIM+M+SG
zambaninha	zambana+N+DIM+M+SG
zambanas	zambana+N+M+PL
zambana	zambana+N+M+SG
zambelezinhos	zambelê+N+DIM+M+PL
zambelezinho	zambelê+N+DIM+M+SG
zambelês	zambelê+N+M+PL
zambelê	zambelê+N+M+SG
zambequezinhos	zambeque+N+DIM+M+PL
zambequinhos	zambeque+N+DIM+M+PL
zambequezinho	zambeque+N+DIM+M+SG
zambequinho	zambeque+N+DIM+M+SG
zambeques	zambeque+N+M+PL
zambeque	zambeque+N+M+SG
zambetazinhas	zambeta+N+DIM+F+PL
zambetazinha	zambeta+N+DIM+F+SG
zambetazinhos	zambeta+N+DIM+M+PL
zambetazinho	zambeta+N+DIM+M+SG
zambetinhas	zambeta+N+DIM+PL
zambetinha	zambeta+N+DIM+SG
zambetas	zambeta+N+PL
zambeta	zambeta+N+SG
zambetinhos	zambeto+N+DIM+M+PL
zambetozinhos	zambeto+N+DIM+M+PL
zambetinho	zambeto+N+DIM+M+SG
zambetozinho	zambeto+N+DIM+M+SG
zambetos	zambeto+N+M+PL
zambeto	zambeto+N+M+SG
zambizinhos	zambi+N+DIM+M+PL
zambizinho	zambi+N+DIM+M+SG
zambis	zambi+N+M+PL
zambi	zambi+N+M+SG
zambiampongozinhos	zambiampongo+N+DIM+M+PL
zambiamponguinhos	zambiampongo+N+DIM+M+PL
zambiampongozinho	zambiampongo+N+DIM+M+SG
zambiamponguinho	zambiampongo+N+DIM+M+SG
zambiampongos	zambiampongo+N+M+PL
zambiampongo	zambiampongo+N+M+SG
zambiampungozinhos	zambiampungo+N+DIM+M+PL
zambiampunguinhos	zambiampungo+N+DIM+M+PL
zambiampungozinho	zambiampungo+N+DIM+M+SG
zambiampunguinho	zambiampungo+N+DIM+M+SG
zambiampungos	zambiampungo+N+M+PL
zambiampungo	zambiampungo+N+M+SG
zambianazinhas	zambiano+N+DIM+F+PL
zambianinhas	zambiano+N+DIM+F+PL
zambianazinha	zambiano+N+DIM+F+SG
zambianinha	zambiano+N+DIM+F+SG
zambianinhos	zambiano+N+DIM+M+PL
zambianozinhos	zambiano+N+DIM+M+PL
zambianinho	zambiano+N+DIM+M+SG
zambianozinho	zambiano+N+DIM+M+SG
zambianas	zambiano+N+F+PL
zambiana	zambiano+N+F+SG
zambianos	zambiano+N+M+PL
zambiano	zambiano+N+M+SG
zambiapombinhos	zambiapombo+N+DIM+M+PL
zambiapombozinhos	zambiapombo+N+DIM+M+PL
zambiapombinho	zambiapombo+N+DIM+M+SG
zambiapombozinho	zambiapombo+N+DIM+M+SG
zambiapombos	zambiapombo+N+M+PL
zambiapombo	zambiapombo+N+M+SG
zambiapongozinhos	zambiapongo+N+DIM+M+PL
zambiaponguinhos	zambiapongo+N+DIM+M+PL
zambiapongozinho	zambiapongo+N+DIM+M+SG
zambiaponguinho	zambiapongo+N+DIM+M+SG
zambiapongos	zambiapongo+N+M+PL
zambiapongo	zambiapongo+N+M+SG
zambiapungozinhos	zambiapungo+N+DIM+M+PL
zambiapunguinhos	zambiapungo+N+DIM+M+PL
zambiapungozinho	zambiapungo+N+DIM+M+SG
zambiapunguinho	zambiapungo+N+DIM+M+SG
zambiapungos	zambiapungo+N+M+PL
zambiapungo	zambiapungo+N+M+SG
zambiuapongozinhos	zambiuapongo+N+DIM+M+PL
zambiuaponguinhos	zambiuapongo+N+DIM+M+PL
zambiuapongozinho	zambiuapongo+N+DIM+M+SG
zambiuaponguinho	zambiuapongo+N+DIM+M+SG
zambiuapongos	zambiuapongo+N+M+PL
zambiuapongo	zambiuapongo+N+M+SG
zambiupombinhos	zambiupombo+N+DIM+M+PL
zambiupombozinhos	zambiupombo+N+DIM+M+PL
zambiupombinho	zambiupombo+N+DIM+M+SG
zambiupombozinho	zambiupombo+N+DIM+M+SG
zambiupombos	zambiupombo+N+M+PL
zambiupombo	zambiupombo+N+M+SG
zambazinhas	zambo+N+DIM+F+PL
zambinhas	zambo+N+DIM+F+PL
zambazinha	zambo+N+DIM+F+SG
zambinha	zambo+N+DIM+F+SG
zambinhos	zambo+N+DIM+M+PL
zambozinhos	zambo+N+DIM+M+PL
zambinho	zambo+N+DIM+M+SG
zambozinho	zambo+N+DIM+M+SG
zambas	zambo+N+F+PL
zamba	zambo+N+F+SG
zambos	zambo+N+M+PL
zambo	zambo+N+M+SG
zamboazinhas	zamboa+N+DIM+F+PL
zamboinhas	zamboa+N+DIM+F+PL
zamboazinha	zamboa+N+DIM+F+SG
zamboinha	zamboa+N+DIM+F+SG
zamboas	zamboa+N+F+PL
zamboa	zamboa+N+F+SG
zamboadazinhas	zamboada+N+DIM+F+PL
zamboadinhas	zamboada+N+DIM+F+PL
zamboadazinha	zamboada+N+DIM+F+SG
zamboadinha	zamboada+N+DIM+F+SG
zamboadas	zamboada+N+F+PL
zamboada	zamboada+N+F+SG
zamboeirazinhas	zamboeira+N+DIM+F+PL
zamboeirinhas	zamboeira+N+DIM+F+PL
zamboeirazinha	zamboeira+N+DIM+F+SG
zamboeirinha	zamboeira+N+DIM+F+SG
zamboeiras	zamboeira+N+F+PL
zamboeira	zamboeira+N+F+SG
zamboeirinhos	zamboeiro+N+DIM+M+PL
zamboeirozinhos	zamboeiro+N+DIM+M+PL
zamboeirinho	zamboeiro+N+DIM+M+SG
zamboeirozinho	zamboeiro+N+DIM+M+SG
zamboeiros	zamboeiro+N+M+PL
zamboeiro	zamboeiro+N+M+SG
zamboninitazinhas	zamboninita+N+DIM+F+PL
zamboninitinhas	zamboninita+N+DIM+F+PL
zamboninitazinha	zamboninita+N+DIM+F+SG
zamboninitinha	zamboninita+N+DIM+F+SG
zamboninitas	zamboninita+N+F+PL
zamboninita	zamboninita+N+F+SG
zamboquezinhos	zamboque+N+DIM+M+PL
zamboquinhos	zamboque+N+DIM+M+PL
zamboquezinho	zamboque+N+DIM+M+SG
zamboquinho	zamboque+N+DIM+M+SG
zamboques	zamboque+N+M+PL
zamboque	zamboque+N+M+SG
zamborinazinhas	zamborina+N+DIM+F+PL
zamborininhas	zamborina+N+DIM+F+PL
zamborinazinha	zamborina+N+DIM+F+SG
zamborininha	zamborina+N+DIM+F+SG
zamborinas	zamborina+N+F+PL
zamborina	zamborina+N+F+SG
zamborrazinhas	zamborra+N+DIM+F+PL
zamborrinhas	zamborra+N+DIM+F+PL
zamborrazinha	zamborra+N+DIM+F+SG
zamborrinha	zamborra+N+DIM+F+SG
zamborras	zamborra+N+F+PL
zamborra	zamborra+N+F+SG
zamborradazinhas	zamborrada+N+DIM+F+PL
zamborradinhas	zamborrada+N+DIM+F+PL
zamborradazinha	zamborrada+N+DIM+F+SG
zamborradinha	zamborrada+N+DIM+F+SG
zamborradas	zamborrada+N+F+PL
zamborrada	zamborrada+N+F+SG
zambotinhos	zamboto+N+DIM+M+PL
zambotozinhos	zamboto+N+DIM+M+PL
zambotinho	zamboto+N+DIM+M+SG
zambotozinho	zamboto+N+DIM+M+SG
zambotos	zamboto+N+M+PL
zamboto	zamboto+N+M+SG
zambozininhos	zambozino+N+DIM+M+PL
zambozinozinhos	zambozino+N+DIM+M+PL
zambozininho	zambozino+N+DIM+M+SG
zambozinozinho	zambozino+N+DIM+M+SG
zambozinos	zambozino+N+M+PL
zambozino	zambozino+N+M+SG
zambozinosinhas	zambozinos+N+DIM+F+PL
zambozinosinhos	zambozinos+N+DIM+M+PL
zambozinos	zambozinos+N+M+PL
zambrazinhas	zambra+N+DIM+F+PL
zambrinhas	zambra+N+DIM+F+PL
zambrazinha	zambra+N+DIM+F+SG
zambrinha	zambra+N+DIM+F+SG
zambras	zambra+N+F+PL
zambra	zambra+N+F+SG
zambralhinhos	zambralho+N+DIM+M+PL
zambralhozinhos	zambralho+N+DIM+M+PL
zambralhinho	zambralho+N+DIM+M+SG
zambralhozinho	zambralho+N+DIM+M+SG
zambralhos	zambralho+N+M+PL
zambralho	zambralho+N+M+SG
zambranazinhos	zambrana+N+DIM+M+PL
zambraninhas	zambrana+N+DIM+M+PL
zambranazinho	zambrana+N+DIM+M+SG
zambraninha	zambrana+N+DIM+M+SG
zambranas	zambrana+N+M+PL
zambrana	zambrana+N+M+SG
zambucaizinhos	zambucal+N+DIM+M+PL
zambucalzinho	zambucal+N+DIM+M+SG
zambucais	zambucal+N+M+PL
zambucal	zambucal+N+M+SG
zambucozinhos	zambuco+N+DIM+M+PL
zambuquinhos	zambuco+N+DIM+M+PL
zambucozinho	zambuco+N+DIM+M+SG
zambuquinho	zambuco+N+DIM+M+SG
zambucos	zambuco+N+M+PL
zambuco	zambuco+N+M+SG
zambugaizinhos	zambugal+N+DIM+M+PL
zambugalzinho	zambugal+N+DIM+M+SG
zambugais	zambugal+N+M+PL
zambugal	zambugal+N+M+SG
zambujaizinhos	zambujal+N+DIM+M+PL
zambujalzinho	zambujal+N+DIM+M+SG
zambujais	zambujal+N+M+PL
zambujal	zambujal+N+M+SG
zambujeirinhos	zambujeiro+N+DIM+M+PL
zambujeirozinhos	zambujeiro+N+DIM+M+PL
zambujeirinho	zambujeiro+N+DIM+M+SG
zambujeirozinho	zambujeiro+N+DIM+M+SG
zambujeiros	zambujeiro+N+M+PL
zambujeiro	zambujeiro+N+M+SG
zambujinhos	zambujo+N+DIM+M+PL
zambujozinhos	zambujo+N+DIM+M+PL
zambujinho	zambujo+N+DIM+M+SG
zambujozinho	zambujo+N+DIM+M+SG
zambujos	zambujo+N+M+PL
zambujo	zambujo+N+M+SG
zambulheirazinhas	zambulheira+N+DIM+F+PL
zambulheirinhas	zambulheira+N+DIM+F+PL
zambulheirazinha	zambulheira+N+DIM+F+SG
zambulheirinha	zambulheira+N+DIM+F+SG
zambulheiras	zambulheira+N+F+PL
zambulheira	zambulheira+N+F+SG
zambulhinhos	zambulho+N+DIM+M+PL
zambulhozinhos	zambulho+N+DIM+M+PL
zambulhinho	zambulho+N+DIM+M+SG
zambulhozinho	zambulho+N+DIM+M+SG
zambulhos	zambulho+N+M+PL
zambulho	zambulho+N+M+SG
zambulazinhos	zambulá+N+DIM+M+PL
zambulazinho	zambulá+N+DIM+M+SG
zambulás	zambulá+N+M+PL
zambulá	zambulá+N+M+SG
zambumbazinhas	zambumba+N+DIM+F+PL
zambumbinhas	zambumba+N+DIM+F+PL
zambumbazinha	zambumba+N+DIM+F+SG
zambumbinha	zambumba+N+DIM+F+SG
zambumbas	zambumba+N+F+PL
zambumba	zambumba+N+F+SG
zamburequezinhos	zambureque+N+DIM+M+PL
zamburequinhos	zambureque+N+DIM+M+PL
zamburequezinho	zambureque+N+DIM+M+SG
zamburequinho	zambureque+N+DIM+M+SG
zambureques	zambureque+N+M+PL
zambureque	zambureque+N+M+SG
zamburradazinhas	zamburrada+N+DIM+F+PL
zamburradinhas	zamburrada+N+DIM+F+PL
zamburradazinha	zamburrada+N+DIM+F+SG
zamburradinha	zamburrada+N+DIM+F+SG
zamburradas	zamburrada+N+F+PL
zamburrada	zamburrada+N+F+SG
zamburrinhazinhas	zamburrinha+N+DIM+F+PL
zamburrinhinhas	zamburrinha+N+DIM+F+PL
zamburrinhazinha	zamburrinha+N+DIM+F+SG
zamburrinhinha	zamburrinha+N+DIM+F+SG
zamburrinhas	zamburrinha+N+F+PL
zamburrinha	zamburrinha+N+F+SG
zamenazinhas	zamena+N+DIM+F+PL
zameninhas	zamena+N+DIM+F+PL
zamenazinha	zamena+N+DIM+F+SG
zameninha	zamena+N+DIM+F+SG
zamenas	zamena+N+F+PL
zamena	zamena+N+F+SG
zamiazinhas	zamia+N+DIM+F+PL
zaminhas	zamia+N+DIM+F+PL
zamiazinha	zamia+N+DIM+F+SG
zaminha	zamia+N+DIM+F+SG
zamias	zamia+N+F+PL
zamia	zamia+N+F+SG
zamiapombinhos	zamiapombo+N+DIM+M+PL
zamiapombozinhos	zamiapombo+N+DIM+M+PL
zamiapombinho	zamiapombo+N+DIM+M+SG
zamiapombozinho	zamiapombo+N+DIM+M+SG
zamiapombos	zamiapombo+N+M+PL
zamiapombo	zamiapombo+N+M+SG
zamicrinhos	zamicro+N+DIM+M+PL
zamicrozinhos	zamicro+N+DIM+M+PL
zamicrinho	zamicro+N+DIM+M+SG
zamicrozinho	zamicro+N+DIM+M+SG
zamicros	zamicro+N+M+PL
zamicro	zamicro+N+M+SG
zamiaceazinhas	zamiácea+N+DIM+F+PL
zamiaceinhas	zamiácea+N+DIM+F+PL
zamiaceazinha	zamiácea+N+DIM+F+SG
zamiaceinha	zamiácea+N+DIM+F+SG
zamiáceas	zamiácea+N+F+PL
zamiácea	zamiácea+N+F+SG
zamiaceazinhas	zamiáceo+N+DIM+F+PL
zamiaceinhas	zamiáceo+N+DIM+F+PL
zamiaceazinha	zamiáceo+N+DIM+F+SG
zamiaceinha	zamiáceo+N+DIM+F+SG
zamiaceinhos	zamiáceo+N+DIM+M+PL
zamiaceozinhos	zamiáceo+N+DIM+M+PL
zamiaceinho	zamiáceo+N+DIM+M+SG
zamiaceozinho	zamiáceo+N+DIM+M+SG
zamiáceas	zamiáceo+N+F+PL
zamiácea	zamiáceo+N+F+SG
zamiáceos	zamiáceo+N+M+PL
zamiáceo	zamiáceo+N+M+SG
zamorinzinhos	zamorim+N+DIM+M+PL
zamorinzinho	zamorim+N+DIM+M+SG
zamorins	zamorim+N+M+PL
zamorim	zamorim+N+M+SG
zamparinazinhas	zamparina+N+DIM+F+PL
zamparininhas	zamparina+N+DIM+F+PL
zamparinazinha	zamparina+N+DIM+F+SG
zamparininha	zamparina+N+DIM+F+SG
zamparinas	zamparina+N+F+PL
zamparina	zamparina+N+F+SG
zamuminhos	zamumo+N+DIM+M+PL
zamumozinhos	zamumo+N+DIM+M+PL
zamuminho	zamumo+N+DIM+M+SG
zamumozinho	zamumo+N+DIM+M+SG
zamumos	zamumo+N+M+PL
zamumo	zamumo+N+M+SG
zanazinhas	zana+N+DIM+F+PL
zaninhas	zana+N+DIM+F+PL
zanazinha	zana+N+DIM+F+SG
zaninha	zana+N+DIM+F+SG
zanas	zana+N+F+PL
zana	zana+N+F+SG
zanagazinhas	zanaga+N+DIM+F+PL
zanagazinha	zanaga+N+DIM+F+SG
zanagazinhos	zanaga+N+DIM+M+PL
zanagazinho	zanaga+N+DIM+M+SG
zanaguinhas	zanaga+N+DIM+PL
zanaguinha	zanaga+N+DIM+SG
zanagas	zanaga+N+PL
zanaga	zanaga+N+SG
zanagozinhas	zanago+N+DIM+F+PL
zanagozinha	zanago+N+DIM+F+SG
zanagozinhos	zanago+N+DIM+M+PL
zanagozinho	zanago+N+DIM+M+SG
zanaguinhos	zanago+N+DIM+PL
zanaguinho	zanago+N+DIM+SG
zanagos	zanago+N+PL
zanago	zanago+N+SG
zanalzinhos	zanal+N+DIM+M+PL
zanalzinho	zanal+N+DIM+M+SG
zanals	zanal+N+M+PL
zanal	zanal+N+M+SG
zanaloinazinhas	zanaloína+N+DIM+F+PL
zanaloininhas	zanaloína+N+DIM+F+PL
zanaloinazinha	zanaloína+N+DIM+F+SG
zanaloininha	zanaloína+N+DIM+F+SG
zanaloínas	zanaloína+N+F+PL
zanaloína	zanaloína+N+F+SG
zanatazinhas	zanata+N+DIM+F+PL
zanatinhas	zanata+N+DIM+F+PL
zanatazinha	zanata+N+DIM+F+SG
zanatinha	zanata+N+DIM+F+SG
zanatas	zanata+N+F+PL
zanata	zanata+N+F+SG
zancarrõezinhos	zancarrão+N+DIM+M+PL
zancarrãozinho	zancarrão+N+DIM+M+SG
zancarrões	zancarrão+N+M+PL
zancarrão	zancarrão+N+M+SG
zanclinhos	zanclo+N+DIM+M+PL
zanclozinhos	zanclo+N+DIM+M+PL
zanclinho	zanclo+N+DIM+M+SG
zanclozinho	zanclo+N+DIM+M+SG
zanclos	zanclo+N+M+PL
zanclo	zanclo+N+M+SG
zanclognatazinhas	zanclógnata+N+DIM+F+PL
zanclognatinhas	zanclógnata+N+DIM+F+PL
zanclognatazinha	zanclógnata+N+DIM+F+SG
zanclognatinha	zanclógnata+N+DIM+F+SG
zanclógnatas	zanclógnata+N+F+PL
zanclógnata	zanclógnata+N+F+SG
zanclostominhos	zanclóstomo+N+DIM+M+PL
zanclostomozinhos	zanclóstomo+N+DIM+M+PL
zanclostominho	zanclóstomo+N+DIM+M+SG
zanclostomozinho	zanclóstomo+N+DIM+M+SG
zanclóstomos	zanclóstomo+N+M+PL
zanclóstomo	zanclóstomo+N+M+SG
zangazinhas	zanga+N+DIM+F+PL
zanguinhas	zanga+N+DIM+F+PL
zangazinha	zanga+N+DIM+F+SG
zanguinha	zanga+N+DIM+F+SG
zangas	zanga+N+F+PL
zanga	zanga+N+F+SG
zangaburrinhazinhas	zangaburrinha+N+DIM+F+PL
zangaburrinhinhas	zangaburrinha+N+DIM+F+PL
zangaburrinhazinha	zangaburrinha+N+DIM+F+SG
zangaburrinhinha	zangaburrinha+N+DIM+F+SG
zangaburrinhas	zangaburrinha+N+F+PL
zangaburrinha	zangaburrinha+N+F+SG
zangaburrinhinhos	zangaburrinho+N+DIM+M+PL
zangaburrinhozinhos	zangaburrinho+N+DIM+M+PL
zangaburrinhinho	zangaburrinho+N+DIM+M+SG
zangaburrinhozinho	zangaburrinho+N+DIM+M+SG
zangaburrinhos	zangaburrinho+N+M+PL
zangaburrinho	zangaburrinho+N+M+SG
zangadorazinhas	zangador+N+DIM+F+PL
zangadorinhas	zangador+N+DIM+F+PL
zangadorazinha	zangador+N+DIM+F+SG
zangadorinha	zangador+N+DIM+F+SG
zangadorezinhos	zangador+N+DIM+M+PL
zangadorzinhos	zangador+N+DIM+M+PL
zangadorzinho	zangador+N+DIM+M+SG
zangadoras	zangador+N+F+PL
zangadora	zangador+N+F+SG
zangadores	zangador+N+M+PL
zangador	zangador+N+M+SG
zangalhazinhas	zangalho+N+DIM+F+PL
zangalhinhas	zangalho+N+DIM+F+PL
zangalhazinha	zangalho+N+DIM+F+SG
zangalhinha	zangalho+N+DIM+F+SG
zangalhinhos	zangalho+N+DIM+M+PL
zangalhozinhos	zangalho+N+DIM+M+PL
zangalhinho	zangalho+N+DIM+M+SG
zangalhozinho	zangalho+N+DIM+M+SG
zangalhas	zangalho+N+F+PL
zangalha	zangalho+N+F+SG
zangalhos	zangalho+N+M+PL
zangalho	zangalho+N+M+SG
zangalhonazinhas	zangalhão+N+DIM+F+PL
zangalhoninhas	zangalhão+N+DIM+F+PL
zangalhonazinha	zangalhão+N+DIM+F+SG
zangalhoninha	zangalhão+N+DIM+F+SG
zangalhõezinhos	zangalhão+N+DIM+M+PL
zangalhãozinho	zangalhão+N+DIM+M+SG
zangalhonas	zangalhão+N+F+PL
zangalhona	zangalhão+N+F+SG
zangalhões	zangalhão+N+M+PL
zangalhão	zangalhão+N+M+SG
zangaralhonazinhas	zangaralhão+N+DIM+F+PL
zangaralhoninhas	zangaralhão+N+DIM+F+PL
zangaralhonazinha	zangaralhão+N+DIM+F+SG
zangaralhoninha	zangaralhão+N+DIM+F+SG
zangaralhõezinhos	zangaralhão+N+DIM+M+PL
zangaralhãozinho	zangaralhão+N+DIM+M+SG
zangaralhonas	zangaralhão+N+F+PL
zangaralhona	zangaralhão+N+F+SG
zangaralhões	zangaralhão+N+M+PL
zangaralhão	zangaralhão+N+M+SG
zangarelhazinhas	zangarelha+N+DIM+F+PL
zangarelhinhas	zangarelha+N+DIM+F+PL
zangarelhazinha	zangarelha+N+DIM+F+SG
zangarelhinha	zangarelha+N+DIM+F+SG
zangarelhas	zangarelha+N+F+PL
zangarelha	zangarelha+N+F+SG
zangarelhinhos	zangarelho+N+DIM+M+PL
zangarelhozinhos	zangarelho+N+DIM+M+PL
zangarelhinho	zangarelho+N+DIM+M+SG
zangarelhozinho	zangarelho+N+DIM+M+SG
zangarelhos	zangarelho+N+M+PL
zangarelho	zangarelho+N+M+SG
zangarilheirazinhas	zangarilheira+N+DIM+F+PL
zangarilheirinhas	zangarilheira+N+DIM+F+PL
zangarilheirazinha	zangarilheira+N+DIM+F+SG
zangarilheirinha	zangarilheira+N+DIM+F+SG
zangarilheiras	zangarilheira+N+F+PL
zangarilheira	zangarilheira+N+F+SG
zangarilhazinhas	zangarilho+N+DIM+F+PL
zangarilhinhas	zangarilho+N+DIM+F+PL
zangarilhazinha	zangarilho+N+DIM+F+SG
zangarilhinha	zangarilho+N+DIM+F+SG
zangarilhinhos	zangarilho+N+DIM+M+PL
zangarilhozinhos	zangarilho+N+DIM+M+PL
zangarilhinho	zangarilho+N+DIM+M+SG
zangarilhozinho	zangarilho+N+DIM+M+SG
zangarilhas	zangarilho+N+F+PL
zangarilha	zangarilho+N+F+SG
zangarilhos	zangarilho+N+M+PL
zangarilho	zangarilho+N+M+SG
zangarinheirinhos	zangarinheiro+N+DIM+M+PL
zangarinheirozinhos	zangarinheiro+N+DIM+M+PL
zangarinheirinho	zangarinheiro+N+DIM+M+SG
zangarinheirozinho	zangarinheiro+N+DIM+M+SG
zangarinheiros	zangarinheiro+N+M+PL
zangarinheiro	zangarinheiro+N+M+SG
zangarinhinhos	zangarinho+N+DIM+M+PL
zangarinhozinhos	zangarinho+N+DIM+M+PL
zangarinhinho	zangarinho+N+DIM+M+SG
zangarinhozinho	zangarinho+N+DIM+M+SG
zangarinhos	zangarinho+N+M+PL
zangarinho	zangarinho+N+M+SG
zangarreinhos	zangarreio+N+DIM+M+PL
zangarreiozinhos	zangarreio+N+DIM+M+PL
zangarreinho	zangarreio+N+DIM+M+SG
zangarreiozinho	zangarreio+N+DIM+M+SG
zangarreios	zangarreio+N+M+PL
zangarreio	zangarreio+N+M+SG
zangarrilhõezinhos	zangarrilhão+N+DIM+M+PL
zangarrilhãozinho	zangarrilhão+N+DIM+M+SG
zangarrilhões	zangarrilhão+N+M+PL
zangarrilhão	zangarrilhão+N+M+SG
zangarrõezinhos	zangarrão+N+DIM+M+PL
zangarrãozinho	zangarrão+N+DIM+M+SG
zangarrões	zangarrão+N+M+PL
zangarrão	zangarrão+N+M+SG
zanguizarrazinhas	zanguizarra+N+DIM+F+PL
zanguizarrinhas	zanguizarra+N+DIM+F+PL
zanguizarrazinha	zanguizarra+N+DIM+F+SG
zanguizarrinha	zanguizarra+N+DIM+F+SG
zanguizarras	zanguizarra+N+F+PL
zanguizarra	zanguizarra+N+F+SG
zangurriadazinhas	zangurriada+N+DIM+F+PL
zangurriadinhas	zangurriada+N+DIM+F+PL
zangurriadazinha	zangurriada+N+DIM+F+SG
zangurriadinha	zangurriada+N+DIM+F+SG
zangurriadas	zangurriada+N+F+PL
zangurriada	zangurriada+N+F+SG
zangurrianazinhas	zangurriana+N+DIM+F+PL
zangurrianinhas	zangurriana+N+DIM+F+PL
zangurrianazinha	zangurriana+N+DIM+F+SG
zangurrianinha	zangurriana+N+DIM+F+SG
zangurrianas	zangurriana+N+F+PL
zangurriana	zangurriana+N+F+SG
zangurrinazinhas	zangurrina+N+DIM+F+PL
zangurrininhas	zangurrina+N+DIM+F+PL
zangurrinazinha	zangurrina+N+DIM+F+SG
zangurrininha	zangurrina+N+DIM+F+SG
zangurrinas	zangurrina+N+F+PL
zangurrina	zangurrina+N+F+SG
zangonazinhas	zangão+N+DIM+F+PL
zangoninhas	zangão+N+DIM+F+PL
zangonazinha	zangão+N+DIM+F+SG
zangoninha	zangão+N+DIM+F+SG
zangõezinhos	zangão+N+DIM+M+PL
zangãozinho	zangão+N+DIM+M+SG
zangonas	zangão+N+F+PL
zangona	zangão+N+F+SG
zangões	zangão+N+M+PL
zangão	zangão+N+M+SG
zanizinhos	zanizo+N+DIM+M+PL
zanizozinhos	zanizo+N+DIM+M+PL
zanizinho	zanizo+N+DIM+M+SG
zanizozinho	zanizo+N+DIM+M+SG
zanizos	zanizo+N+M+PL
zanizo	zanizo+N+M+SG
zannizinho	zanni+N+DIM+M+SG
zanni	zanni+N+M+SG
zanociaceazinhas	zanociácea+N+DIM+F+PL
zanociaceinhas	zanociácea+N+DIM+F+PL
zanociaceazinha	zanociácea+N+DIM+F+SG
zanociaceinha	zanociácea+N+DIM+F+SG
zanociáceas	zanociácea+N+F+PL
zanociácea	zanociácea+N+F+SG
zanoiazinhas	zanoio+N+DIM+F+PL
zanoinhas	zanoio+N+DIM+F+PL
zanoiazinha	zanoio+N+DIM+F+SG
zanoinha	zanoio+N+DIM+F+SG
zanoinhos	zanoio+N+DIM+M+PL
zanoiozinhos	zanoio+N+DIM+M+PL
zanoinho	zanoio+N+DIM+M+SG
zanoiozinho	zanoio+N+DIM+M+SG
zanoias	zanoio+N+F+PL
zanoia	zanoio+N+F+SG
zanoios	zanoio+N+M+PL
zanoio	zanoio+N+M+SG
zanolhazinhas	zanolho+N+DIM+F+PL
zanolhinhas	zanolho+N+DIM+F+PL
zanolhazinha	zanolho+N+DIM+F+SG
zanolhinha	zanolho+N+DIM+F+SG
zanolhinhos	zanolho+N+DIM+M+PL
zanolhozinhos	zanolho+N+DIM+M+PL
zanolhinho	zanolho+N+DIM+M+SG
zanolhozinho	zanolho+N+DIM+M+SG
zanolhas	zanolho+N+F+PL
zanolha	zanolho+N+F+SG
zanolhos	zanolho+N+M+PL
zanolho	zanolho+N+M+SG
zantezinhos	zante+N+DIM+M+PL
zantinhos	zante+N+DIM+M+PL
zantezinho	zante+N+DIM+M+SG
zantinho	zante+N+DIM+M+SG
zantes	zante+N+M+PL
zante	zante+N+M+SG
zantoxilaceazinhas	zantoxilácea+N+DIM+F+PL
zantoxilaceinhas	zantoxilácea+N+DIM+F+PL
zantoxilaceazinha	zantoxilácea+N+DIM+F+SG
zantoxilaceinha	zantoxilácea+N+DIM+F+SG
zantoxiláceas	zantoxilácea+N+F+PL
zantoxilácea	zantoxilácea+N+F+SG
zantoxilinhos	zantóxilo+N+DIM+M+PL
zantoxilozinhos	zantóxilo+N+DIM+M+PL
zantoxilinho	zantóxilo+N+DIM+M+SG
zantoxilozinho	zantóxilo+N+DIM+M+SG
zantóxilos	zantóxilo+N+M+PL
zantóxilo	zantóxilo+N+M+SG
zanzazinhas	zanza+N+DIM+F+PL
zanzinhas	zanza+N+DIM+F+PL
zanzazinha	zanza+N+DIM+F+SG
zanzinha	zanza+N+DIM+F+SG
zanzas	zanza+N+F+PL
zanza	zanza+N+F+SG
zanzadorazinhas	zanzador+N+DIM+F+PL
zanzadorinhas	zanzador+N+DIM+F+PL
zanzadorazinha	zanzador+N+DIM+F+SG
zanzadorinha	zanzador+N+DIM+F+SG
zanzadorezinhos	zanzador+N+DIM+M+PL
zanzadorzinhos	zanzador+N+DIM+M+PL
zanzadorzinho	zanzador+N+DIM+M+SG
zanzadoras	zanzador+N+F+PL
zanzadora	zanzador+N+F+SG
zanzadores	zanzador+N+M+PL
zanzador	zanzador+N+M+SG
zanzibarzinhos	zanzibar+N+DIM+M+PL
zanzibarzinho	zanzibar+N+DIM+M+SG
zanzibars	zanzibar+N+M+PL
zanzibar	zanzibar+N+M+SG
zanzibaritazinhas	zanzibarita+N+DIM+F+PL
zanzibaritazinha	zanzibarita+N+DIM+F+SG
zanzibaritazinhos	zanzibarita+N+DIM+M+PL
zanzibaritazinho	zanzibarita+N+DIM+M+SG
zanzibaritinhas	zanzibarita+N+DIM+PL
zanzibaritinha	zanzibarita+N+DIM+SG
zanzibaritas	zanzibarita+N+PL
zanzibarita	zanzibarita+N+SG
zanzininhos	zanzino+N+DIM+M+PL
zanzinozinhos	zanzino+N+DIM+M+PL
zanzininho	zanzino+N+DIM+M+SG
zanzinozinho	zanzino+N+DIM+M+SG
zanzinos	zanzino+N+M+PL
zanzino	zanzino+N+M+SG
zanzinhos	zanzo+N+DIM+M+PL
zanzozinhos	zanzo+N+DIM+M+PL
zanzinho	zanzo+N+DIM+M+SG
zanzozinho	zanzo+N+DIM+M+SG
zanzos	zanzo+N+M+PL
zanzo	zanzo+N+M+SG
zapezinhos	zape+N+DIM+M+PL
zapinhos	zape+N+DIM+M+PL
zapezinho	zape+N+DIM+M+SG
zapinho	zape+N+DIM+M+SG
zapes	zape+N+M+PL
zape	zape+N+M+SG
zapetrapezinhos	zapetrape+N+DIM+M+PL
zapetrapinhos	zapetrape+N+DIM+M+PL
zapetrapezinho	zapetrape+N+DIM+M+SG
zapetrapinho	zapetrape+N+DIM+M+SG
zapetrapes	zapetrape+N+M+PL
zapetrape	zapetrape+N+M+SG
zarabatanazinhas	zarabatana+N+DIM+F+PL
zarabataninhas	zarabatana+N+DIM+F+PL
zarabatanazinha	zarabatana+N+DIM+F+SG
zarabataninha	zarabatana+N+DIM+F+SG
zarabatanas	zarabatana+N+F+PL
zarabatana	zarabatana+N+F+SG
zarabatanadazinhas	zarabatanada+N+DIM+F+PL
zarabatanadinhas	zarabatanada+N+DIM+F+PL
zarabatanadazinha	zarabatanada+N+DIM+F+SG
zarabatanadinha	zarabatanada+N+DIM+F+SG
zarabatanadas	zarabatanada+N+F+PL
zarabatanada	zarabatanada+N+F+SG
zaracoteiazinhas	zaracoteia+N+DIM+F+PL
zaracoteinhas	zaracoteia+N+DIM+F+PL
zaracoteiazinha	zaracoteia+N+DIM+F+SG
zaracoteinha	zaracoteia+N+DIM+F+SG
zaracoteias	zaracoteia+N+F+PL
zaracoteia	zaracoteia+N+F+SG
zaragalhadazinhas	zaragalhada+N+DIM+F+PL
zaragalhadinhas	zaragalhada+N+DIM+F+PL
zaragalhadazinha	zaragalhada+N+DIM+F+SG
zaragalhadinha	zaragalhada+N+DIM+F+SG
zaragalhadas	zaragalhada+N+F+PL
zaragalhada	zaragalhada+N+F+SG
zaragatazinhas	zaragata+N+DIM+F+PL
zaragatinhas	zaragata+N+DIM+F+PL
zaragatazinha	zaragata+N+DIM+F+SG
zaragatinha	zaragata+N+DIM+F+SG
zaragatas	zaragata+N+F+PL
zaragata	zaragata+N+F+SG
zaragateirazinhas	zaragateiro+N+DIM+F+PL
zaragateirinhas	zaragateiro+N+DIM+F+PL
zaragateirazinha	zaragateiro+N+DIM+F+SG
zaragateirinha	zaragateiro+N+DIM+F+SG
zaragateirinhos	zaragateiro+N+DIM+M+PL
zaragateirozinhos	zaragateiro+N+DIM+M+PL
zaragateirinho	zaragateiro+N+DIM+M+SG
zaragateirozinho	zaragateiro+N+DIM+M+SG
zaragateiras	zaragateiro+N+F+PL
zaragateira	zaragateiro+N+F+SG
zaragateiros	zaragateiro+N+M+PL
zaragateiro	zaragateiro+N+M+SG
zaragatoazinhas	zaragatoa+N+DIM+F+PL
zaragatoinhas	zaragatoa+N+DIM+F+PL
zaragatoazinha	zaragatoa+N+DIM+F+SG
zaragatoinha	zaragatoa+N+DIM+F+SG
zaragatoas	zaragatoa+N+F+PL
zaragatoa	zaragatoa+N+F+SG
zaragatoadelazinhas	zaragatoadela+N+DIM+F+PL
zaragatoadelinhas	zaragatoadela+N+DIM+F+PL
zaragatoadelazinha	zaragatoadela+N+DIM+F+SG
zaragatoadelinha	zaragatoadela+N+DIM+F+SG
zaragatoadelas	zaragatoadela+N+F+PL
zaragatoadela	zaragatoadela+N+F+SG
zaralhazinhas	zaralha+N+DIM+F+PL
zaralhinhas	zaralha+N+DIM+F+PL
zaralhazinha	zaralha+N+DIM+F+SG
zaralhinha	zaralha+N+DIM+F+SG
zaralhas	zaralha+N+F+PL
zaralha	zaralha+N+F+SG
zaranzazinhas	zaranza+N+DIM+F+PL
zaranzazinha	zaranza+N+DIM+F+SG
zaranzazinhos	zaranza+N+DIM+M+PL
zaranzazinho	zaranza+N+DIM+M+SG
zaranzinhas	zaranza+N+DIM+PL
zaranzinha	zaranza+N+DIM+SG
zaranzas	zaranza+N+PL
zaranza	zaranza+N+SG
zarapelhinhos	zarapelho+N+DIM+M+PL
zarapelhozinhos	zarapelho+N+DIM+M+PL
zarapelhinho	zarapelho+N+DIM+M+SG
zarapelhozinho	zarapelho+N+DIM+M+SG
zarapelhos	zarapelho+N+M+PL
zarapelho	zarapelho+N+M+SG
zarapilheirazinhas	zarapilheira+N+DIM+F+PL
zarapilheirinhas	zarapilheira+N+DIM+F+PL
zarapilheirazinha	zarapilheira+N+DIM+F+SG
zarapilheirinha	zarapilheira+N+DIM+F+SG
zarapilheiras	zarapilheira+N+F+PL
zarapilheira	zarapilheira+N+F+SG
zarapotecozinhos	zarapoteco+N+DIM+M+PL
zarapotequinhos	zarapoteco+N+DIM+M+PL
zarapotecozinho	zarapoteco+N+DIM+M+SG
zarapotequinho	zarapoteco+N+DIM+M+SG
zarapotecos	zarapoteco+N+M+PL
zarapoteco	zarapoteco+N+M+SG
zarascazinhas	zarasca+N+DIM+F+PL
zarasquinhas	zarasca+N+DIM+F+PL
zarascazinha	zarasca+N+DIM+F+SG
zarasquinha	zarasca+N+DIM+F+SG
zarascas	zarasca+N+F+PL
zarasca	zarasca+N+F+SG
zarcõezinhos	zarcão+N+DIM+M+PL
zarcãozinho	zarcão+N+DIM+M+SG
zarcões	zarcão+N+M+PL
zarcão	zarcão+N+M+SG
zarconinhos	zarcónio+N+DIM+M+PL
zarconiozinhos	zarcónio+N+DIM+M+PL
zarconinho	zarcónio+N+DIM+M+SG
zarconiozinho	zarcónio+N+DIM+M+SG
zarcónios	zarcónio+N+M+PL
zarcónio	zarcónio+N+M+SG
zarconinhos	zarcônio+N+DIM+M+PL
zarconiozinhos	zarcônio+N+DIM+M+PL
zarconinho	zarcônio+N+DIM+M+SG
zarconiozinho	zarcônio+N+DIM+M+SG
zarcônios	zarcônio+N+M+PL
zarcônio	zarcônio+N+M+SG
zarelhazinhas	zarelho+N+DIM+F+PL
zarelhinhas	zarelho+N+DIM+F+PL
zarelhazinha	zarelho+N+DIM+F+SG
zarelhinha	zarelho+N+DIM+F+SG
zarelhinhos	zarelho+N+DIM+M+PL
zarelhozinhos	zarelho+N+DIM+M+PL
zarelhinho	zarelho+N+DIM+M+SG
zarelhozinho	zarelho+N+DIM+M+SG
zarelhas	zarelho+N+F+PL
zarelha	zarelho+N+F+SG
zarelhos	zarelho+N+M+PL
zarelho	zarelho+N+M+SG
zarguelistazinhas	zarguelista+N+DIM+F+PL
zarguelistazinha	zarguelista+N+DIM+F+SG
zarguelistazinhos	zarguelista+N+DIM+M+PL
zarguelistazinho	zarguelista+N+DIM+M+SG
zarguelistinhas	zarguelista+N+DIM+PL
zarguelistinha	zarguelista+N+DIM+SG
zarguelistas	zarguelista+N+PL
zarguelista	zarguelista+N+SG
zargunchadazinhas	zargunchada+N+DIM+F+PL
zargunchadinhas	zargunchada+N+DIM+F+PL
zargunchadazinha	zargunchada+N+DIM+F+SG
zargunchadinha	zargunchada+N+DIM+F+SG
zargunchadas	zargunchada+N+F+PL
zargunchada	zargunchada+N+F+SG
zargunchinhos	zarguncho+N+DIM+M+PL
zargunchozinhos	zarguncho+N+DIM+M+PL
zargunchinho	zarguncho+N+DIM+M+SG
zargunchozinho	zarguncho+N+DIM+M+SG
zargunchos	zarguncho+N+M+PL
zarguncho	zarguncho+N+M+SG
zarolhicezinhas	zarolhice+N+DIM+F+PL
zarolhicinhas	zarolhice+N+DIM+F+PL
zarolhicezinha	zarolhice+N+DIM+F+SG
zarolhicinha	zarolhice+N+DIM+F+SG
zarolhices	zarolhice+N+F+PL
zarolhice	zarolhice+N+F+SG
zarrinhos	zarro+N+DIM+M+PL
zarrozinhos	zarro+N+DIM+M+PL
zarrinho	zarro+N+DIM+M+SG
zarrozinho	zarro+N+DIM+M+SG
zarros	zarro+N+M+PL
zarro	zarro+N+M+SG
zarzagitaniazinhas	zarzagitânia+N+DIM+F+PL
zarzagitaninhas	zarzagitânia+N+DIM+F+PL
zarzagitaniazinha	zarzagitânia+N+DIM+F+SG
zarzagitaninha	zarzagitânia+N+DIM+F+SG
zarzagitânias	zarzagitânia+N+F+PL
zarzagitânia	zarzagitânia+N+F+SG
zarzuelazinhas	zarzuela+N+DIM+F+PL
zarzuelinhas	zarzuela+N+DIM+F+PL
zarzuelazinha	zarzuela+N+DIM+F+SG
zarzuelinha	zarzuela+N+DIM+F+SG
zarzuelas	zarzuela+N+F+PL
zarzuela	zarzuela+N+F+SG
zarõezinhos	zarão+N+DIM+M+PL
zarãozinho	zarão+N+DIM+M+SG
zarões	zarão+N+M+PL
zarão	zarão+N+M+SG
zavrazinhas	zavra+N+DIM+F+PL
zavrinhas	zavra+N+DIM+F+PL
zavrazinha	zavra+N+DIM+F+SG
zavrinha	zavra+N+DIM+F+SG
zavras	zavra+N+F+PL
zavra	zavra+N+F+SG
zazinhos	zazo+N+DIM+M+PL
zazozinhos	zazo+N+DIM+M+PL
zazinho	zazo+N+DIM+M+SG
zazozinho	zazo+N+DIM+M+SG
zazos	zazo+N+M+PL
zazo	zazo+N+M+SG
zebinhos	zebo+N+DIM+M+PL
zebozinhos	zebo+N+DIM+M+PL
zebinho	zebo+N+DIM+M+SG
zebozinho	zebo+N+DIM+M+SG
zebos	zebo+N+M+PL
zebo	zebo+N+M+SG
zebrazinhas	zebra+N+DIM+F+PL
zebrazinha	zebra+N+DIM+F+SG
zebrazinhos	zebra+N+DIM+M+PL
zebrazinho	zebra+N+DIM+M+SG
zebrinhas	zebra+N+DIM+PL
zebrinha	zebra+N+DIM+SG
zebras	zebra+N+PL
zebra	zebra+N+SG
zebrainhinhos	zebrainho+N+DIM+M+PL
zebrainhozinhos	zebrainho+N+DIM+M+PL
zebrainhinho	zebrainho+N+DIM+M+SG
zebrainhozinho	zebrainho+N+DIM+M+SG
zebrainhos	zebrainho+N+M+PL
zebrainho	zebrainho+N+M+SG
zebralidadezinhas	zebralidade+N+DIM+F+PL
zebralidadinhas	zebralidade+N+DIM+F+PL
zebralidadezinha	zebralidade+N+DIM+F+SG
zebralidadinha	zebralidade+N+DIM+F+SG
zebralidades	zebralidade+N+F+PL
zebralidade	zebralidade+N+F+SG
zebrinhos	zebro+N+DIM+M+PL
zebrozinhos	zebro+N+DIM+M+PL
zebrinho	zebro+N+DIM+M+SG
zebrozinho	zebro+N+DIM+M+SG
zebros	zebro+N+M+PL
zebro	zebro+N+M+SG
zebroidezinhos	zebroide+N+DIM+M+PL
zebroidinhos	zebroide+N+DIM+M+PL
zebroidezinho	zebroide+N+DIM+M+SG
zebroidinho	zebroide+N+DIM+M+SG
zebroides	zebroide+N+M+PL
zebroide	zebroide+N+M+SG
zebuzinhas	zebu+N+DIM+F+PL
zebuzinha	zebu+N+DIM+F+SG
zebuzinhos	zebu+N+DIM+M+PL
zebuzinho	zebu+N+DIM+M+SG
zebus	zebu+N+PL
zebu	zebu+N+SG
zebueirinhos	zebueiro+N+DIM+M+PL
zebueirozinhos	zebueiro+N+DIM+M+PL
zebueirinho	zebueiro+N+DIM+M+SG
zebueirozinho	zebueiro+N+DIM+M+SG
zebueiros	zebueiro+N+M+PL
zebueiro	zebueiro+N+M+SG
zebuzeirinhos	zebuzeiro+N+DIM+M+PL
zebuzeirozinhos	zebuzeiro+N+DIM+M+PL
zebuzeirinho	zebuzeiro+N+DIM+M+SG
zebuzeirozinho	zebuzeiro+N+DIM+M+SG
zebuzeiros	zebuzeiro+N+M+PL
zebuzeiro	zebuzeiro+N+M+SG
zedoariazinhas	zedoária+N+DIM+F+PL
zedoarinhas	zedoária+N+DIM+F+PL
zedoariazinha	zedoária+N+DIM+F+SG
zedoarinha	zedoária+N+DIM+F+SG
zedoárias	zedoária+N+F+PL
zedoária	zedoária+N+F+SG
zefirezinhos	zefir+N+DIM+M+PL
zefirzinhos	zefir+N+DIM+M+PL
zefirzinho	zefir+N+DIM+M+SG
zefires	zefir+N+M+PL
zefir	zefir+N+M+SG
zefirezinhos	zefire+N+DIM+M+PL
zefirinhos	zefire+N+DIM+M+PL
zefirzinhos	zefire+N+DIM+M+PL
zefirezinho	zefire+N+DIM+M+SG
zefirinho	zefire+N+DIM+M+SG
zefires	zefire+N+M+PL
zefire	zefire+N+M+SG
zegrezinhos	zegre+N+DIM+M+PL
zegrinhos	zegre+N+DIM+M+PL
zegrezinho	zegre+N+DIM+M+SG
zegrinho	zegre+N+DIM+M+SG
zegres	zegre+N+M+PL
zegre	zegre+N+M+SG
zeidazinhos	zeida+N+DIM+M+PL
zeidinhas	zeida+N+DIM+M+PL
zeidazinho	zeida+N+DIM+M+SG
zeidinha	zeida+N+DIM+M+SG
zeidas	zeida+N+M+PL
zeida	zeida+N+M+SG
zeimãzinhas	zeimão+N+DIM+F+PL
zeimãzinha	zeimão+N+DIM+F+SG
zeimãozinhos	zeimão+N+DIM+M+PL
zeimãozinho	zeimão+N+DIM+M+SG
zeimãs	zeimão+N+F+PL
zeimã	zeimão+N+F+SG
zeimãos	zeimão+N+M+PL
zeimão	zeimão+N+M+SG
zelabilidadezinhas	zelabilidade+N+DIM+F+PL
zelabilidadinhas	zelabilidade+N+DIM+F+PL
zelabilidadezinha	zelabilidade+N+DIM+F+SG
zelabilidadinha	zelabilidade+N+DIM+F+SG
zelabilidades	zelabilidade+N+F+PL
zelabilidade	zelabilidade+N+F+SG
zeladorazinhas	zelador+N+DIM+F+PL
zeladorinhas	zelador+N+DIM+F+PL
zeladorazinha	zelador+N+DIM+F+SG
zeladorinha	zelador+N+DIM+F+SG
zeladorezinhos	zelador+N+DIM+M+PL
zeladorzinhos	zelador+N+DIM+M+PL
zeladorzinho	zelador+N+DIM+M+SG
zeladoras	zelador+N+F+PL
zeladora	zelador+N+F+SG
zeladores	zelador+N+M+PL
zelador	zelador+N+M+SG
zeladora-de-inquicinhas	zelador-de-inquice+N+DIM+F+PL
zeladoras-de-inquicezinhas	zelador-de-inquice+N+DIM+F+PL
zeladora-de-inquicezinha	zelador-de-inquice+N+DIM+F+SG
zeladora-de-inquicinha	zelador-de-inquice+N+DIM+F+SG
zelador-de-inquicinhos	zelador-de-inquice+N+DIM+M+PL
zeladores-de-inquicezinhos	zelador-de-inquice+N+DIM+M+PL
zelador-de-inquicezinho	zelador-de-inquice+N+DIM+M+SG
zelador-de-inquicinho	zelador-de-inquice+N+DIM+M+SG
zeladoras-de-inquice	zelador-de-inquice+N+F+PL
zeladora-de-inquice	zelador-de-inquice+N+F+SG
zeladores-de-inquice	zelador-de-inquice+N+M+PL
zelador-de-inquice	zelador-de-inquice+N+M+SG
zeladora-de-santinhos	zelador-de-santo+N+DIM+F+PL
zeladoras-de-santozinhas	zelador-de-santo+N+DIM+F+PL
zeladora-de-santinho	zelador-de-santo+N+DIM+F+SG
zeladora-de-santozinha	zelador-de-santo+N+DIM+F+SG
zelador-de-santinhos	zelador-de-santo+N+DIM+M+PL
zeladores-de-santozinhos	zelador-de-santo+N+DIM+M+PL
zelador-de-santinho	zelador-de-santo+N+DIM+M+SG
zelador-de-santozinho	zelador-de-santo+N+DIM+M+SG
zeladoras-de-santos	zelador-de-santo+N+F+PL
zeladora-de-santo	zelador-de-santo+N+F+SG
zeladores-de-santos	zelador-de-santo+N+M+PL
zelador-de-santo	zelador-de-santo+N+M+SG
zeladoriazinhas	zeladoria+N+DIM+F+PL
zeladorinhas	zeladoria+N+DIM+F+PL
zeladoriazinha	zeladoria+N+DIM+F+SG
zeladorinha	zeladoria+N+DIM+F+SG
zeladorias	zeladoria+N+F+PL
zeladoria	zeladoria+N+F+SG
zelandesazinhas	zelandês+N+DIM+F+PL
zelandesinhas	zelandês+N+DIM+F+PL
zelandesazinha	zelandês+N+DIM+F+SG
zelandesinha	zelandês+N+DIM+F+SG
zelandesezinhos	zelandês+N+DIM+M+PL
zelandesinhos	zelandês+N+DIM+M+PL
zelandesinho	zelandês+N+DIM+M+SG
zelandesas	zelandês+N+F+PL
zelandesa	zelandês+N+F+SG
zelandeses	zelandês+N+M+PL
zelandês	zelandês+N+M+SG
zelaçõezinhas	zelação+N+DIM+F+PL
zelaçãozinha	zelação+N+DIM+F+SG
zelações	zelação+N+F+PL
zelação	zelação+N+F+SG
zelhazinhas	zelha+N+DIM+F+PL
zelhinhas	zelha+N+DIM+F+PL
zelhazinha	zelha+N+DIM+F+SG
zelhinha	zelha+N+DIM+F+SG
zelhas	zelha+N+F+PL
zelha	zelha+N+F+SG
zelinhos	zelo+N+DIM+M+PL
zelozinhos	zelo+N+DIM+M+PL
zelinho	zelo+N+DIM+M+SG
zelozinho	zelo+N+DIM+M+SG
zelos	zelo+N+M+PL
zelo	zelo+N+M+SG
zelosiazinhas	zelosia+N+DIM+F+PL
zelosinhas	zelosia+N+DIM+F+PL
zelosiazinha	zelosia+N+DIM+F+SG
zelosinha	zelosia+N+DIM+F+SG
zelosias	zelosia+N+F+PL
zelosia	zelosia+N+F+SG
zelosidadezinhas	zelosidade+N+DIM+F+PL
zelosidadinhas	zelosidade+N+DIM+F+PL
zelosidadezinha	zelosidade+N+DIM+F+SG
zelosidadinha	zelosidade+N+DIM+F+SG
zelosidades	zelosidade+N+F+PL
zelosidade	zelosidade+N+F+SG
zelotazinhas	zelota+N+DIM+F+PL
zelotazinha	zelota+N+DIM+F+SG
zelotazinhos	zelota+N+DIM+M+PL
zelotazinho	zelota+N+DIM+M+SG
zelotinhas	zelota+N+DIM+PL
zelotinha	zelota+N+DIM+SG
zelotas	zelota+N+PL
zelota	zelota+N+SG
zelotezinhas	zelote+N+DIM+F+PL
zelotinhas	zelote+N+DIM+F+PL
zelotezinha	zelote+N+DIM+F+SG
zelotinha	zelote+N+DIM+F+SG
zelotezinhos	zelote+N+DIM+M+PL
zelotinhos	zelote+N+DIM+M+PL
zelotezinho	zelote+N+DIM+M+SG
zelotinho	zelote+N+DIM+M+SG
zelotes	zelote+N+PL
zelote	zelote+N+SG
zelotipiazinhas	zelotipia+N+DIM+F+PL
zelotipinhas	zelotipia+N+DIM+F+PL
zelotipiazinha	zelotipia+N+DIM+F+SG
zelotipinha	zelotipia+N+DIM+F+SG
zelotipias	zelotipia+N+F+PL
zelotipia	zelotipia+N+F+SG
zemiobiosezinhas	zemiobiose+N+DIM+F+PL
zemiobiosinhas	zemiobiose+N+DIM+F+PL
zemiobiosezinha	zemiobiose+N+DIM+F+SG
zemiobiosinha	zemiobiose+N+DIM+F+SG
zemiobioses	zemiobiose+N+F+PL
zemiobiose	zemiobiose+N+F+SG
zemiodemiazinhas	zemiodemia+N+DIM+F+PL
zemiodeminhas	zemiodemia+N+DIM+F+PL
zemiodemiazinha	zemiodemia+N+DIM+F+SG
zemiodeminha	zemiodemia+N+DIM+F+SG
zemiodemias	zemiodemia+N+F+PL
zemiodemia	zemiodemia+N+F+SG
zen-budisminhos	zen-budismo+N+DIM+M+PL
zen-budismozinhos	zen-budismo+N+DIM+M+PL
zen-budisminho	zen-budismo+N+DIM+M+SG
zen-budismozinho	zen-budismo+N+DIM+M+SG
zen-budismos	zen-budismo+N+M+PL
zen-budismo	zen-budismo+N+M+SG
zendazinhas	zenda+N+DIM+F+PL
zendazinha	zenda+N+DIM+F+SG
zendazinhos	zenda+N+DIM+M+PL
zendazinho	zenda+N+DIM+M+SG
zendinhas	zenda+N+DIM+PL
zendinha	zenda+N+DIM+SG
zendas	zenda+N+PL
zenda	zenda+N+SG
zendezinhos	zende+N+DIM+M+PL
zendinhos	zende+N+DIM+M+PL
zendezinho	zende+N+DIM+M+SG
zendinho	zende+N+DIM+M+SG
zendes	zende+N+M+PL
zende	zende+N+M+SG
zendicisminhos	zendicismo+N+DIM+M+PL
zendicismozinhos	zendicismo+N+DIM+M+PL
zendicisminho	zendicismo+N+DIM+M+SG
zendicismozinho	zendicismo+N+DIM+M+SG
zendicismos	zendicismo+N+M+PL
zendicismo	zendicismo+N+M+SG
zendicistazinhas	zendicista+N+DIM+F+PL
zendicistazinha	zendicista+N+DIM+F+SG
zendicistazinhos	zendicista+N+DIM+M+PL
zendicistazinho	zendicista+N+DIM+M+SG
zendicistinhas	zendicista+N+DIM+PL
zendicistinha	zendicista+N+DIM+SG
zendicistas	zendicista+N+PL
zendicista	zendicista+N+SG
zenitalidadezinhas	zenitalidade+N+DIM+F+PL
zenitalidadinhas	zenitalidade+N+DIM+F+PL
zenitalidadezinha	zenitalidade+N+DIM+F+SG
zenitalidadinha	zenitalidade+N+DIM+F+SG
zenitalidades	zenitalidade+N+F+PL
zenitalidade	zenitalidade+N+F+SG
zenonicidadezinhas	zenonicidade+N+DIM+F+PL
zenonicidadinhas	zenonicidade+N+DIM+F+PL
zenonicidadezinha	zenonicidade+N+DIM+F+SG
zenonicidadinha	zenonicidade+N+DIM+F+SG
zenonicidades	zenonicidade+N+F+PL
zenonicidade	zenonicidade+N+F+SG
zenonisminhos	zenonismo+N+DIM+M+PL
zenonismozinhos	zenonismo+N+DIM+M+PL
zenonisminho	zenonismo+N+DIM+M+SG
zenonismozinho	zenonismo+N+DIM+M+SG
zenonismos	zenonismo+N+M+PL
zenonismo	zenonismo+N+M+SG
zenonistazinhas	zenonista+N+DIM+F+PL
zenonistazinha	zenonista+N+DIM+F+SG
zenonistazinhos	zenonista+N+DIM+M+PL
zenonistazinho	zenonista+N+DIM+M+SG
zenonistinhas	zenonista+N+DIM+PL
zenonistinha	zenonista+N+DIM+SG
zenonistas	zenonista+N+PL
zenonista	zenonista+N+SG
zenzemzinhos	zenzém+N+DIM+M+PL
zenzenzinho	zenzém+N+DIM+M+SG
zenzéms	zenzém+N+M+PL
zenzém	zenzém+N+M+SG
zeoliticidadezinhas	zeoliticidade+N+DIM+F+PL
zeoliticidadinhas	zeoliticidade+N+DIM+F+PL
zeoliticidadezinha	zeoliticidade+N+DIM+F+SG
zeoliticidadinha	zeoliticidade+N+DIM+F+SG
zeoliticidades	zeoliticidade+N+F+PL
zeoliticidade	zeoliticidade+N+F+SG
zepelinzinhos	zepelim+N+DIM+M+PL
zepelinzinho	zepelim+N+DIM+M+SG
zepelins	zepelim+N+M+PL
zepelim	zepelim+N+M+SG
zeragenzinhas	zeragem+N+DIM+F+PL
zeragenzinha	zeragem+N+DIM+F+SG
zeragens	zeragem+N+F+PL
zeragem	zeragem+N+F+SG
zerbinhos	zerbo+N+DIM+M+PL
zerbozinhos	zerbo+N+DIM+M+PL
zerbinho	zerbo+N+DIM+M+SG
zerbozinho	zerbo+N+DIM+M+SG
zerbos	zerbo+N+M+PL
zerbo	zerbo+N+M+SG
zeribandazinhas	zeribanda+N+DIM+F+PL
zeribandinhas	zeribanda+N+DIM+F+PL
zeribandazinha	zeribanda+N+DIM+F+SG
zeribandinha	zeribanda+N+DIM+F+SG
zeribandas	zeribanda+N+F+PL
zeribanda	zeribanda+N+F+SG
zerichiazinhas	zerichia+N+DIM+F+PL
zerichinhas	zerichia+N+DIM+F+PL
zerichiazinha	zerichia+N+DIM+F+SG
zerichinha	zerichia+N+DIM+F+SG
zerichias	zerichia+N+F+PL
zerichia	zerichia+N+F+SG
zerozinha	zero+N+DIM+F+SG
zerozinhos	zero+N+DIM+M+PL
zerozinho	zero+N+DIM+M+SG
zerinhos	zero+N+DIM+PL
zerinho	zero+N+DIM+SG
zeros	zero+N+M+PL
zero	zero+N+SG
zerumbazinhas	zerumba+N+DIM+F+PL
zerumbinhas	zerumba+N+DIM+F+PL
zerumbazinha	zerumba+N+DIM+F+SG
zerumbinha	zerumba+N+DIM+F+SG
zerumbas	zerumba+N+F+PL
zerumba	zerumba+N+F+SG
zerumbetezinhos	zerumbete+N+DIM+M+PL
zerumbetinhos	zerumbete+N+DIM+M+PL
zerumbetezinho	zerumbete+N+DIM+M+SG
zerumbetinho	zerumbete+N+DIM+M+SG
zerumbetes	zerumbete+N+M+PL
zerumbete	zerumbete+N+M+SG
zestinhos	zesto+N+DIM+M+PL
zestozinhos	zesto+N+DIM+M+PL
zestinho	zesto+N+DIM+M+SG
zestozinho	zesto+N+DIM+M+SG
zestos	zesto+N+M+PL
zesto	zesto+N+M+SG
zetazinhos	zeta+N+DIM+M+PL
zetinhas	zeta+N+DIM+M+PL
zetazinho	zeta+N+DIM+M+SG
zetinha	zeta+N+DIM+M+SG
zetas	zeta+N+M+PL
zeta	zeta+N+M+SG
zetacisminhos	zetacismo+N+DIM+M+PL
zetacismozinhos	zetacismo+N+DIM+M+PL
zetacisminho	zetacismo+N+DIM+M+SG
zetacismozinho	zetacismo+N+DIM+M+SG
zetacismos	zetacismo+N+M+PL
zetacismo	zetacismo+N+M+SG
zeteticidadezinhas	zeteticidade+N+DIM+F+PL
zeteticidadinhas	zeteticidade+N+DIM+F+PL
zeteticidadezinha	zeteticidade+N+DIM+F+SG
zeteticidadinha	zeteticidade+N+DIM+F+SG
zeteticidades	zeteticidade+N+F+PL
zeteticidade	zeteticidade+N+F+SG
zeteticazinhas	zetética+N+DIM+F+PL
zetetiquinhas	zetética+N+DIM+F+PL
zeteticazinha	zetética+N+DIM+F+SG
zetetiquinha	zetética+N+DIM+F+SG
zetéticas	zetética+N+F+PL
zetética	zetética+N+F+SG
zeugitazinhas	zeugita+N+DIM+F+PL
zeugitazinha	zeugita+N+DIM+F+SG
zeugitazinhos	zeugita+N+DIM+M+PL
zeugitazinho	zeugita+N+DIM+M+SG
zeugitinhas	zeugita+N+DIM+PL
zeugitinha	zeugita+N+DIM+SG
zeugitas	zeugita+N+PL
zeugita	zeugita+N+SG
zeugmazinhas	zeugma+N+DIM+F+PL
zeugminhas	zeugma+N+DIM+F+PL
zeugmazinha	zeugma+N+DIM+F+SG
zeugminha	zeugma+N+DIM+F+SG
zeugmas	zeugma+N+F+PL
zeugma	zeugma+N+F+SG
zeugmaticidadezinhas	zeugmaticidade+N+DIM+F+PL
zeugmaticidadinhas	zeugmaticidade+N+DIM+F+PL
zeugmaticidadezinha	zeugmaticidade+N+DIM+F+SG
zeugmaticidadinha	zeugmaticidade+N+DIM+F+SG
zeugmaticidades	zeugmaticidade+N+F+PL
zeugmaticidade	zeugmaticidade+N+F+SG
zeugozinhos	zeugo+N+DIM+M+PL
zeuguinhos	zeugo+N+DIM+M+PL
zeugozinho	zeugo+N+DIM+M+SG
zeuguinho	zeugo+N+DIM+M+SG
zeugos	zeugo+N+M+PL
zeugo	zeugo+N+M+SG
zeideinhos	zeídeo+N+DIM+M+PL
zeideozinhos	zeídeo+N+DIM+M+PL
zeideinho	zeídeo+N+DIM+M+SG
zeideozinho	zeídeo+N+DIM+M+SG
zeídeos	zeídeo+N+M+PL
zeídeo	zeídeo+N+M+SG
zeisminhos	zeísmo+N+DIM+M+PL
zeismozinhos	zeísmo+N+DIM+M+PL
zeisminho	zeísmo+N+DIM+M+SG
zeismozinho	zeísmo+N+DIM+M+SG
zeísmos	zeísmo+N+M+PL
zeísmo	zeísmo+N+M+SG
zeolitinhos	zeólito+N+DIM+M+PL
zeolitozinhos	zeólito+N+DIM+M+PL
zeolitinho	zeólito+N+DIM+M+SG
zeolitozinho	zeólito+N+DIM+M+SG
zeólitos	zeólito+N+M+PL
zeólito	zeólito+N+M+SG
zibelinazinhas	zibelina+N+DIM+F+PL
zibelininhas	zibelina+N+DIM+F+PL
zibelinazinha	zibelina+N+DIM+F+SG
zibelininha	zibelina+N+DIM+F+SG
zibelinas	zibelina+N+F+PL
zibelina	zibelina+N+F+SG
zibetazinhas	zibeta+N+DIM+F+PL
zibetinhas	zibeta+N+DIM+F+PL
zibetazinha	zibeta+N+DIM+F+SG
zibetinha	zibeta+N+DIM+F+SG
zibetas	zibeta+N+F+PL
zibeta	zibeta+N+F+SG
zichinhos	zicho+N+DIM+M+PL
zichozinhos	zicho+N+DIM+M+PL
zichinho	zicho+N+DIM+M+SG
zichozinho	zicho+N+DIM+M+SG
zichos	zicho+N+M+PL
zicho	zicho+N+M+SG
zidovudinazinhas	zidovudina+N+DIM+F+PL
zidovudininhas	zidovudina+N+DIM+F+PL
zidovudinazinha	zidovudina+N+DIM+F+SG
zidovudininha	zidovudina+N+DIM+F+SG
zidovudinas	zidovudina+N+F+PL
zidovudina	zidovudina+N+F+SG
zignemeazinhas	zignémea+N+DIM+F+PL
zignemeinhas	zignémea+N+DIM+F+PL
zignemeazinha	zignémea+N+DIM+F+SG
zignemeinha	zignémea+N+DIM+F+SG
zignémeas	zignémea+N+F+PL
zignémea	zignémea+N+F+SG
zignemeazinhas	zignêmea+N+DIM+F+PL
zignemeinhas	zignêmea+N+DIM+F+PL
zignemeazinha	zignêmea+N+DIM+F+SG
zignemeinha	zignêmea+N+DIM+F+SG
zignêmeas	zignêmea+N+F+PL
zignêmea	zignêmea+N+F+SG
zigoblastinhos	zigoblasto+N+DIM+M+PL
zigoblastozinhos	zigoblasto+N+DIM+M+PL
zigoblastinho	zigoblasto+N+DIM+M+SG
zigoblastozinho	zigoblasto+N+DIM+M+SG
zigoblastos	zigoblasto+N+M+PL
zigoblasto	zigoblasto+N+M+SG
zigobranquinhos	zigobrânquio+N+DIM+M+PL
zigobranquiozinhos	zigobrânquio+N+DIM+M+PL
zigobranquinho	zigobrânquio+N+DIM+M+SG
zigobranquiozinho	zigobrânquio+N+DIM+M+SG
zigobrânquios	zigobrânquio+N+M+PL
zigobrânquio	zigobrânquio+N+M+SG
zigodatilinhos	zigodátilo+N+DIM+M+PL
zigodatilozinhos	zigodátilo+N+DIM+M+PL
zigodatilinho	zigodátilo+N+DIM+M+SG
zigodatilozinho	zigodátilo+N+DIM+M+SG
zigodátilos	zigodátilo+N+M+PL
zigodátilo	zigodátilo+N+M+SG
zigofilinhos	zigofilo+N+DIM+M+PL
zigofilozinhos	zigofilo+N+DIM+M+PL
zigofilinho	zigofilo+N+DIM+M+SG
zigofilozinho	zigofilo+N+DIM+M+SG
zigofilos	zigofilo+N+M+PL
zigofilo	zigofilo+N+M+SG
zigofilaceazinhas	zigofilácea+N+DIM+F+PL
zigofilaceinhas	zigofilácea+N+DIM+F+PL
zigofilaceazinha	zigofilácea+N+DIM+F+SG
zigofilaceinha	zigofilácea+N+DIM+F+SG
zigofiláceas	zigofilácea+N+F+PL
zigofilácea	zigofilácea+N+F+SG
zigofileazinhas	zigofílea+N+DIM+F+PL
zigofileinhas	zigofílea+N+DIM+F+PL
zigofileazinha	zigofílea+N+DIM+F+SG
zigofileinha	zigofílea+N+DIM+F+SG
zigofíleas	zigofílea+N+F+PL
zigofílea	zigofílea+N+F+SG
zigogametazinhos	zigogâmeta+N+DIM+M+PL
zigogametinhas	zigogâmeta+N+DIM+M+PL
zigogametazinho	zigogâmeta+N+DIM+M+SG
zigogametinha	zigogâmeta+N+DIM+M+SG
zigogâmetas	zigogâmeta+N+M+PL
zigogâmeta	zigogâmeta+N+M+SG
zigomazinhos	zigoma+N+DIM+M+PL
zigominhas	zigoma+N+DIM+M+PL
zigomazinho	zigoma+N+DIM+M+SG
zigominha	zigoma+N+DIM+M+SG
zigomas	zigoma+N+M+PL
zigoma	zigoma+N+M+SG
zigomatauricularidadezinhas	zigomatauricularidade+N+DIM+F+PL
zigomatauricularidadinhas	zigomatauricularidade+N+DIM+F+PL
zigomatauricularidadezinha	zigomatauricularidade+N+DIM+F+SG
zigomatauricularidadinha	zigomatauricularidade+N+DIM+F+SG
zigomatauricularidades	zigomatauricularidade+N+F+PL
zigomatauricularidade	zigomatauricularidade+N+F+SG
zigomaticidadezinhas	zigomaticidade+N+DIM+F+PL
zigomaticidadinhas	zigomaticidade+N+DIM+F+PL
zigomaticidadezinha	zigomaticidade+N+DIM+F+SG
zigomaticidadinha	zigomaticidade+N+DIM+F+SG
zigomaticidades	zigomaticidade+N+F+PL
zigomaticidade	zigomaticidade+N+F+SG
zigomatolabialidadezinhas	zigomatolabialidade+N+DIM+F+PL
zigomatolabialidadinhas	zigomatolabialidade+N+DIM+F+PL
zigomatolabialidadezinha	zigomatolabialidade+N+DIM+F+SG
zigomatolabialidadinha	zigomatolabialidade+N+DIM+F+SG
zigomatolabialidades	zigomatolabialidade+N+F+PL
zigomatolabialidade	zigomatolabialidade+N+F+SG
zigomatomaxilaridadezinhas	zigomatomaxilaridade+N+DIM+F+PL
zigomatomaxilaridadinhas	zigomatomaxilaridade+N+DIM+F+PL
zigomatomaxilaridadezinha	zigomatomaxilaridade+N+DIM+F+SG
zigomatomaxilaridadinha	zigomatomaxilaridade+N+DIM+F+SG
zigomatomaxilaridades	zigomatomaxilaridade+N+F+PL
zigomatomaxilaridade	zigomatomaxilaridade+N+F+SG
zigomicetalezinhos	zigomicetale+N+DIM+M+PL
zigomicetalinhos	zigomicetale+N+DIM+M+PL
zigomicetalezinho	zigomicetale+N+DIM+M+SG
zigomicetalinho	zigomicetale+N+DIM+M+SG
zigomicetales	zigomicetale+N+M+PL
zigomicetale	zigomicetale+N+M+SG
zigomicetezinhos	zigomicete+N+DIM+M+PL
zigomicetinhos	zigomicete+N+DIM+M+PL
zigomicetezinho	zigomicete+N+DIM+M+SG
zigomicetinho	zigomicete+N+DIM+M+SG
zigomicetes	zigomicete+N+M+PL
zigomicete	zigomicete+N+M+SG
zigonemazinhos	zigonema+N+DIM+M+PL
zigoneminhas	zigonema+N+DIM+M+PL
zigonemazinho	zigonema+N+DIM+M+SG
zigoneminha	zigonema+N+DIM+M+SG
zigonemas	zigonema+N+M+PL
zigonema	zigonema+N+M+SG
zigosezinhas	zigose+N+DIM+F+PL
zigosinhas	zigose+N+DIM+F+PL
zigosezinha	zigose+N+DIM+F+SG
zigosinha	zigose+N+DIM+F+SG
zigoses	zigose+N+F+PL
zigose	zigose+N+F+SG
zigosporinhos	zigospório+N+DIM+M+PL
zigosporiozinhos	zigospório+N+DIM+M+PL
zigosporinho	zigospório+N+DIM+M+SG
zigosporiozinho	zigospório+N+DIM+M+SG
zigospórios	zigospório+N+M+PL
zigospório	zigospório+N+M+SG
zigotacticidadezinhas	zigotacticidade+N+DIM+F+PL
zigotacticidadinhas	zigotacticidade+N+DIM+F+PL
zigotacticidadezinha	zigotacticidade+N+DIM+F+SG
zigotacticidadinha	zigotacticidade+N+DIM+F+SG
zigotacticidades	zigotacticidade+N+F+PL
zigotacticidade	zigotacticidade+N+F+SG
zigotactisminhos	zigotactismo+N+DIM+M+PL
zigotactismozinhos	zigotactismo+N+DIM+M+PL
zigotactisminho	zigotactismo+N+DIM+M+SG
zigotactismozinho	zigotactismo+N+DIM+M+SG
zigotactismos	zigotactismo+N+M+PL
zigotactismo	zigotactismo+N+M+SG
zigotaticidadezinhas	zigotaticidade+N+DIM+F+PL
zigotaticidadinhas	zigotaticidade+N+DIM+F+PL
zigotaticidadezinha	zigotaticidade+N+DIM+F+SG
zigotaticidadinha	zigotaticidade+N+DIM+F+SG
zigotaticidades	zigotaticidade+N+F+PL
zigotaticidade	zigotaticidade+N+F+SG
zigotatisminhos	zigotatismo+N+DIM+M+PL
zigotatismozinhos	zigotatismo+N+DIM+M+PL
zigotatisminho	zigotatismo+N+DIM+M+SG
zigotatismozinho	zigotatismo+N+DIM+M+SG
zigotatismos	zigotatismo+N+M+PL
zigotatismo	zigotatismo+N+M+SG
zigotinhos	zigoto+N+DIM+M+PL
zigotozinhos	zigoto+N+DIM+M+PL
zigotinho	zigoto+N+DIM+M+SG
zigotozinho	zigoto+N+DIM+M+SG
zigotos	zigoto+N+M+PL
zigoto	zigoto+N+M+SG
zigotomerinhos	zigotómero+N+DIM+M+PL
zigotomerozinhos	zigotómero+N+DIM+M+PL
zigotomerinho	zigotómero+N+DIM+M+SG
zigotomerozinho	zigotómero+N+DIM+M+SG
zigotómeros	zigotómero+N+M+PL
zigotómero	zigotómero+N+M+SG
zigue-zaguezinhos	zigue-zague+N+DIM+M+PL
zigue-zaguinhos	zigue-zague+N+DIM+M+PL
zigue-zaguezinho	zigue-zague+N+DIM+M+SG
zigue-zaguinho	zigue-zague+N+DIM+M+SG
zigue-zagues	zigue-zague+N+M+PL
zigue-zague	zigue-zague+N+M+SG
ziguezaguezinhos	ziguezague+N+DIM+M+PL
ziguezaguinhos	ziguezague+N+DIM+M+PL
ziguezaguezinho	ziguezague+N+DIM+M+SG
ziguezaguinho	ziguezague+N+DIM+M+SG
ziguezagues	ziguezague+N+M+PL
ziguezague	ziguezague+N+M+SG
zigueziguezinhas	ziguezigue+N+DIM+F+PL
zigueziguinhas	ziguezigue+N+DIM+F+PL
zigueziguezinha	ziguezigue+N+DIM+F+SG
zigueziguinha	ziguezigue+N+DIM+F+SG
zigueziguezinhos	ziguezigue+N+DIM+M+PL
zigueziguinhos	ziguezigue+N+DIM+M+PL
zigueziguezinho	ziguezigue+N+DIM+M+SG
zigueziguinho	ziguezigue+N+DIM+M+SG
ziguezigues	ziguezigue+N+PL
ziguezigue	ziguezigue+N+SG
ziguratezinhos	zigurate+N+DIM+M+PL
ziguratinhos	zigurate+N+DIM+M+PL
ziguratezinho	zigurate+N+DIM+M+SG
ziguratinho	zigurate+N+DIM+M+SG
zigurates	zigurate+N+M+PL
zigurate	zigurate+N+M+SG
zigofasezinhas	zigófase+N+DIM+F+PL
zigofasinhas	zigófase+N+DIM+F+PL
zigofasezinha	zigófase+N+DIM+F+SG
zigofasinha	zigófase+N+DIM+F+SG
zigófases	zigófase+N+F+PL
zigófase	zigófase+N+F+SG
zigofitinhos	zigófito+N+DIM+M+PL
zigofitozinhos	zigófito+N+DIM+M+PL
zigofitinho	zigófito+N+DIM+M+SG
zigofitozinho	zigófito+N+DIM+M+SG
zigófitos	zigófito+N+M+PL
zigófito	zigófito+N+M+SG
zigosporinhos	zigósporo+N+DIM+M+PL
zigosporozinhos	zigósporo+N+DIM+M+PL
zigosporinho	zigósporo+N+DIM+M+SG
zigosporozinho	zigósporo+N+DIM+M+SG
zigósporos	zigósporo+N+M+PL
zigósporo	zigósporo+N+M+SG
zigostatazinhos	zigóstata+N+DIM+M+PL
zigostatinhas	zigóstata+N+DIM+M+PL
zigostatazinho	zigóstata+N+DIM+M+SG
zigostatinha	zigóstata+N+DIM+M+SG
zigóstatas	zigóstata+N+M+PL
zigóstata	zigóstata+N+M+SG
zigoteninhos	zigóteno+N+DIM+M+PL
zigotenozinhos	zigóteno+N+DIM+M+PL
zigoteninho	zigóteno+N+DIM+M+SG
zigotenozinho	zigóteno+N+DIM+M+SG
zigótenos	zigóteno+N+M+PL
zigóteno	zigóteno+N+M+SG
zilrinhos	zilro+N+DIM+M+PL
zilrozinhos	zilro+N+DIM+M+PL
zilrinho	zilro+N+DIM+M+SG
zilrozinho	zilro+N+DIM+M+SG
zilros	zilro+N+M+PL
zilro	zilro+N+M+SG
zimazinhas	zima+N+DIM+F+PL
ziminhas	zima+N+DIM+F+PL
zimazinha	zima+N+DIM+F+SG
ziminha	zima+N+DIM+F+SG
zimas	zima+N+F+PL
zima	zima+N+F+SG
zimbabueanazinhas	zimbabueano+N+DIM+F+PL
zimbabueaninhas	zimbabueano+N+DIM+F+PL
zimbabueanazinha	zimbabueano+N+DIM+F+SG
zimbabueaninha	zimbabueano+N+DIM+F+SG
zimbabueaninhos	zimbabueano+N+DIM+M+PL
zimbabueanozinhos	zimbabueano+N+DIM+M+PL
zimbabueaninho	zimbabueano+N+DIM+M+SG
zimbabueanozinho	zimbabueano+N+DIM+M+SG
zimbabueanas	zimbabueano+N+F+PL
zimbabueana	zimbabueano+N+F+SG
zimbabueanos	zimbabueano+N+M+PL
zimbabueano	zimbabueano+N+M+SG
zimbinhos	zimbo+N+DIM+M+PL
zimbozinhos	zimbo+N+DIM+M+PL
zimbinho	zimbo+N+DIM+M+SG
zimbozinho	zimbo+N+DIM+M+SG
zimbos	zimbo+N+M+PL
zimbo	zimbo+N+M+SG
zimbrabilidadezinhas	zimbrabilidade+N+DIM+F+PL
zimbrabilidadinhas	zimbrabilidade+N+DIM+F+PL
zimbrabilidadezinha	zimbrabilidade+N+DIM+F+SG
zimbrabilidadinha	zimbrabilidade+N+DIM+F+SG
zimbrabilidades	zimbrabilidade+N+F+PL
zimbrabilidade	zimbrabilidade+N+F+SG
zimbradazinhas	zimbrada+N+DIM+F+PL
zimbradinhas	zimbrada+N+DIM+F+PL
zimbradazinha	zimbrada+N+DIM+F+SG
zimbradinha	zimbrada+N+DIM+F+SG
zimbradas	zimbrada+N+F+PL
zimbrada	zimbrada+N+F+SG
zimbraizinhos	zimbral+N+DIM+M+PL
zimbralzinho	zimbral+N+DIM+M+SG
zimbrais	zimbral+N+M+PL
zimbral	zimbral+N+M+SG
zimbreiraizinhos	zimbreiral+N+DIM+M+PL
zimbreiralzinho	zimbreiral+N+DIM+M+SG
zimbreirais	zimbreiral+N+M+PL
zimbreiral	zimbreiral+N+M+SG
zimbreirinhos	zimbreiro+N+DIM+M+PL
zimbreirozinhos	zimbreiro+N+DIM+M+PL
zimbreirinho	zimbreiro+N+DIM+M+SG
zimbreirozinho	zimbreiro+N+DIM+M+SG
zimbreiros	zimbreiro+N+M+PL
zimbreiro	zimbreiro+N+M+SG
zimbrinhos	zimbro+N+DIM+M+PL
zimbrozinhos	zimbro+N+DIM+M+PL
zimbrinho	zimbro+N+DIM+M+SG
zimbrozinho	zimbro+N+DIM+M+SG
zimbros	zimbro+N+M+PL
zimbro	zimbro+N+M+SG
zimborinhos	zimbório+N+DIM+M+PL
zimboriozinhos	zimbório+N+DIM+M+PL
zimborinho	zimbório+N+DIM+M+SG
zimboriozinho	zimbório+N+DIM+M+SG
zimbórios	zimbório+N+M+PL
zimbório	zimbório+N+M+SG
zimeosezinhas	zimeose+N+DIM+F+PL
zimeosinhas	zimeose+N+DIM+F+PL
zimeosezinha	zimeose+N+DIM+F+SG
zimeosinha	zimeose+N+DIM+F+SG
zimeoses	zimeose+N+F+PL
zimeose	zimeose+N+F+SG
zimicidadezinhas	zimicidade+N+DIM+F+PL
zimicidadinhas	zimicidade+N+DIM+F+PL
zimicidadezinha	zimicidade+N+DIM+F+SG
zimicidadinha	zimicidade+N+DIM+F+SG
zimicidades	zimicidade+N+F+PL
zimicidade	zimicidade+N+F+SG
zimogeniazinhas	zimogenia+N+DIM+F+PL
zimogeninhas	zimogenia+N+DIM+F+PL
zimogeniazinha	zimogenia+N+DIM+F+SG
zimogeninha	zimogenia+N+DIM+F+SG
zimogenias	zimogenia+N+F+PL
zimogenia	zimogenia+N+F+SG
zimogenicidadezinhas	zimogenicidade+N+DIM+F+PL
zimogenicidadinhas	zimogenicidade+N+DIM+F+PL
zimogenicidadezinha	zimogenicidade+N+DIM+F+SG
zimogenicidadinha	zimogenicidade+N+DIM+F+SG
zimogenicidades	zimogenicidade+N+F+PL
zimogenicidade	zimogenicidade+N+F+SG
zimogeninhos	zimogénio+N+DIM+M+PL
zimogeniozinhos	zimogénio+N+DIM+M+PL
zimogeninho	zimogénio+N+DIM+M+SG
zimogeniozinho	zimogénio+N+DIM+M+SG
zimogénios	zimogénio+N+M+PL
zimogénio	zimogénio+N+M+SG
zimogeninhos	zimogênio+N+DIM+M+PL
zimogeniozinhos	zimogênio+N+DIM+M+PL
zimogeninho	zimogênio+N+DIM+M+SG
zimogeniozinho	zimogênio+N+DIM+M+SG
zimogênios	zimogênio+N+M+PL
zimogênio	zimogênio+N+M+SG
zimologiazinhas	zimologia+N+DIM+F+PL
zimologinhas	zimologia+N+DIM+F+PL
zimologiazinha	zimologia+N+DIM+F+SG
zimologinha	zimologia+N+DIM+F+SG
zimologias	zimologia+N+F+PL
zimologia	zimologia+N+F+SG
zimosezinhas	zimose+N+DIM+F+PL
zimosinhas	zimose+N+DIM+F+PL
zimosezinha	zimose+N+DIM+F+SG
zimosinha	zimose+N+DIM+F+SG
zimoses	zimose+N+F+PL
zimose	zimose+N+F+SG
zimosimetriazinhas	zimosimetria+N+DIM+F+PL
zimosimetrinhas	zimosimetria+N+DIM+F+PL
zimosimetriazinha	zimosimetria+N+DIM+F+SG
zimosimetrinha	zimosimetria+N+DIM+F+SG
zimosimetrias	zimosimetria+N+F+PL
zimosimetria	zimosimetria+N+F+SG
zimosimetricidadezinhas	zimosimetricidade+N+DIM+F+PL
zimosimetricidadinhas	zimosimetricidade+N+DIM+F+PL
zimosimetricidadezinha	zimosimetricidade+N+DIM+F+SG
zimosimetricidadinha	zimosimetricidade+N+DIM+F+SG
zimosimetricidades	zimosimetricidade+N+F+PL
zimosimetricidade	zimosimetricidade+N+F+SG
zimosiometrinhos	zimosiómetro+N+DIM+M+PL
zimosiometrozinhos	zimosiómetro+N+DIM+M+PL
zimosiometrinho	zimosiómetro+N+DIM+M+SG
zimosiometrozinho	zimosiómetro+N+DIM+M+SG
zimosiómetros	zimosiómetro+N+M+PL
zimosiómetro	zimosiómetro+N+M+SG
zimosiometrinhos	zimosiômetro+N+DIM+M+PL
zimosiometrozinhos	zimosiômetro+N+DIM+M+PL
zimosiometrinho	zimosiômetro+N+DIM+M+SG
zimosiometrozinho	zimosiômetro+N+DIM+M+SG
zimosiômetros	zimosiômetro+N+M+PL
zimosiômetro	zimosiômetro+N+M+SG
zimosimetrinhos	zimosímetro+N+DIM+M+PL
zimosimetrozinhos	zimosímetro+N+DIM+M+PL
zimosimetrinho	zimosímetro+N+DIM+M+SG
zimosimetrozinho	zimosímetro+N+DIM+M+SG
zimosímetros	zimosímetro+N+M+PL
zimosímetro	zimosímetro+N+M+SG
zimotecniazinhas	zimotecnia+N+DIM+F+PL
zimotecninhas	zimotecnia+N+DIM+F+PL
zimotecniazinha	zimotecnia+N+DIM+F+SG
zimotecninha	zimotecnia+N+DIM+F+SG
zimotecnias	zimotecnia+N+F+PL
zimotecnia	zimotecnia+N+F+SG
zimotecnicidadezinhas	zimotecnicidade+N+DIM+F+PL
zimotecnicidadinhas	zimotecnicidade+N+DIM+F+PL
zimotecnicidadezinha	zimotecnicidade+N+DIM+F+SG
zimotecnicidadinha	zimotecnicidade+N+DIM+F+SG
zimotecnicidades	zimotecnicidade+N+F+PL
zimotecnicidade	zimotecnicidade+N+F+SG
zimoterapiazinhas	zimoterapia+N+DIM+F+PL
zimoterapinhas	zimoterapia+N+DIM+F+PL
zimoterapiazinha	zimoterapia+N+DIM+F+SG
zimoterapinha	zimoterapia+N+DIM+F+SG
zimoterapias	zimoterapia+N+F+PL
zimoterapia	zimoterapia+N+F+SG
zimoticidadezinhas	zimoticidade+N+DIM+F+PL
zimoticidadinhas	zimoticidade+N+DIM+F+PL
zimoticidadezinha	zimoticidade+N+DIM+F+SG
zimoticidadinha	zimoticidade+N+DIM+F+SG
zimoticidades	zimoticidade+N+F+PL
zimoticidade	zimoticidade+N+F+SG
zinazinhas	zina+N+DIM+F+PL
zininhas	zina+N+DIM+F+PL
zinazinha	zina+N+DIM+F+SG
zininha	zina+N+DIM+F+SG
zinas	zina+N+F+PL
zina	zina+N+F+SG
zinabrezinhos	zinabre+N+DIM+M+PL
zinabrinhos	zinabre+N+DIM+M+PL
zinabrezinho	zinabre+N+DIM+M+SG
zinabrinho	zinabre+N+DIM+M+SG
zinabres	zinabre+N+M+PL
zinabre	zinabre+N+M+SG
zincabilidadezinhas	zincabilidade+N+DIM+F+PL
zincabilidadinhas	zincabilidade+N+DIM+F+PL
zincabilidadezinha	zincabilidade+N+DIM+F+SG
zincabilidadinha	zincabilidade+N+DIM+F+SG
zincabilidades	zincabilidade+N+F+PL
zincabilidade	zincabilidade+N+F+SG
zincagenzinhos	zincagem+N+DIM+M+PL
zincagenzinho	zincagem+N+DIM+M+SG
zincagens	zincagem+N+M+PL
zincagem	zincagem+N+M+SG
zincicidadezinhas	zincicidade+N+DIM+F+PL
zincicidadinhas	zincicidade+N+DIM+F+PL
zincicidadezinha	zincicidade+N+DIM+F+SG
zincicidadinha	zincicidade+N+DIM+F+SG
zincicidades	zincicidade+N+F+PL
zincicidade	zincicidade+N+F+SG
zincitezinhas	zincite+N+DIM+F+PL
zincitinhas	zincite+N+DIM+F+PL
zincitezinha	zincite+N+DIM+F+SG
zincitinha	zincite+N+DIM+F+SG
zincites	zincite+N+F+PL
zincite	zincite+N+F+SG
zincozinhos	zinco+N+DIM+M+PL
zinquinhos	zinco+N+DIM+M+PL
zincozinho	zinco+N+DIM+M+SG
zinquinho	zinco+N+DIM+M+SG
zincos	zinco+N+M+PL
zinco	zinco+N+M+SG
zincografiazinhas	zincografia+N+DIM+F+PL
zincografinhas	zincografia+N+DIM+F+PL
zincografiazinha	zincografia+N+DIM+F+SG
zincografinha	zincografia+N+DIM+F+SG
zincografias	zincografia+N+F+PL
zincografia	zincografia+N+F+SG
zincograficidadezinhas	zincograficidade+N+DIM+F+PL
zincograficidadinhas	zincograficidade+N+DIM+F+PL
zincograficidadezinha	zincograficidade+N+DIM+F+SG
zincograficidadinha	zincograficidade+N+DIM+F+SG
zincograficidades	zincograficidade+N+F+PL
zincograficidade	zincograficidade+N+F+SG
zincogravabilidadezinhas	zincogravabilidade+N+DIM+F+PL
zincogravabilidadinhas	zincogravabilidade+N+DIM+F+PL
zincogravabilidadezinha	zincogravabilidade+N+DIM+F+SG
zincogravabilidadinha	zincogravabilidade+N+DIM+F+SG
zincogravabilidades	zincogravabilidade+N+F+PL
zincogravabilidade	zincogravabilidade+N+F+SG
zincogravadorazinhas	zincogravador+N+DIM+F+PL
zincogravadorinhas	zincogravador+N+DIM+F+PL
zincogravadorazinha	zincogravador+N+DIM+F+SG
zincogravadorinha	zincogravador+N+DIM+F+SG
zincogravadorezinhos	zincogravador+N+DIM+M+PL
zincogravadorzinhos	zincogravador+N+DIM+M+PL
zincogravadorzinho	zincogravador+N+DIM+M+SG
zincogravadoras	zincogravador+N+F+PL
zincogravadora	zincogravador+N+F+SG
zincogravadores	zincogravador+N+M+PL
zincogravador	zincogravador+N+M+SG
zincogravurazinhas	zincogravura+N+DIM+F+PL
zincogravurinhas	zincogravura+N+DIM+F+PL
zincogravurazinha	zincogravura+N+DIM+F+SG
zincogravurinha	zincogravura+N+DIM+F+SG
zincogravuras	zincogravura+N+F+PL
zincogravura	zincogravura+N+F+SG
zincografazinhas	zincógrafo+N+DIM+F+PL
zincografinhas	zincógrafo+N+DIM+F+PL
zincografazinha	zincógrafo+N+DIM+F+SG
zincografinha	zincógrafo+N+DIM+F+SG
zincografinhos	zincógrafo+N+DIM+M+PL
zincografozinhos	zincógrafo+N+DIM+M+PL
zincografinho	zincógrafo+N+DIM+M+SG
zincografozinho	zincógrafo+N+DIM+M+SG
zincógrafas	zincógrafo+N+F+PL
zincógrafa	zincógrafo+N+F+SG
zincógrafos	zincógrafo+N+M+PL
zincógrafo	zincógrafo+N+M+SG
zineirazinhas	zineira+N+DIM+F+PL
zineirinhas	zineira+N+DIM+F+PL
zineirazinha	zineira+N+DIM+F+SG
zineirinha	zineira+N+DIM+F+SG
zineiras	zineira+N+F+PL
zineira	zineira+N+F+SG
zingadorazinhas	zingador+N+DIM+F+PL
zingadorinhas	zingador+N+DIM+F+PL
zingadorazinha	zingador+N+DIM+F+SG
zingadorinha	zingador+N+DIM+F+SG
zingadorezinhos	zingador+N+DIM+M+PL
zingadorzinhos	zingador+N+DIM+M+PL
zingadorzinho	zingador+N+DIM+M+SG
zingadoras	zingador+N+F+PL
zingadora	zingador+N+F+SG
zingadores	zingador+N+M+PL
zingador	zingador+N+M+SG
zingamochinhos	zingamocho+N+DIM+M+PL
zingamochozinhos	zingamocho+N+DIM+M+PL
zingamochinho	zingamocho+N+DIM+M+SG
zingamochozinho	zingamocho+N+DIM+M+SG
zingamochos	zingamocho+N+M+PL
zingamocho	zingamocho+N+M+SG
zingiberaceazinhas	zingiberácea+N+DIM+F+PL
zingiberaceinhas	zingiberácea+N+DIM+F+PL
zingiberaceazinha	zingiberácea+N+DIM+F+SG
zingiberaceinha	zingiberácea+N+DIM+F+SG
zingiberáceas	zingiberácea+N+F+PL
zingiberácea	zingiberácea+N+F+SG
zingiberaceazinhas	zingiberáceo+N+DIM+F+PL
zingiberaceinhas	zingiberáceo+N+DIM+F+PL
zingiberaceazinha	zingiberáceo+N+DIM+F+SG
zingiberaceinha	zingiberáceo+N+DIM+F+SG
zingiberaceinhos	zingiberáceo+N+DIM+M+PL
zingiberaceozinhos	zingiberáceo+N+DIM+M+PL
zingiberaceinho	zingiberáceo+N+DIM+M+SG
zingiberaceozinho	zingiberáceo+N+DIM+M+SG
zingiberáceas	zingiberáceo+N+F+PL
zingiberácea	zingiberáceo+N+F+SG
zingiberáceos	zingiberáceo+N+M+PL
zingiberáceo	zingiberáceo+N+M+SG
zingraçõezinhos	zingração+N+DIM+M+PL
zingraçãozinho	zingração+N+DIM+M+SG
zingrações	zingração+N+M+PL
zingração	zingração+N+M+SG
zinhazinhas	zinho+N+DIM+F+PL
zinhinhas	zinho+N+DIM+F+PL
zinhazinha	zinho+N+DIM+F+SG
zinhinha	zinho+N+DIM+F+SG
zinhinhos	zinho+N+DIM+M+PL
zinhozinhos	zinho+N+DIM+M+PL
zinhinho	zinho+N+DIM+M+SG
zinhozinho	zinho+N+DIM+M+SG
zinhas	zinho+N+F+PL
zinha	zinho+N+F+SG
zinhos	zinho+N+M+PL
zinho	zinho+N+M+SG
zinideirazinhas	zinideira+N+DIM+F+PL
zinideirinhas	zinideira+N+DIM+F+PL
zinideirazinha	zinideira+N+DIM+F+SG
zinideirinha	zinideira+N+DIM+F+SG
zinideiras	zinideira+N+F+PL
zinideira	zinideira+N+F+SG
zinostatinazinhas	zinostatina+N+DIM+F+PL
zinostatininhas	zinostatina+N+DIM+F+PL
zinostatinazinha	zinostatina+N+DIM+F+SG
zinostatininha	zinostatina+N+DIM+F+SG
zinostatinas	zinostatina+N+F+PL
zinostatina	zinostatina+N+F+SG
zipadazinhas	zipada+N+DIM+F+PL
zipadinhas	zipada+N+DIM+F+PL
zipadazinha	zipada+N+DIM+F+SG
zipadinha	zipada+N+DIM+F+SG
zipadas	zipada+N+F+PL
zipada	zipada+N+F+SG
zirbalidadezinhas	zirbalidade+N+DIM+F+PL
zirbalidadinhas	zirbalidade+N+DIM+F+PL
zirbalidadezinha	zirbalidade+N+DIM+F+SG
zirbalidadinha	zirbalidade+N+DIM+F+SG
zirbalidades	zirbalidade+N+F+PL
zirbalidade	zirbalidade+N+F+SG
zirbeirinhos	zirbeiro+N+DIM+M+PL
zirbeirozinhos	zirbeiro+N+DIM+M+PL
zirbeirinho	zirbeiro+N+DIM+M+SG
zirbeirozinho	zirbeiro+N+DIM+M+SG
zirbeiros	zirbeiro+N+M+PL
zirbeiro	zirbeiro+N+M+SG
zirbinhos	zirbo+N+DIM+M+PL
zirbozinhos	zirbo+N+DIM+M+PL
zirbinho	zirbo+N+DIM+M+SG
zirbozinho	zirbo+N+DIM+M+SG
zirbos	zirbo+N+M+PL
zirbo	zirbo+N+M+SG
zirconicidadezinhas	zirconicidade+N+DIM+F+PL
zirconicidadinhas	zirconicidade+N+DIM+F+PL
zirconicidadezinha	zirconicidade+N+DIM+F+SG
zirconicidadinha	zirconicidade+N+DIM+F+SG
zirconicidades	zirconicidade+N+F+PL
zirconicidade	zirconicidade+N+F+SG
zircõezinhos	zircão+N+DIM+M+PL
zircãozinho	zircão+N+DIM+M+SG
zircões	zircão+N+M+PL
zircão	zircão+N+M+SG
zirconinhos	zircónio+N+DIM+M+PL
zirconiozinhos	zircónio+N+DIM+M+PL
zirconinho	zircónio+N+DIM+M+SG
zirconiozinho	zircónio+N+DIM+M+SG
zircónios	zircónio+N+M+PL
zircónio	zircónio+N+M+SG
zirconiazinhas	zircônia+N+DIM+F+PL
zirconinhas	zircônia+N+DIM+F+PL
zirconiazinha	zircônia+N+DIM+F+SG
zirconinha	zircônia+N+DIM+F+SG
zircônias	zircônia+N+F+PL
zircônia	zircônia+N+F+SG
zirconinhos	zircônio+N+DIM+M+PL
zirconiozinhos	zircônio+N+DIM+M+PL
zirconinho	zircônio+N+DIM+M+SG
zirconiozinho	zircônio+N+DIM+M+SG
zircônios	zircônio+N+M+PL
zircônio	zircônio+N+M+SG
zirneirazinhas	zirneira+N+DIM+F+PL
zirneirinhas	zirneira+N+DIM+F+PL
zirneirazinha	zirneira+N+DIM+F+SG
zirneirinha	zirneira+N+DIM+F+SG
zirneiras	zirneira+N+F+PL
zirneira	zirneira+N+F+SG
zirrinhos	zirro+N+DIM+M+PL
zirrozinhos	zirro+N+DIM+M+PL
zirrinho	zirro+N+DIM+M+SG
zirrozinho	zirro+N+DIM+M+SG
zirros	zirro+N+M+PL
zirro	zirro+N+M+SG
zitogalazinhas	zitógala+N+DIM+F+PL
zitogalinhas	zitógala+N+DIM+F+PL
zitogalazinha	zitógala+N+DIM+F+SG
zitogalinha	zitógala+N+DIM+F+SG
zitógalas	zitógala+N+F+PL
zitógala	zitógala+N+F+SG
zizanistazinhas	zizanista+N+DIM+F+PL
zizanistazinha	zizanista+N+DIM+F+SG
zizanistazinhos	zizanista+N+DIM+M+PL
zizanistazinho	zizanista+N+DIM+M+SG
zizanistinhas	zizanista+N+DIM+PL
zizanistinha	zizanista+N+DIM+SG
zizanistas	zizanista+N+PL
zizanista	zizanista+N+SG
zizifiaceazinhas	zizifiácea+N+DIM+F+PL
zizifiaceinhas	zizifiácea+N+DIM+F+PL
zizifiaceazinha	zizifiácea+N+DIM+F+SG
zizifiaceinha	zizifiácea+N+DIM+F+SG
zizifiáceas	zizifiácea+N+F+PL
zizifiácea	zizifiácea+N+F+SG
zizaniazinhas	zizânia+N+DIM+F+PL
zizaninhas	zizânia+N+DIM+F+PL
zizaniazinha	zizânia+N+DIM+F+SG
zizaninha	zizânia+N+DIM+F+SG
zizânias	zizânia+N+F+PL
zizânia	zizânia+N+F+SG
zoadazinhas	zoada+N+DIM+F+PL
zoadinhas	zoada+N+DIM+F+PL
zoadazinha	zoada+N+DIM+F+SG
zoadinha	zoada+N+DIM+F+SG
zoadas	zoada+N+F+PL
zoada	zoada+N+F+SG
zoadeirazinhas	zoadeira+N+DIM+F+PL
zoadeirinhas	zoadeira+N+DIM+F+PL
zoadeirazinha	zoadeira+N+DIM+F+SG
zoadeirinha	zoadeira+N+DIM+F+SG
zoadeiras	zoadeira+N+F+PL
zoadeira	zoadeira+N+F+SG
zoantropiazinhas	zoantropia+N+DIM+F+PL
zoantropinhas	zoantropia+N+DIM+F+PL
zoantropiazinha	zoantropia+N+DIM+F+SG
zoantropinha	zoantropia+N+DIM+F+SG
zoantropias	zoantropia+N+F+PL
zoantropia	zoantropia+N+F+SG
zoantropinhos	zoantropo+N+DIM+M+PL
zoantropozinhos	zoantropo+N+DIM+M+PL
zoantropinho	zoantropo+N+DIM+M+SG
zoantropozinho	zoantropo+N+DIM+M+SG
zoantropos	zoantropo+N+M+PL
zoantropo	zoantropo+N+M+SG
zoantarinhos	zoantário+N+DIM+M+PL
zoantariozinhos	zoantário+N+DIM+M+PL
zoantarinho	zoantário+N+DIM+M+SG
zoantariozinho	zoantário+N+DIM+M+SG
zoantários	zoantário+N+M+PL
zoantário	zoantário+N+M+SG
zoantideinhos	zoantídeo+N+DIM+M+PL
zoantideozinhos	zoantídeo+N+DIM+M+PL
zoantideinho	zoantídeo+N+DIM+M+SG
zoantideozinho	zoantídeo+N+DIM+M+SG
zoantídeos	zoantídeo+N+M+PL
zoantídeo	zoantídeo+N+M+SG
zodiacalidadezinhas	zodiacalidade+N+DIM+F+PL
zodiacalidadinhas	zodiacalidade+N+DIM+F+PL
zodiacalidadezinha	zodiacalidade+N+DIM+F+SG
zodiacalidadinha	zodiacalidade+N+DIM+F+SG
zodiacalidades	zodiacalidade+N+F+PL
zodiacalidade	zodiacalidade+N+F+SG
zodiacozinhos	zodíaco+N+DIM+M+PL
zodiaquinhos	zodíaco+N+DIM+M+PL
zodiacozinho	zodíaco+N+DIM+M+SG
zodiaquinho	zodíaco+N+DIM+M+SG
zodíacos	zodíaco+N+M+PL
zodíaco	zodíaco+N+M+SG
zoeiazinhas	zoeia+N+DIM+F+PL
zoeinhas	zoeia+N+DIM+F+PL
zoeiazinha	zoeia+N+DIM+F+SG
zoeinha	zoeia+N+DIM+F+SG
zoeias	zoeia+N+F+PL
zoeia	zoeia+N+F+SG
zoeirazinhas	zoeira+N+DIM+F+PL
zoeirinhas	zoeira+N+DIM+F+PL
zoeirazinha	zoeira+N+DIM+F+SG
zoeirinha	zoeira+N+DIM+F+SG
zoeiras	zoeira+N+F+PL
zoeira	zoeira+N+F+SG
zoelectricidadezinhas	zoelectricidade+N+DIM+F+PL
zoelectricidadinhas	zoelectricidade+N+DIM+F+PL
zoelectricidadezinha	zoelectricidade+N+DIM+F+SG
zoelectricidadinha	zoelectricidade+N+DIM+F+SG
zoelectricidades	zoelectricidade+N+F+PL
zoelectricidade	zoelectricidade+N+F+SG
zoeletricidadezinhas	zoeletricidade+N+DIM+F+PL
zoeletricidadinhas	zoeletricidade+N+DIM+F+PL
zoeletricidadezinha	zoeletricidade+N+DIM+F+SG
zoeletricidadinha	zoeletricidade+N+DIM+F+SG
zoeletricidades	zoeletricidade+N+F+PL
zoeletricidade	zoeletricidade+N+F+SG
zogazinhas	zoga+N+DIM+F+PL
zoguinhas	zoga+N+DIM+F+PL
zogazinha	zoga+N+DIM+F+SG
zoguinha	zoga+N+DIM+F+SG
zogas	zoga+N+F+PL
zoga	zoga+N+F+SG
zogadazinhas	zogada+N+DIM+F+PL
zogadinhas	zogada+N+DIM+F+PL
zogadazinha	zogada+N+DIM+F+SG
zogadinha	zogada+N+DIM+F+SG
zogadas	zogada+N+F+PL
zogada	zogada+N+F+SG
zoiatrazinhos	zoiatra+N+DIM+M+PL
zoiatrinhas	zoiatra+N+DIM+M+PL
zoiatrazinho	zoiatra+N+DIM+M+SG
zoiatrinha	zoiatra+N+DIM+M+SG
zoiatras	zoiatra+N+M+PL
zoiatra	zoiatra+N+M+SG
zoiatriazinhas	zoiatria+N+DIM+F+PL
zoiatrinhas	zoiatria+N+DIM+F+PL
zoiatriazinha	zoiatria+N+DIM+F+SG
zoiatrinha	zoiatria+N+DIM+F+SG
zoiatrias	zoiatria+N+F+PL
zoiatria	zoiatria+N+F+SG
zoiatrologiazinhas	zoiatrologia+N+DIM+F+PL
zoiatrologinhas	zoiatrologia+N+DIM+F+PL
zoiatrologiazinha	zoiatrologia+N+DIM+F+SG
zoiatrologinha	zoiatrologia+N+DIM+F+SG
zoiatrologias	zoiatrologia+N+F+PL
zoiatrologia	zoiatrologia+N+F+SG
zoiatrologistazinhas	zoiatrologista+N+DIM+F+PL
zoiatrologistazinha	zoiatrologista+N+DIM+F+SG
zoiatrologistazinhos	zoiatrologista+N+DIM+M+PL
zoiatrologistazinho	zoiatrologista+N+DIM+M+SG
zoiatrologistinhas	zoiatrologista+N+DIM+PL
zoiatrologistinha	zoiatrologista+N+DIM+SG
zoiatrologistas	zoiatrologista+N+PL
zoiatrologista	zoiatrologista+N+SG
zoiatrologazinhas	zoiatrólogo+N+DIM+F+PL
zoiatrologuinhas	zoiatrólogo+N+DIM+F+PL
zoiatrologazinha	zoiatrólogo+N+DIM+F+SG
zoiatrologuinha	zoiatrólogo+N+DIM+F+SG
zoiatrologozinhos	zoiatrólogo+N+DIM+M+PL
zoiatrologuinhos	zoiatrólogo+N+DIM+M+PL
zoiatrologozinho	zoiatrólogo+N+DIM+M+SG
zoiatrologuinho	zoiatrólogo+N+DIM+M+SG
zoiatrólogas	zoiatrólogo+N+F+PL
zoiatróloga	zoiatrólogo+N+F+SG
zoiatrólogos	zoiatrólogo+N+M+PL
zoiatrólogo	zoiatrólogo+N+M+SG
zoicidadezinhas	zoicidade+N+DIM+F+PL
zoicidadinhas	zoicidade+N+DIM+F+PL
zoicidadezinha	zoicidade+N+DIM+F+SG
zoicidadinha	zoicidade+N+DIM+F+SG
zoicidades	zoicidade+N+F+PL
zoicidade	zoicidade+N+F+SG
zoidezinhos	zoide+N+DIM+M+PL
zoidinhos	zoide+N+DIM+M+PL
zoidezinho	zoide+N+DIM+M+SG
zoidinho	zoide+N+DIM+M+SG
zoides	zoide+N+M+PL
zoide	zoide+N+M+SG
zoidiofiliazinhas	zoidiofilia+N+DIM+F+PL
zoidiofilinhas	zoidiofilia+N+DIM+F+PL
zoidiofiliazinha	zoidiofilia+N+DIM+F+SG
zoidiofilinha	zoidiofilia+N+DIM+F+SG
zoidiofilias	zoidiofilia+N+F+PL
zoidiofilia	zoidiofilia+N+F+SG
zoidiogamiazinhas	zoidiogamia+N+DIM+F+PL
zoidiogaminhas	zoidiogamia+N+DIM+F+PL
zoidiogamiazinha	zoidiogamia+N+DIM+F+SG
zoidiogaminha	zoidiogamia+N+DIM+F+SG
zoidiogamias	zoidiogamia+N+F+PL
zoidiogamia	zoidiogamia+N+F+SG
zoilinhos	zoilo+N+DIM+M+PL
zoilozinhos	zoilo+N+DIM+M+PL
zoilinho	zoilo+N+DIM+M+SG
zoilozinho	zoilo+N+DIM+M+SG
zoilos	zoilo+N+M+PL
zoilo	zoilo+N+M+SG
zoinazinhas	zoina+N+DIM+F+PL
zoininhas	zoina+N+DIM+F+PL
zoinazinha	zoina+N+DIM+F+SG
zoininha	zoina+N+DIM+F+SG
zoinas	zoina+N+F+PL
zoina	zoina+N+F+SG
zoisitezinhas	zoisite+N+DIM+F+PL
zoisitinhas	zoisite+N+DIM+F+PL
zoisitezinha	zoisite+N+DIM+F+SG
zoisitinha	zoisite+N+DIM+F+SG
zoisites	zoisite+N+F+PL
zoisite	zoisite+N+F+SG
zolazinhas	zola+N+DIM+F+PL
zolinhas	zola+N+DIM+F+PL
zolazinha	zola+N+DIM+F+SG
zolinha	zola+N+DIM+F+SG
zolas	zola+N+F+PL
zola	zola+N+F+SG
zolaisminhos	zolaísmo+N+DIM+M+PL
zolaismozinhos	zolaísmo+N+DIM+M+PL
zolaisminho	zolaísmo+N+DIM+M+SG
zolaismozinho	zolaísmo+N+DIM+M+SG
zolaísmos	zolaísmo+N+M+PL
zolaísmo	zolaísmo+N+M+SG
zolizinhos	zoli+N+DIM+M+PL
zolizinho	zoli+N+DIM+M+SG
zolis	zoli+N+M+PL
zoli	zoli+N+M+SG
zolisminhos	zolismo+N+DIM+M+PL
zolismozinhos	zolismo+N+DIM+M+PL
zolisminho	zolismo+N+DIM+M+SG
zolismozinho	zolismo+N+DIM+M+SG
zolismos	zolismo+N+M+PL
zolismo	zolismo+N+M+SG
zombazinhas	zomba+N+DIM+F+PL
zombinhas	zomba+N+DIM+F+PL
zombazinha	zomba+N+DIM+F+SG
zombinha	zomba+N+DIM+F+SG
zombas	zomba+N+F+PL
zomba	zomba+N+F+SG
zombadorazinhas	zombador+N+DIM+F+PL
zombadorinhas	zombador+N+DIM+F+PL
zombadorazinha	zombador+N+DIM+F+SG
zombadorinha	zombador+N+DIM+F+SG
zombadorezinhos	zombador+N+DIM+M+PL
zombadorzinhos	zombador+N+DIM+M+PL
zombadorzinho	zombador+N+DIM+M+SG
zombadoras	zombador+N+F+PL
zombadora	zombador+N+F+SG
zombadores	zombador+N+M+PL
zombador	zombador+N+M+SG
zombariazinhas	zombaria+N+DIM+F+PL
zombarinhas	zombaria+N+DIM+F+PL
zombariazinha	zombaria+N+DIM+F+SG
zombarinha	zombaria+N+DIM+F+SG
zombarias	zombaria+N+F+PL
zombaria	zombaria+N+F+SG
zombeironazinhas	zombeirão+N+DIM+F+PL
zombeironinhas	zombeirão+N+DIM+F+PL
zombeironazinha	zombeirão+N+DIM+F+SG
zombeironinha	zombeirão+N+DIM+F+SG
zombeirõezinhos	zombeirão+N+DIM+M+PL
zombeirãozinho	zombeirão+N+DIM+M+SG
zombeironas	zombeirão+N+F+PL
zombeirona	zombeirão+N+F+SG
zombeirões	zombeirão+N+M+PL
zombeirão	zombeirão+N+M+SG
zombeteirazinhas	zombeteiro+N+DIM+F+PL
zombeteirinhas	zombeteiro+N+DIM+F+PL
zombeteirazinha	zombeteiro+N+DIM+F+SG
zombeteirinha	zombeteiro+N+DIM+F+SG
zombeteirinhos	zombeteiro+N+DIM+M+PL
zombeteirozinhos	zombeteiro+N+DIM+M+PL
zombeteirinho	zombeteiro+N+DIM+M+SG
zombeteirozinho	zombeteiro+N+DIM+M+SG
zombeteiras	zombeteiro+N+F+PL
zombeteira	zombeteiro+N+F+SG
zombeteiros	zombeteiro+N+M+PL
zombeteiro	zombeteiro+N+M+SG
zombiezinhas	zombie+N+DIM+F+PL
zombinhas	zombie+N+DIM+F+PL
zombiezinha	zombie+N+DIM+F+SG
zombinha	zombie+N+DIM+F+SG
zombiezinhos	zombie+N+DIM+M+PL
zombinhos	zombie+N+DIM+M+PL
zombiezinho	zombie+N+DIM+M+SG
zombinho	zombie+N+DIM+M+SG
zombies	zombie+N+PL
zombie	zombie+N+SG
zomoterapiazinhas	zomoterapia+N+DIM+F+PL
zomoterapinhas	zomoterapia+N+DIM+F+PL
zomoterapiazinha	zomoterapia+N+DIM+F+SG
zomoterapinha	zomoterapia+N+DIM+F+SG
zomoterapias	zomoterapia+N+F+PL
zomoterapia	zomoterapia+N+F+SG
zonazinhas	zona+N+DIM+F+PL
zoninhas	zona+N+DIM+F+PL
zonazinha	zona+N+DIM+F+SG
zoninha	zona+N+DIM+F+SG
zonas	zona+N+F+PL
zona	zona+N+F+SG
zona-pilotinhos	zona-piloto+N+DIM+F+PL
zonas-pilotozinhas	zona-piloto+N+DIM+F+PL
zona-pilotinho	zona-piloto+N+DIM+F+SG
zona-pilotozinha	zona-piloto+N+DIM+F+SG
zonas-piloto	zona-piloto+N+F+PL
zona-piloto	zona-piloto+N+F+SG
zonas-tampãozinhas	zona-tampão+N+DIM+F+PL
zona-tampãozinha	zona-tampão+N+DIM+F+SG
zonas-tampão	zona-tampão+N+F+PL
zona-tampão	zona-tampão+N+F+SG
zonadazinhas	zonada+N+DIM+F+PL
zonadinhas	zonada+N+DIM+F+PL
zonadazinha	zonada+N+DIM+F+SG
zonadinha	zonada+N+DIM+F+SG
zonadas	zonada+N+F+PL
zonada	zonada+N+F+SG
zonadazinhas	zonado+N+DIM+F+PL
zonadinhas	zonado+N+DIM+F+PL
zonadazinha	zonado+N+DIM+F+SG
zonadinha	zonado+N+DIM+F+SG
zonadinhos	zonado+N+DIM+M+PL
zonadozinhos	zonado+N+DIM+M+PL
zonadinho	zonado+N+DIM+M+SG
zonadozinho	zonado+N+DIM+M+SG
zonadas	zonado+N+F+PL
zonada	zonado+N+F+SG
zonados	zonado+N+M+PL
zonado	zonado+N+M+SG
zonalidadezinhas	zonalidade+N+DIM+F+PL
zonalidadinhas	zonalidade+N+DIM+F+PL
zonalidadezinha	zonalidade+N+DIM+F+SG
zonalidadinha	zonalidade+N+DIM+F+SG
zonalidades	zonalidade+N+F+PL
zonalidade	zonalidade+N+F+SG
zonchadurazinhas	zonchadura+N+DIM+F+PL
zonchadurinhas	zonchadura+N+DIM+F+PL
zonchadurazinha	zonchadura+N+DIM+F+SG
zonchadurinha	zonchadura+N+DIM+F+SG
zonchaduras	zonchadura+N+F+PL
zonchadura	zonchadura+N+F+SG
zonchinhos	zoncho+N+DIM+M+PL
zonchozinhos	zoncho+N+DIM+M+PL
zonchinho	zoncho+N+DIM+M+SG
zonchozinho	zoncho+N+DIM+M+SG
zonchos	zoncho+N+M+PL
zoncho	zoncho+N+M+SG
zondaliazinhas	zondálio+N+DIM+F+PL
zondalinhas	zondálio+N+DIM+F+PL
zondaliazinha	zondálio+N+DIM+F+SG
zondalinha	zondálio+N+DIM+F+SG
zondalinhos	zondálio+N+DIM+M+PL
zondaliozinhos	zondálio+N+DIM+M+PL
zondalinho	zondálio+N+DIM+M+SG
zondaliozinho	zondálio+N+DIM+M+SG
zondálias	zondálio+N+F+PL
zondália	zondálio+N+F+SG
zondálios	zondálio+N+M+PL
zondálio	zondálio+N+M+SG
zoneamentinhos	zoneamento+N+DIM+M+PL
zoneamentozinhos	zoneamento+N+DIM+M+PL
zoneamentinho	zoneamento+N+DIM+M+SG
zoneamentozinho	zoneamento+N+DIM+M+SG
zoneamentos	zoneamento+N+M+PL
zoneamento	zoneamento+N+M+SG
zonzeirazinhas	zonzeira+N+DIM+F+PL
zonzeirinhas	zonzeira+N+DIM+F+PL
zonzeirazinha	zonzeira+N+DIM+F+SG
zonzeirinha	zonzeira+N+DIM+F+SG
zonzeiras	zonzeira+N+F+PL
zonzeira	zonzeira+N+F+SG
zonzonzinhos	zonzom+N+DIM+M+PL
zonzonzinho	zonzom+N+DIM+M+SG
zonzons	zonzom+N+M+PL
zonzom	zonzom+N+M+SG
zoinhos	zoo+N+DIM+M+PL
zoozinhos	zoo+N+DIM+M+PL
zoinho	zoo+N+DIM+M+SG
zoozinho	zoo+N+DIM+M+SG
zoos	zoo+N+M+PL
zoo	zoo+N+M+SG
zoobiazinhas	zoobia+N+DIM+F+PL
zoobinhas	zoobia+N+DIM+F+PL
zoobiazinha	zoobia+N+DIM+F+SG
zoobinha	zoobia+N+DIM+F+SG
zoobias	zoobia+N+F+PL
zoobia	zoobia+N+F+SG
zoobiologiazinhas	zoobiologia+N+DIM+F+PL
zoobiologinhas	zoobiologia+N+DIM+F+PL
zoobiologiazinha	zoobiologia+N+DIM+F+SG
zoobiologinha	zoobiologia+N+DIM+F+SG
zoobiologias	zoobiologia+N+F+PL
zoobiologia	zoobiologia+N+F+SG
zoobioticidadezinhas	zoobioticidade+N+DIM+F+PL
zoobioticidadinhas	zoobioticidade+N+DIM+F+PL
zoobioticidadezinha	zoobioticidade+N+DIM+F+SG
zoobioticidadinha	zoobioticidade+N+DIM+F+SG
zoobioticidades	zoobioticidade+N+F+PL
zoobioticidade	zoobioticidade+N+F+SG
zoocecidiazinhas	zoocecídia+N+DIM+F+PL
zoocecidinhas	zoocecídia+N+DIM+F+PL
zoocecidiazinha	zoocecídia+N+DIM+F+SG
zoocecidinha	zoocecídia+N+DIM+F+SG
zoocecídias	zoocecídia+N+F+PL
zoocecídia	zoocecídia+N+F+SG
zoocinazinhas	zoocina+N+DIM+F+PL
zoocininhas	zoocina+N+DIM+F+PL
zoocinazinha	zoocina+N+DIM+F+SG
zoocininha	zoocina+N+DIM+F+SG
zoocinas	zoocina+N+F+PL
zoocina	zoocina+N+F+SG
zoocistezinhas	zoociste+N+DIM+F+PL
zoocistinhas	zoociste+N+DIM+F+PL
zoocistezinha	zoociste+N+DIM+F+SG
zoocistinha	zoociste+N+DIM+F+SG
zoocistes	zoociste+N+F+PL
zoociste	zoociste+N+F+SG
zooclorelazinhas	zooclorela+N+DIM+F+PL
zooclorelinhas	zooclorela+N+DIM+F+PL
zooclorelazinha	zooclorela+N+DIM+F+SG
zooclorelinha	zooclorela+N+DIM+F+SG
zooclorelas	zooclorela+N+F+PL
zooclorela	zooclorela+N+F+SG
zoococinazinhas	zoococina+N+DIM+F+PL
zoococininhas	zoococina+N+DIM+F+PL
zoococinazinha	zoococina+N+DIM+F+SG
zoococininha	zoococina+N+DIM+F+SG
zoococinas	zoococina+N+F+PL
zoococina	zoococina+N+F+SG
zoodinamicazinhas	zoodinâmica+N+DIM+F+PL
zoodinamiquinhas	zoodinâmica+N+DIM+F+PL
zoodinamicazinha	zoodinâmica+N+DIM+F+SG
zoodinamiquinha	zoodinâmica+N+DIM+F+SG
zoodinâmicas	zoodinâmica+N+F+PL
zoodinâmica	zoodinâmica+N+F+SG
zoodomaciazinhas	zoodomácia+N+DIM+F+PL
zoodomacinhas	zoodomácia+N+DIM+F+PL
zoodomaciazinha	zoodomácia+N+DIM+F+SG
zoodomacinha	zoodomácia+N+DIM+F+SG
zoodomácias	zoodomácia+N+F+PL
zoodomácia	zoodomácia+N+F+SG
zooelectricidadezinhas	zooelectricidade+N+DIM+F+PL
zooelectricidadinhas	zooelectricidade+N+DIM+F+PL
zooelectricidadezinha	zooelectricidade+N+DIM+F+SG
zooelectricidadinha	zooelectricidade+N+DIM+F+SG
zooelectricidades	zooelectricidade+N+F+PL
zooelectricidade	zooelectricidade+N+F+SG
zooeletricidadezinhas	zooeletricidade+N+DIM+F+PL
zooeletricidadinhas	zooeletricidade+N+DIM+F+PL
zooeletricidadezinha	zooeletricidade+N+DIM+F+SG
zooeletricidadinha	zooeletricidade+N+DIM+F+SG
zooeletricidades	zooeletricidade+N+F+PL
zooeletricidade	zooeletricidade+N+F+SG
zoofagiazinhas	zoofagia+N+DIM+F+PL
zoofaginhas	zoofagia+N+DIM+F+PL
zoofagiazinha	zoofagia+N+DIM+F+SG
zoofaginha	zoofagia+N+DIM+F+SG
zoofagias	zoofagia+N+F+PL
zoofagia	zoofagia+N+F+SG
zoofiliazinhas	zoofilia+N+DIM+F+PL
zoofilinhas	zoofilia+N+DIM+F+PL
zoofiliazinha	zoofilia+N+DIM+F+SG
zoofilinha	zoofilia+N+DIM+F+SG
zoofilias	zoofilia+N+F+PL
zoofilia	zoofilia+N+F+SG
zoofiticidadezinhas	zoofiticidade+N+DIM+F+PL
zoofiticidadinhas	zoofiticidade+N+DIM+F+PL
zoofiticidadezinha	zoofiticidade+N+DIM+F+SG
zoofiticidadinha	zoofiticidade+N+DIM+F+SG
zoofiticidades	zoofiticidade+N+F+PL
zoofiticidade	zoofiticidade+N+F+SG
zoofitobiazinhas	zoofitobia+N+DIM+F+PL
zoofitobinhas	zoofitobia+N+DIM+F+PL
zoofitobiazinha	zoofitobia+N+DIM+F+SG
zoofitobinha	zoofitobia+N+DIM+F+SG
zoofitobias	zoofitobia+N+F+PL
zoofitobia	zoofitobia+N+F+SG
zoofitologiazinhas	zoofitologia+N+DIM+F+PL
zoofitologinhas	zoofitologia+N+DIM+F+PL
zoofitologiazinha	zoofitologia+N+DIM+F+SG
zoofitologinha	zoofitologia+N+DIM+F+SG
zoofitologias	zoofitologia+N+F+PL
zoofitologia	zoofitologia+N+F+SG
zoofitografazinhas	zoofitógrafo+N+DIM+F+PL
zoofitografinhas	zoofitógrafo+N+DIM+F+PL
zoofitografazinha	zoofitógrafo+N+DIM+F+SG
zoofitografinha	zoofitógrafo+N+DIM+F+SG
zoofitografinhos	zoofitógrafo+N+DIM+M+PL
zoofitografozinhos	zoofitógrafo+N+DIM+M+PL
zoofitografinho	zoofitógrafo+N+DIM+M+SG
zoofitografozinho	zoofitógrafo+N+DIM+M+SG
zoofitógrafas	zoofitógrafo+N+F+PL
zoofitógrafa	zoofitógrafo+N+F+SG
zoofitógrafos	zoofitógrafo+N+M+PL
zoofitógrafo	zoofitógrafo+N+M+SG
zoofitologazinhas	zoofitólogo+N+DIM+F+PL
zoofitologuinhas	zoofitólogo+N+DIM+F+PL
zoofitologazinha	zoofitólogo+N+DIM+F+SG
zoofitologuinha	zoofitólogo+N+DIM+F+SG
zoofitologozinhos	zoofitólogo+N+DIM+M+PL
zoofitologuinhos	zoofitólogo+N+DIM+M+PL
zoofitologozinho	zoofitólogo+N+DIM+M+SG
zoofitologuinho	zoofitólogo+N+DIM+M+SG
zoofitólogas	zoofitólogo+N+F+PL
zoofitóloga	zoofitólogo+N+F+SG
zoofitólogos	zoofitólogo+N+M+PL
zoofitólogo	zoofitólogo+N+M+SG
zooflageladinhos	zooflagelado+N+DIM+M+PL
zooflageladozinhos	zooflagelado+N+DIM+M+PL
zooflageladinho	zooflagelado+N+DIM+M+SG
zooflageladozinho	zooflagelado+N+DIM+M+SG
zooflagelados	zooflagelado+N+M+PL
zooflagelado	zooflagelado+N+M+SG
zoofobiazinhas	zoofobia+N+DIM+F+PL
zoofobinhas	zoofobia+N+DIM+F+PL
zoofobiazinha	zoofobia+N+DIM+F+SG
zoofobinha	zoofobia+N+DIM+F+SG
zoofobias	zoofobia+N+F+PL
zoofobia	zoofobia+N+F+SG
zoogamiazinhas	zoogamia+N+DIM+F+PL
zoogaminhas	zoogamia+N+DIM+F+PL
zoogamiazinha	zoogamia+N+DIM+F+SG
zoogaminha	zoogamia+N+DIM+F+SG
zoogamias	zoogamia+N+F+PL
zoogamia	zoogamia+N+F+SG
zoogeniazinhas	zoogenia+N+DIM+F+PL
zoogeninhas	zoogenia+N+DIM+F+PL
zoogeniazinha	zoogenia+N+DIM+F+SG
zoogeninha	zoogenia+N+DIM+F+SG
zoogenias	zoogenia+N+F+PL
zoogenia	zoogenia+N+F+SG
zoogenicidadezinhas	zoogenicidade+N+DIM+F+PL
zoogenicidadinhas	zoogenicidade+N+DIM+F+PL
zoogenicidadezinha	zoogenicidade+N+DIM+F+SG
zoogenicidadinha	zoogenicidade+N+DIM+F+SG
zoogenicidades	zoogenicidade+N+F+PL
zoogenicidade	zoogenicidade+N+F+SG
zoogeografiazinhas	zoogeografia+N+DIM+F+PL
zoogeografinhas	zoogeografia+N+DIM+F+PL
zoogeografiazinha	zoogeografia+N+DIM+F+SG
zoogeografinha	zoogeografia+N+DIM+F+SG
zoogeografias	zoogeografia+N+F+PL
zoogeografia	zoogeografia+N+F+SG
zoogleiazinhas	zoogleia+N+DIM+F+PL
zoogleinhas	zoogleia+N+DIM+F+PL
zoogleiazinha	zoogleia+N+DIM+F+SG
zoogleinha	zoogleia+N+DIM+F+SG
zoogleias	zoogleia+N+F+PL
zoogleia	zoogleia+N+F+SG
zoogleiazinhas	zoogléia+N+DIM+F+PL
zoogleinhas	zoogléia+N+DIM+F+PL
zoogleiazinha	zoogléia+N+DIM+F+SG
zoogleinha	zoogléia+N+DIM+F+SG
zoogléias	zoogléia+N+F+PL
zoogléia	zoogléia+N+F+SG
zoogoniazinhas	zoogonia+N+DIM+F+PL
zoogoninhas	zoogonia+N+DIM+F+PL
zoogoniazinha	zoogonia+N+DIM+F+SG
zoogoninha	zoogonia+N+DIM+F+SG
zoogonias	zoogonia+N+F+PL
zoogonia	zoogonia+N+F+SG
zoografiazinhas	zoografia+N+DIM+F+PL
zoografinhas	zoografia+N+DIM+F+PL
zoografiazinha	zoografia+N+DIM+F+SG
zoografinha	zoografia+N+DIM+F+SG
zoografias	zoografia+N+F+PL
zoografia	zoografia+N+F+SG
zoograficidadezinhas	zoograficidade+N+DIM+F+PL
zoograficidadinhas	zoograficidade+N+DIM+F+PL
zoograficidadezinha	zoograficidade+N+DIM+F+SG
zoograficidadinha	zoograficidade+N+DIM+F+SG
zoograficidades	zoograficidade+N+F+PL
zoograficidade	zoograficidade+N+F+SG
zoogametazinhos	zoogâmeta+N+DIM+M+PL
zoogametinhas	zoogâmeta+N+DIM+M+PL
zoogametazinho	zoogâmeta+N+DIM+M+SG
zoogametinha	zoogâmeta+N+DIM+M+SG
zoogâmetas	zoogâmeta+N+M+PL
zoogâmeta	zoogâmeta+N+M+SG
zoogeninhos	zoogénio+N+DIM+M+PL
zoogeniozinhos	zoogénio+N+DIM+M+PL
zoogeninho	zoogénio+N+DIM+M+SG
zoogeniozinho	zoogénio+N+DIM+M+SG
zoogénios	zoogénio+N+M+PL
zoogénio	zoogénio+N+M+SG
zoogeninhos	zoogênio+N+DIM+M+PL
zoogeniozinhos	zoogênio+N+DIM+M+PL
zoogeninho	zoogênio+N+DIM+M+SG
zoogeniozinho	zoogênio+N+DIM+M+SG
zoogênios	zoogênio+N+M+PL
zoogênio	zoogênio+N+M+SG
zooiatrazinhas	zooiatra+N+DIM+F+PL
zooiatrazinha	zooiatra+N+DIM+F+SG
zooiatrazinhos	zooiatra+N+DIM+M+PL
zooiatrazinho	zooiatra+N+DIM+M+SG
zooiatrinhas	zooiatra+N+DIM+PL
zooiatrinha	zooiatra+N+DIM+SG
zooiatras	zooiatra+N+PL
zooiatra	zooiatra+N+SG
zooidezinhos	zooide+N+DIM+M+PL
zooidinhos	zooide+N+DIM+M+PL
zooidezinho	zooide+N+DIM+M+SG
zooidinho	zooide+N+DIM+M+SG
zooides	zooide+N+M+PL
zooide	zooide+N+M+SG
zoolatriazinhas	zoolatria+N+DIM+F+PL
zoolatrinhas	zoolatria+N+DIM+F+PL
zoolatriazinha	zoolatria+N+DIM+F+SG
zoolatrinha	zoolatria+N+DIM+F+SG
zoolatrias	zoolatria+N+F+PL
zoolatria	zoolatria+N+F+SG
zoolatricidadezinhas	zoolatricidade+N+DIM+F+PL
zoolatricidadinhas	zoolatricidade+N+DIM+F+PL
zoolatricidadezinha	zoolatricidade+N+DIM+F+SG
zoolatricidadinha	zoolatricidade+N+DIM+F+SG
zoolatricidades	zoolatricidade+N+F+PL
zoolatricidade	zoolatricidade+N+F+SG
zooliticidadezinhas	zooliticidade+N+DIM+F+PL
zooliticidadinhas	zooliticidade+N+DIM+F+PL
zooliticidadezinha	zooliticidade+N+DIM+F+SG
zooliticidadinha	zooliticidade+N+DIM+F+SG
zooliticidades	zooliticidade+N+F+PL
zooliticidade	zooliticidade+N+F+SG
zoologiazinhas	zoologia+N+DIM+F+PL
zoologinhas	zoologia+N+DIM+F+PL
zoologiazinha	zoologia+N+DIM+F+SG
zoologinha	zoologia+N+DIM+F+SG
zoologias	zoologia+N+F+PL
zoologia	zoologia+N+F+SG
zoologicidadezinhas	zoologicidade+N+DIM+F+PL
zoologicidadinhas	zoologicidade+N+DIM+F+PL
zoologicidadezinha	zoologicidade+N+DIM+F+SG
zoologicidadinha	zoologicidade+N+DIM+F+SG
zoologicidades	zoologicidade+N+F+PL
zoologicidade	zoologicidade+N+F+SG
zoologistazinhas	zoologista+N+DIM+F+PL
zoologistazinha	zoologista+N+DIM+F+SG
zoologistazinhos	zoologista+N+DIM+M+PL
zoologistazinho	zoologista+N+DIM+M+SG
zoologistinhas	zoologista+N+DIM+PL
zoologistinha	zoologista+N+DIM+SG
zoologistas	zoologista+N+PL
zoologista	zoologista+N+SG
zoomezinhos	zoom+N+DIM+M+PL
zoomzinhos	zoom+N+DIM+M+PL
zoonzinho	zoom+N+DIM+M+SG
zoomes	zoom+N+M+PL
zooms	zoom+N+M+PL
zoom	zoom+N+M+SG
zoomagneticidadezinhas	zoomagneticidade+N+DIM+F+PL
zoomagneticidadinhas	zoomagneticidade+N+DIM+F+PL
zoomagneticidadezinha	zoomagneticidade+N+DIM+F+SG
zoomagneticidadinha	zoomagneticidade+N+DIM+F+SG
zoomagneticidades	zoomagneticidade+N+F+PL
zoomagneticidade	zoomagneticidade+N+F+SG
zoomagnetisminhos	zoomagnetismo+N+DIM+M+PL
zoomagnetismozinhos	zoomagnetismo+N+DIM+M+PL
zoomagnetisminho	zoomagnetismo+N+DIM+M+SG
zoomagnetismozinho	zoomagnetismo+N+DIM+M+SG
zoomagnetismos	zoomagnetismo+N+M+PL
zoomagnetismo	zoomagnetismo+N+M+SG
zoomaniazinhas	zoomania+N+DIM+F+PL
zoomaninhas	zoomania+N+DIM+F+PL
zoomaniazinha	zoomania+N+DIM+F+SG
zoomaninha	zoomania+N+DIM+F+SG
zoomanias	zoomania+N+F+PL
zoomania	zoomania+N+F+SG
zoomaniacazinhas	zoomaníaco+N+DIM+F+PL
zoomaniaquinhas	zoomaníaco+N+DIM+F+PL
zoomaniacazinha	zoomaníaco+N+DIM+F+SG
zoomaniaquinha	zoomaníaco+N+DIM+F+SG
zoomaniacozinhos	zoomaníaco+N+DIM+M+PL
zoomaniaquinhos	zoomaníaco+N+DIM+M+PL
zoomaniacozinho	zoomaníaco+N+DIM+M+SG
zoomaniaquinho	zoomaníaco+N+DIM+M+SG
zoomaníacas	zoomaníaco+N+F+PL
zoomaníaca	zoomaníaco+N+F+SG
zoomaníacos	zoomaníaco+N+M+PL
zoomaníaco	zoomaníaco+N+M+SG
zoomastigininhos	zoomastigino+N+DIM+M+PL
zoomastiginozinhos	zoomastigino+N+DIM+M+PL
zoomastigininho	zoomastigino+N+DIM+M+SG
zoomastiginozinho	zoomastigino+N+DIM+M+SG
zoomastiginos	zoomastigino+N+M+PL
zoomastigino	zoomastigino+N+M+SG
zoomorfiazinhas	zoomorfia+N+DIM+F+PL
zoomorfinhas	zoomorfia+N+DIM+F+PL
zoomorfiazinha	zoomorfia+N+DIM+F+SG
zoomorfinha	zoomorfia+N+DIM+F+SG
zoomorfias	zoomorfia+N+F+PL
zoomorfia	zoomorfia+N+F+SG
zoomorficidadezinhas	zoomorficidade+N+DIM+F+PL
zoomorficidadinhas	zoomorficidade+N+DIM+F+PL
zoomorficidadezinha	zoomorficidade+N+DIM+F+SG
zoomorficidadinha	zoomorficidade+N+DIM+F+SG
zoomorficidades	zoomorficidade+N+F+PL
zoomorficidade	zoomorficidade+N+F+SG
zoomorfisminhos	zoomorfismo+N+DIM+M+PL
zoomorfismozinhos	zoomorfismo+N+DIM+M+PL
zoomorfisminho	zoomorfismo+N+DIM+M+SG
zoomorfismozinho	zoomorfismo+N+DIM+M+SG
zoomorfismos	zoomorfismo+N+M+PL
zoomorfismo	zoomorfismo+N+M+SG
zoomorfitezinhas	zoomorfite+N+DIM+F+PL
zoomorfitinhas	zoomorfite+N+DIM+F+PL
zoomorfitezinha	zoomorfite+N+DIM+F+SG
zoomorfitinha	zoomorfite+N+DIM+F+SG
zoomorfites	zoomorfite+N+F+PL
zoomorfite	zoomorfite+N+F+SG
zoomorfinhos	zoomorfo+N+DIM+M+PL
zoomorfozinhos	zoomorfo+N+DIM+M+PL
zoomorfinho	zoomorfo+N+DIM+M+SG
zoomorfozinho	zoomorfo+N+DIM+M+SG
zoomorfos	zoomorfo+N+M+PL
zoomorfo	zoomorfo+N+M+SG
zoomorfosezinhas	zoomorfose+N+DIM+F+PL
zoomorfosinhas	zoomorfose+N+DIM+F+PL
zoomorfosezinha	zoomorfose+N+DIM+F+SG
zoomorfosinha	zoomorfose+N+DIM+F+SG
zoomorfoses	zoomorfose+N+F+PL
zoomorfose	zoomorfose+N+F+SG
zoonicidadezinhas	zoonicidade+N+DIM+F+PL
zoonicidadinhas	zoonicidade+N+DIM+F+PL
zoonicidadezinha	zoonicidade+N+DIM+F+SG
zoonicidadinha	zoonicidade+N+DIM+F+SG
zoonicidades	zoonicidade+N+F+PL
zoonicidade	zoonicidade+N+F+SG
zoonitinhos	zoonito+N+DIM+M+PL
zoonitozinhos	zoonito+N+DIM+M+PL
zoonitinho	zoonito+N+DIM+M+SG
zoonitozinho	zoonito+N+DIM+M+SG
zoonitos	zoonito+N+M+PL
zoonito	zoonito+N+M+SG
zoonomiazinhas	zoonomia+N+DIM+F+PL
zoonominhas	zoonomia+N+DIM+F+PL
zoonomiazinha	zoonomia+N+DIM+F+SG
zoonominha	zoonomia+N+DIM+F+SG
zoonomias	zoonomia+N+F+PL
zoonomia	zoonomia+N+F+SG
zoonomicidadezinhas	zoonomicidade+N+DIM+F+PL
zoonomicidadinhas	zoonomicidade+N+DIM+F+PL
zoonomicidadezinha	zoonomicidade+N+DIM+F+SG
zoonomicidadinha	zoonomicidade+N+DIM+F+SG
zoonomicidades	zoonomicidade+N+F+PL
zoonomicidade	zoonomicidade+N+F+SG
zoonosezinhas	zoonose+N+DIM+F+PL
zoonosinhas	zoonose+N+DIM+F+PL
zoonosezinha	zoonose+N+DIM+F+SG
zoonosinha	zoonose+N+DIM+F+SG
zoonoses	zoonose+N+F+PL
zoonose	zoonose+N+F+SG
zoonosiazinhas	zoonosia+N+DIM+F+PL
zoonosinhas	zoonosia+N+DIM+F+PL
zoonosiazinha	zoonosia+N+DIM+F+SG
zoonosinha	zoonosia+N+DIM+F+SG
zoonosias	zoonosia+N+F+PL
zoonosia	zoonosia+N+F+SG
zoonosologiazinhas	zoonosologia+N+DIM+F+PL
zoonosologinhas	zoonosologia+N+DIM+F+PL
zoonosologiazinha	zoonosologia+N+DIM+F+SG
zoonosologinha	zoonosologia+N+DIM+F+SG
zoonosologias	zoonosologia+N+F+PL
zoonosologia	zoonosologia+N+F+SG
zoonosologicidadezinhas	zoonosologicidade+N+DIM+F+PL
zoonosologicidadinhas	zoonosologicidade+N+DIM+F+PL
zoonosologicidadezinha	zoonosologicidade+N+DIM+F+SG
zoonosologicidadinha	zoonosologicidade+N+DIM+F+SG
zoonosologicidades	zoonosologicidade+N+F+PL
zoonosologicidade	zoonosologicidade+N+F+SG
zoontezinhos	zoonte+N+DIM+M+PL
zoontinhos	zoonte+N+DIM+M+PL
zoontezinho	zoonte+N+DIM+M+SG
zoontinho	zoonte+N+DIM+M+SG
zoontes	zoonte+N+M+PL
zoonte	zoonte+N+M+SG
zoonimiazinhas	zoonímia+N+DIM+F+PL
zooniminhas	zoonímia+N+DIM+F+PL
zoonimiazinha	zoonímia+N+DIM+F+SG
zooniminha	zoonímia+N+DIM+F+SG
zoonímias	zoonímia+N+F+PL
zoonímia	zoonímia+N+F+SG
zooparasitazinhos	zooparasita+N+DIM+M+PL
zooparasitinhas	zooparasita+N+DIM+M+PL
zooparasitazinho	zooparasita+N+DIM+M+SG
zooparasitinha	zooparasita+N+DIM+M+SG
zooparasitas	zooparasita+N+M+PL
zooparasita	zooparasita+N+M+SG
zooparasitinhos	zooparasito+N+DIM+M+PL
zooparasitozinhos	zooparasito+N+DIM+M+PL
zooparasitinho	zooparasito+N+DIM+M+SG
zooparasitozinho	zooparasito+N+DIM+M+SG
zooparasitos	zooparasito+N+M+PL
zooparasito	zooparasito+N+M+SG
zoopatiazinhas	zoopatia+N+DIM+F+PL
zoopatinhas	zoopatia+N+DIM+F+PL
zoopatiazinha	zoopatia+N+DIM+F+SG
zoopatinha	zoopatia+N+DIM+F+SG
zoopatias	zoopatia+N+F+PL
zoopatia	zoopatia+N+F+SG
zoopatologiazinhas	zoopatologia+N+DIM+F+PL
zoopatologinhas	zoopatologia+N+DIM+F+PL
zoopatologiazinha	zoopatologia+N+DIM+F+SG
zoopatologinha	zoopatologia+N+DIM+F+SG
zoopatologias	zoopatologia+N+F+PL
zoopatologia	zoopatologia+N+F+SG
zoopatologicidadezinhas	zoopatologicidade+N+DIM+F+PL
zoopatologicidadinhas	zoopatologicidade+N+DIM+F+PL
zoopatologicidadezinha	zoopatologicidade+N+DIM+F+SG
zoopatologicidadinha	zoopatologicidade+N+DIM+F+SG
zoopatologicidades	zoopatologicidade+N+F+PL
zoopatologicidade	zoopatologicidade+N+F+SG
zoopediazinhas	zoopedia+N+DIM+F+PL
zoopedinhas	zoopedia+N+DIM+F+PL
zoopediazinha	zoopedia+N+DIM+F+SG
zoopedinha	zoopedia+N+DIM+F+SG
zoopedias	zoopedia+N+F+PL
zoopedia	zoopedia+N+F+SG
zooplasmazinhos	zooplasma+N+DIM+M+PL
zooplasminhas	zooplasma+N+DIM+M+PL
zooplasmazinho	zooplasma+N+DIM+M+SG
zooplasminha	zooplasma+N+DIM+M+SG
zooplasmas	zooplasma+N+M+PL
zooplasma	zooplasma+N+M+SG
zooplastiazinhas	zooplastia+N+DIM+F+PL
zooplastinhas	zooplastia+N+DIM+F+PL
zooplastiazinha	zooplastia+N+DIM+F+SG
zooplastinha	zooplastia+N+DIM+F+SG
zooplastias	zooplastia+N+F+PL
zooplastia	zooplastia+N+F+SG
zooplanctonzinhos	zooplâncton+N+DIM+M+PL
zooplanctonzinho	zooplâncton+N+DIM+M+SG
zooplânctons	zooplâncton+N+M+PL
zooplâncton	zooplâncton+N+M+SG
zooporocistezinhas	zooporociste+N+DIM+F+PL
zooporocistinhas	zooporociste+N+DIM+F+PL
zooporocistezinha	zooporociste+N+DIM+F+SG
zooporocistinha	zooporociste+N+DIM+F+SG
zooporocistes	zooporociste+N+F+PL
zooporociste	zooporociste+N+F+SG
zoopsiazinhas	zoopsia+N+DIM+F+PL
zoopsinhas	zoopsia+N+DIM+F+PL
zoopsiazinha	zoopsia+N+DIM+F+SG
zoopsinha	zoopsia+N+DIM+F+SG
zoopsias	zoopsia+N+F+PL
zoopsia	zoopsia+N+F+SG
zoopticidadezinhas	zoopticidade+N+DIM+F+PL
zoopticidadinhas	zoopticidade+N+DIM+F+PL
zoopticidadezinha	zoopticidade+N+DIM+F+SG
zoopticidadinha	zoopticidade+N+DIM+F+SG
zoopticidades	zoopticidade+N+F+PL
zoopticidade	zoopticidade+N+F+SG
zooponicazinhas	zoopónica+N+DIM+F+PL
zooponiquinhas	zoopónica+N+DIM+F+PL
zooponicazinha	zoopónica+N+DIM+F+SG
zooponiquinha	zoopónica+N+DIM+F+SG
zoopónicas	zoopónica+N+F+PL
zoopónica	zoopónica+N+F+SG
zooponicazinhas	zoopônica+N+DIM+F+PL
zooponiquinhas	zoopônica+N+DIM+F+PL
zooponicazinha	zoopônica+N+DIM+F+SG
zooponiquinha	zoopônica+N+DIM+F+SG
zoopônicas	zoopônica+N+F+PL
zoopônica	zoopônica+N+F+SG
zooquimicazinhas	zooquímica+N+DIM+F+PL
zooquimiquinhas	zooquímica+N+DIM+F+PL
zooquimicazinha	zooquímica+N+DIM+F+SG
zooquimiquinha	zooquímica+N+DIM+F+SG
zooquímicas	zooquímica+N+F+PL
zooquímica	zooquímica+N+F+SG
zooscopiazinhas	zooscopia+N+DIM+F+PL
zooscopinhas	zooscopia+N+DIM+F+PL
zooscopiazinha	zooscopia+N+DIM+F+SG
zooscopinha	zooscopia+N+DIM+F+SG
zooscopias	zooscopia+N+F+PL
zooscopia	zooscopia+N+F+SG
zooscopicidadezinhas	zooscopicidade+N+DIM+F+PL
zooscopicidadinhas	zooscopicidade+N+DIM+F+PL
zooscopicidadezinha	zooscopicidade+N+DIM+F+SG
zooscopicidadinha	zooscopicidade+N+DIM+F+SG
zooscopicidades	zooscopicidade+N+F+PL
zooscopicidade	zooscopicidade+N+F+SG
zoosezinhas	zoose+N+DIM+F+PL
zoosinhas	zoose+N+DIM+F+PL
zoosezinha	zoose+N+DIM+F+SG
zoosinha	zoose+N+DIM+F+SG
zooses	zoose+N+F+PL
zoose	zoose+N+F+SG
zoospermazinhos	zoosperma+N+DIM+M+PL
zoosperminhas	zoosperma+N+DIM+M+PL
zoospermazinho	zoosperma+N+DIM+M+SG
zoosperminha	zoosperma+N+DIM+M+SG
zoospermas	zoosperma+N+M+PL
zoosperma	zoosperma+N+M+SG
zoospermiazinhas	zoospermia+N+DIM+F+PL
zoosperminhas	zoospermia+N+DIM+F+PL
zoospermiazinha	zoospermia+N+DIM+F+SG
zoosperminha	zoospermia+N+DIM+F+SG
zoospermias	zoospermia+N+F+PL
zoospermia	zoospermia+N+F+SG
zoosporicidadezinhas	zoosporicidade+N+DIM+F+PL
zoosporicidadinhas	zoosporicidade+N+DIM+F+PL
zoosporicidadezinha	zoosporicidade+N+DIM+F+SG
zoosporicidadinha	zoosporicidade+N+DIM+F+SG
zoosporicidades	zoosporicidade+N+F+PL
zoosporicidade	zoosporicidade+N+F+SG
zoosporanginhos	zoosporângio+N+DIM+M+PL
zoosporangiozinhos	zoosporângio+N+DIM+M+PL
zoosporanginho	zoosporângio+N+DIM+M+SG
zoosporangiozinho	zoosporângio+N+DIM+M+SG
zoosporângios	zoosporângio+N+M+PL
zoosporângio	zoosporângio+N+M+SG
zoosporinhos	zoospório+N+DIM+M+PL
zoosporiozinhos	zoospório+N+DIM+M+PL
zoosporinho	zoospório+N+DIM+M+SG
zoosporiozinho	zoospório+N+DIM+M+SG
zoospórios	zoospório+N+M+PL
zoospório	zoospório+N+M+SG
zootacticidadezinhas	zootacticidade+N+DIM+F+PL
zootacticidadinhas	zootacticidade+N+DIM+F+PL
zootacticidadezinha	zootacticidade+N+DIM+F+SG
zootacticidadinha	zootacticidade+N+DIM+F+SG
zootacticidades	zootacticidade+N+F+PL
zootacticidade	zootacticidade+N+F+SG
zootaticidadezinhas	zootaticidade+N+DIM+F+PL
zootaticidadinhas	zootaticidade+N+DIM+F+PL
zootaticidadezinha	zootaticidade+N+DIM+F+SG
zootaticidadinha	zootaticidade+N+DIM+F+SG
zootaticidades	zootaticidade+N+F+PL
zootaticidade	zootaticidade+N+F+SG
zootaxiazinhas	zootaxia+N+DIM+F+PL
zootaxinhas	zootaxia+N+DIM+F+PL
zootaxiazinha	zootaxia+N+DIM+F+SG
zootaxinha	zootaxia+N+DIM+F+SG
zootaxias	zootaxia+N+F+PL
zootaxia	zootaxia+N+F+SG
zootaxicidadezinhas	zootaxicidade+N+DIM+F+PL
zootaxicidadinhas	zootaxicidade+N+DIM+F+PL
zootaxicidadezinha	zootaxicidade+N+DIM+F+SG
zootaxicidadinha	zootaxicidade+N+DIM+F+SG
zootaxicidades	zootaxicidade+N+F+PL
zootaxicidade	zootaxicidade+N+F+SG
zootecazinhas	zooteca+N+DIM+F+PL
zootequinhas	zooteca+N+DIM+F+PL
zootecazinha	zooteca+N+DIM+F+SG
zootequinha	zooteca+N+DIM+F+SG
zootecas	zooteca+N+F+PL
zooteca	zooteca+N+F+SG
zootecniazinhas	zootecnia+N+DIM+F+PL
zootecninhas	zootecnia+N+DIM+F+PL
zootecniazinha	zootecnia+N+DIM+F+SG
zootecninha	zootecnia+N+DIM+F+SG
zootecnias	zootecnia+N+F+PL
zootecnia	zootecnia+N+F+SG
zootecnicidadezinhas	zootecnicidade+N+DIM+F+PL
zootecnicidadinhas	zootecnicidade+N+DIM+F+PL
zootecnicidadezinha	zootecnicidade+N+DIM+F+SG
zootecnicidadinha	zootecnicidade+N+DIM+F+SG
zootecnicidades	zootecnicidade+N+F+PL
zootecnicidade	zootecnicidade+N+F+SG
zootecnistazinhas	zootecnista+N+DIM+F+PL
zootecnistazinha	zootecnista+N+DIM+F+SG
zootecnistazinhos	zootecnista+N+DIM+M+PL
zootecnistazinho	zootecnista+N+DIM+M+SG
zootecnistinhas	zootecnista+N+DIM+PL
zootecnistinha	zootecnista+N+DIM+SG
zootecnistas	zootecnista+N+PL
zootecnista	zootecnista+N+SG
zooterapiazinhas	zooterapia+N+DIM+F+PL
zooterapinhas	zooterapia+N+DIM+F+PL
zooterapiazinha	zooterapia+N+DIM+F+SG
zooterapinha	zooterapia+N+DIM+F+SG
zooterapias	zooterapia+N+F+PL
zooterapia	zooterapia+N+F+SG
zooterapicidadezinhas	zooterapicidade+N+DIM+F+PL
zooterapicidadinhas	zooterapicidade+N+DIM+F+PL
zooterapicidadezinha	zooterapicidade+N+DIM+F+SG
zooterapicidadinha	zooterapicidade+N+DIM+F+SG
zooterapicidades	zooterapicidade+N+F+PL
zooterapicidade	zooterapicidade+N+F+SG
zooterapeuticazinhas	zooterapêutica+N+DIM+F+PL
zooterapeutiquinhas	zooterapêutica+N+DIM+F+PL
zooterapeuticazinha	zooterapêutica+N+DIM+F+SG
zooterapeutiquinha	zooterapêutica+N+DIM+F+SG
zooterapêuticas	zooterapêutica+N+F+PL
zooterapêutica	zooterapêutica+N+F+SG
zooticidadezinhas	zooticidade+N+DIM+F+PL
zooticidadinhas	zooticidade+N+DIM+F+PL
zooticidadezinha	zooticidade+N+DIM+F+SG
zooticidadinha	zooticidade+N+DIM+F+SG
zooticidades	zooticidade+N+F+PL
zooticidade	zooticidade+N+F+SG
zootipolitinhos	zootipólito+N+DIM+M+PL
zootipolitozinhos	zootipólito+N+DIM+M+PL
zootipolitinho	zootipólito+N+DIM+M+SG
zootipolitozinho	zootipólito+N+DIM+M+SG
zootipólitos	zootipólito+N+M+PL
zootipólito	zootipólito+N+M+SG
zootomiazinhas	zootomia+N+DIM+F+PL
zootominhas	zootomia+N+DIM+F+PL
zootomiazinha	zootomia+N+DIM+F+SG
zootominha	zootomia+N+DIM+F+SG
zootomias	zootomia+N+F+PL
zootomia	zootomia+N+F+SG
zootomicidadezinhas	zootomicidade+N+DIM+F+PL
zootomicidadinhas	zootomicidade+N+DIM+F+PL
zootomicidadezinha	zootomicidade+N+DIM+F+SG
zootomicidadinha	zootomicidade+N+DIM+F+SG
zootomicidades	zootomicidade+N+F+PL
zootomicidade	zootomicidade+N+F+SG
zootomistazinhas	zootomista+N+DIM+F+PL
zootomistazinha	zootomista+N+DIM+F+SG
zootomistazinhos	zootomista+N+DIM+M+PL
zootomistazinho	zootomista+N+DIM+M+SG
zootomistinhas	zootomista+N+DIM+PL
zootomistinha	zootomista+N+DIM+SG
zootomistas	zootomista+N+PL
zootomista	zootomista+N+SG
zootropiazinhas	zootropia+N+DIM+F+PL
zootropinhas	zootropia+N+DIM+F+PL
zootropiazinha	zootropia+N+DIM+F+SG
zootropinha	zootropia+N+DIM+F+SG
zootropias	zootropia+N+F+PL
zootropia	zootropia+N+F+SG
zootropinhos	zootrópio+N+DIM+M+PL
zootropiozinhos	zootrópio+N+DIM+M+PL
zootropinho	zootrópio+N+DIM+M+SG
zootropiozinho	zootrópio+N+DIM+M+SG
zootrópios	zootrópio+N+M+PL
zootrópio	zootrópio+N+M+SG
zooxantelazinhas	zooxantela+N+DIM+F+PL
zooxantelinhas	zooxantela+N+DIM+F+PL
zooxantelazinha	zooxantela+N+DIM+F+SG
zooxantelinha	zooxantela+N+DIM+F+SG
zooxantelas	zooxantela+N+F+PL
zooxantela	zooxantela+N+F+SG
zooeticazinhas	zooética+N+DIM+F+PL
zooetiquinhas	zooética+N+DIM+F+PL
zooeticazinha	zooética+N+DIM+F+SG
zooetiquinha	zooética+N+DIM+F+SG
zooéticas	zooética+N+F+PL
zooética	zooética+N+F+SG
zopeirazinhas	zopeiro+N+DIM+F+PL
zopeirinhas	zopeiro+N+DIM+F+PL
zopeirazinha	zopeiro+N+DIM+F+SG
zopeirinha	zopeiro+N+DIM+F+SG
zopeirinhos	zopeiro+N+DIM+M+PL
zopeirozinhos	zopeiro+N+DIM+M+PL
zopeirinho	zopeiro+N+DIM+M+SG
zopeirozinho	zopeiro+N+DIM+M+SG
zopeiras	zopeiro+N+F+PL
zopeira	zopeiro+N+F+SG
zopeiros	zopeiro+N+M+PL
zopeiro	zopeiro+N+M+SG
zopazinhas	zopo+N+DIM+F+PL
zopinhas	zopo+N+DIM+F+PL
zopazinha	zopo+N+DIM+F+SG
zopinha	zopo+N+DIM+F+SG
zopinhos	zopo+N+DIM+M+PL
zopozinhos	zopo+N+DIM+M+PL
zopinho	zopo+N+DIM+M+SG
zopozinho	zopo+N+DIM+M+SG
zopas	zopo+N+F+PL
zopa	zopo+N+F+SG
zopos	zopo+N+M+PL
zopo	zopo+N+M+SG
zoratezinhas	zorate+N+DIM+F+PL
zoratinhas	zorate+N+DIM+F+PL
zoratezinha	zorate+N+DIM+F+SG
zoratinha	zorate+N+DIM+F+SG
zoratezinhos	zorate+N+DIM+M+PL
zoratinhos	zorate+N+DIM+M+PL
zoratezinho	zorate+N+DIM+M+SG
zoratinho	zorate+N+DIM+M+SG
zorates	zorate+N+PL
zorate	zorate+N+SG
zoratazinhas	zorato+N+DIM+F+PL
zoratinhas	zorato+N+DIM+F+PL
zoratazinha	zorato+N+DIM+F+SG
zoratinha	zorato+N+DIM+F+SG
zoratinhos	zorato+N+DIM+M+PL
zoratozinhos	zorato+N+DIM+M+PL
zoratinho	zorato+N+DIM+M+SG
zoratozinho	zorato+N+DIM+M+SG
zoratas	zorato+N+F+PL
zorata	zorato+N+F+SG
zoratos	zorato+N+M+PL
zorato	zorato+N+M+SG
zorlitazinhas	zorlito+N+DIM+F+PL
zorlitinhas	zorlito+N+DIM+F+PL
zorlitazinha	zorlito+N+DIM+F+SG
zorlitinha	zorlito+N+DIM+F+SG
zorlitinhos	zorlito+N+DIM+M+PL
zorlitozinhos	zorlito+N+DIM+M+PL
zorlitinho	zorlito+N+DIM+M+SG
zorlitozinho	zorlito+N+DIM+M+SG
zorlitas	zorlito+N+F+PL
zorlita	zorlito+N+F+SG
zorlitos	zorlito+N+M+PL
zorlito	zorlito+N+M+SG
zornaizinhos	zornal+N+DIM+M+PL
zornalzinho	zornal+N+DIM+M+SG
zornais	zornal+N+M+PL
zornal	zornal+N+M+SG
zoroastricidadezinhas	zoroastricidade+N+DIM+F+PL
zoroastricidadinhas	zoroastricidade+N+DIM+F+PL
zoroastricidadezinha	zoroastricidade+N+DIM+F+SG
zoroastricidadinha	zoroastricidade+N+DIM+F+SG
zoroastricidades	zoroastricidade+N+F+PL
zoroastricidade	zoroastricidade+N+F+SG
zoroastrisminhos	zoroastrismo+N+DIM+M+PL
zoroastrismozinhos	zoroastrismo+N+DIM+M+PL
zoroastrisminho	zoroastrismo+N+DIM+M+SG
zoroastrismozinho	zoroastrismo+N+DIM+M+SG
zoroastrismos	zoroastrismo+N+M+PL
zoroastrismo	zoroastrismo+N+M+SG
zoroastristazinhas	zoroastrista+N+DIM+F+PL
zoroastristazinha	zoroastrista+N+DIM+F+SG
zoroastristazinhos	zoroastrista+N+DIM+M+PL
zoroastristazinho	zoroastrista+N+DIM+M+SG
zoroastristinhas	zoroastrista+N+DIM+PL
zoroastristinha	zoroastrista+N+DIM+SG
zoroastristas	zoroastrista+N+PL
zoroastrista	zoroastrista+N+SG
zorongozinhos	zorongo+N+DIM+M+PL
zoronguinhos	zorongo+N+DIM+M+PL
zorongozinho	zorongo+N+DIM+M+SG
zoronguinho	zorongo+N+DIM+M+SG
zorongos	zorongo+N+M+PL
zorongo	zorongo+N+M+SG
zorrazinhas	zorra+N+DIM+F+PL
zorrinhas	zorra+N+DIM+F+PL
zorrazinha	zorra+N+DIM+F+SG
zorrinha	zorra+N+DIM+F+SG
zorras	zorra+N+F+PL
zorra	zorra+N+F+SG
zorrachazinhas	zorracha+N+DIM+F+PL
zorrachinhas	zorracha+N+DIM+F+PL
zorrachazinha	zorracha+N+DIM+F+SG
zorrachinha	zorracha+N+DIM+F+SG
zorrachas	zorracha+N+F+PL
zorracha	zorracha+N+F+SG
zorraguezinhos	zorrague+N+DIM+M+PL
zorraguinhos	zorrague+N+DIM+M+PL
zorraguezinho	zorrague+N+DIM+M+SG
zorraguinho	zorrague+N+DIM+M+SG
zorragues	zorrague+N+M+PL
zorrague	zorrague+N+M+SG
zorraizinhos	zorral+N+DIM+M+PL
zorralzinho	zorral+N+DIM+M+SG
zorrais	zorral+N+M+PL
zorral	zorral+N+M+SG
zorreirazinhas	zorreira+N+DIM+F+PL
zorreirinhas	zorreira+N+DIM+F+PL
zorreirazinha	zorreira+N+DIM+F+SG
zorreirinha	zorreira+N+DIM+F+SG
zorreiras	zorreira+N+F+PL
zorreira	zorreira+N+F+SG
zorrilhinhos	zorrilho+N+DIM+M+PL
zorrilhozinhos	zorrilho+N+DIM+M+PL
zorrilhinho	zorrilho+N+DIM+M+SG
zorrilhozinho	zorrilho+N+DIM+M+SG
zorrilhos	zorrilho+N+M+PL
zorrilho	zorrilho+N+M+SG
zorrazinhas	zorro+N+DIM+F+PL
zorrinhas	zorro+N+DIM+F+PL
zorrazinha	zorro+N+DIM+F+SG
zorrinha	zorro+N+DIM+F+SG
zorrinhos	zorro+N+DIM+M+PL
zorrozinhos	zorro+N+DIM+M+PL
zorrinho	zorro+N+DIM+M+SG
zorrozinho	zorro+N+DIM+M+SG
zorras	zorro+N+F+PL
zorra	zorro+N+F+SG
zorros	zorro+N+M+PL
zorro	zorro+N+M+SG
zorronazinhas	zorrão+N+DIM+F+PL
zorroninhas	zorrão+N+DIM+F+PL
zorronazinha	zorrão+N+DIM+F+SG
zorroninha	zorrão+N+DIM+F+SG
zorrõezinhos	zorrão+N+DIM+M+PL
zorrãozinho	zorrão+N+DIM+M+SG
zorronas	zorrão+N+F+PL
zorrona	zorrão+N+F+SG
zorrões	zorrão+N+M+PL
zorrão	zorrão+N+M+SG
zorzaizinhos	zorzal+N+DIM+M+PL
zorzalzinho	zorzal+N+DIM+M+SG
zorzais	zorzal+N+M+PL
zorzal	zorzal+N+M+SG
zosterzinho	zoster+N+DIM+M+SG
zoster	zoster+N+M+SG
zosterazinhas	zostera+N+DIM+F+PL
zosterinhas	zostera+N+DIM+F+PL
zosterazinha	zostera+N+DIM+F+SG
zosterinha	zostera+N+DIM+F+SG
zosteras	zostera+N+F+PL
zostera	zostera+N+F+SG
zosteraceazinhas	zosterácea+N+DIM+F+PL
zosteraceinhas	zosterácea+N+DIM+F+PL
zosteraceazinha	zosterácea+N+DIM+F+SG
zosteraceinha	zosterácea+N+DIM+F+SG
zosteráceas	zosterácea+N+F+PL
zosterácea	zosterácea+N+F+SG
zotezinhas	zote+N+DIM+F+PL
zotinhas	zote+N+DIM+F+PL
zotezinha	zote+N+DIM+F+SG
zotinha	zote+N+DIM+F+SG
zotezinhos	zote+N+DIM+M+PL
zotinhos	zote+N+DIM+M+PL
zotezinho	zote+N+DIM+M+SG
zotinho	zote+N+DIM+M+SG
zotes	zote+N+PL
zote	zote+N+SG
zotecazinhas	zoteca+N+DIM+F+PL
zotequinhas	zoteca+N+DIM+F+PL
zotecazinha	zoteca+N+DIM+F+SG
zotequinha	zoteca+N+DIM+F+SG
zotecas	zoteca+N+F+PL
zoteca	zoteca+N+F+SG
zotisminhos	zotismo+N+DIM+M+PL
zotismozinhos	zotismo+N+DIM+M+PL
zotisminho	zotismo+N+DIM+M+SG
zotismozinho	zotismo+N+DIM+M+SG
zotismos	zotismo+N+M+PL
zotismo	zotismo+N+M+SG
zoupeirazinhas	zoupeira+N+DIM+F+PL
zoupeirinhas	zoupeira+N+DIM+F+PL
zoupeirazinha	zoupeira+N+DIM+F+SG
zoupeirinha	zoupeira+N+DIM+F+SG
zoupeiras	zoupeira+N+F+PL
zoupeira	zoupeira+N+F+SG
zoupeirinhos	zoupeiro+N+DIM+M+PL
zoupeirozinhos	zoupeiro+N+DIM+M+PL
zoupeirinho	zoupeiro+N+DIM+M+SG
zoupeirozinho	zoupeiro+N+DIM+M+SG
zoupeiros	zoupeiro+N+M+PL
zoupeiro	zoupeiro+N+M+SG
zoupazinhas	zoupo+N+DIM+F+PL
zoupinhas	zoupo+N+DIM+F+PL
zoupazinha	zoupo+N+DIM+F+SG
zoupinha	zoupo+N+DIM+F+SG
zoupinhos	zoupo+N+DIM+M+PL
zoupozinhos	zoupo+N+DIM+M+PL
zoupinho	zoupo+N+DIM+M+SG
zoupozinho	zoupo+N+DIM+M+SG
zoupas	zoupo+N+F+PL
zoupa	zoupo+N+F+SG
zoupos	zoupo+N+M+PL
zoupo	zoupo+N+M+SG
zouvineirazinhas	zouvineiro+N+DIM+F+PL
zouvineirinhas	zouvineiro+N+DIM+F+PL
zouvineirazinha	zouvineiro+N+DIM+F+SG
zouvineirinha	zouvineiro+N+DIM+F+SG
zouvineirinhos	zouvineiro+N+DIM+M+PL
zouvineirozinhos	zouvineiro+N+DIM+M+PL
zouvineirinho	zouvineiro+N+DIM+M+SG
zouvineirozinho	zouvineiro+N+DIM+M+SG
zouvineiras	zouvineiro+N+F+PL
zouvineira	zouvineiro+N+F+SG
zouvineiros	zouvineiro+N+M+PL
zouvineiro	zouvineiro+N+M+SG
zovinhos	zovo+N+DIM+M+PL
zovozinhos	zovo+N+DIM+M+PL
zovinho	zovo+N+DIM+M+SG
zovozinho	zovo+N+DIM+M+SG
zovos	zovo+N+M+PL
zovo	zovo+N+M+SG
zoxazolaminazinhas	zoxazolamina+N+DIM+F+PL
zoxazolamininhas	zoxazolamina+N+DIM+F+PL
zoxazolaminazinha	zoxazolamina+N+DIM+F+SG
zoxazolamininha	zoxazolamina+N+DIM+F+SG
zoxazolaminas	zoxazolamina+N+F+PL
zoxazolamina	zoxazolamina+N+F+SG
zoarinhos	zoário+N+DIM+M+PL
zoariozinhos	zoário+N+DIM+M+PL
zoarinho	zoário+N+DIM+M+SG
zoariozinho	zoário+N+DIM+M+SG
zoários	zoário+N+M+PL
zoário	zoário+N+M+SG
zoeciazinhas	zoécia+N+DIM+F+PL
zoecinhas	zoécia+N+DIM+F+PL
zoeciazinha	zoécia+N+DIM+F+SG
zoecinha	zoécia+N+DIM+F+SG
zoécias	zoécia+N+F+PL
zoécia	zoécia+N+F+SG
zoecinhos	zoécio+N+DIM+M+PL
zoeciozinhos	zoécio+N+DIM+M+PL
zoecinho	zoécio+N+DIM+M+SG
zoeciozinho	zoécio+N+DIM+M+SG
zoécios	zoécio+N+M+PL
zoécio	zoécio+N+M+SG
zoisminhos	zoísmo+N+DIM+M+PL
zoismozinhos	zoísmo+N+DIM+M+PL
zoisminho	zoísmo+N+DIM+M+SG
zoismozinho	zoísmo+N+DIM+M+SG
zoísmos	zoísmo+N+M+PL
zoísmo	zoísmo+N+M+SG
zoofilazinhas	zoófilo+N+DIM+F+PL
zoofilinhas	zoófilo+N+DIM+F+PL
zoofilazinha	zoófilo+N+DIM+F+SG
zoofilinha	zoófilo+N+DIM+F+SG
zoofilinhos	zoófilo+N+DIM+M+PL
zoofilozinhos	zoófilo+N+DIM+M+PL
zoofilinho	zoófilo+N+DIM+M+SG
zoofilozinho	zoófilo+N+DIM+M+SG
zoófilas	zoófilo+N+F+PL
zoófila	zoófilo+N+F+SG
zoófilos	zoófilo+N+M+PL
zoófilo	zoófilo+N+M+SG
zoofitazinhas	zoófito+N+DIM+F+PL
zoofitinhas	zoófito+N+DIM+F+PL
zoofitazinha	zoófito+N+DIM+F+SG
zoofitinha	zoófito+N+DIM+F+SG
zoofitinhos	zoófito+N+DIM+M+PL
zoofitozinhos	zoófito+N+DIM+M+PL
zoofitinho	zoófito+N+DIM+M+SG
zoofitozinho	zoófito+N+DIM+M+SG
zoófitas	zoófito+N+F+PL
zoófita	zoófito+N+F+SG
zoófitos	zoófito+N+M+PL
zoófito	zoófito+N+M+SG
zooforinhos	zoóforo+N+DIM+M+PL
zooforozinhos	zoóforo+N+DIM+M+PL
zooforinho	zoóforo+N+DIM+M+SG
zooforozinho	zoóforo+N+DIM+M+SG
zoóforos	zoóforo+N+M+PL
zoóforo	zoóforo+N+M+SG
zoografazinhas	zoógrafo+N+DIM+F+PL
zoografinhas	zoógrafo+N+DIM+F+PL
zoografazinha	zoógrafo+N+DIM+F+SG
zoografinha	zoógrafo+N+DIM+F+SG
zoografinhos	zoógrafo+N+DIM+M+PL
zoografozinhos	zoógrafo+N+DIM+M+PL
zoografinho	zoógrafo+N+DIM+M+SG
zoografozinho	zoógrafo+N+DIM+M+SG
zoógrafas	zoógrafo+N+F+PL
zoógrafa	zoógrafo+N+F+SG
zoógrafos	zoógrafo+N+M+PL
zoógrafo	zoógrafo+N+M+SG
zooidezinhos	zoóide+N+DIM+M+PL
zooidinhos	zoóide+N+DIM+M+PL
zooidezinho	zoóide+N+DIM+M+SG
zooidinho	zoóide+N+DIM+M+SG
zoóides	zoóide+N+M+PL
zoóide	zoóide+N+M+SG
zoolatrazinhas	zoólatra+N+DIM+F+PL
zoolatrazinha	zoólatra+N+DIM+F+SG
zoolatrazinhos	zoólatra+N+DIM+M+PL
zoolatrazinho	zoólatra+N+DIM+M+SG
zoolatrinhas	zoólatra+N+DIM+PL
zoolatrinha	zoólatra+N+DIM+SG
zoólatras	zoólatra+N+PL
zoólatra	zoólatra+N+SG
zoolitinhos	zoólito+N+DIM+M+PL
zoolitozinhos	zoólito+N+DIM+M+PL
zoolitinho	zoólito+N+DIM+M+SG
zoolitozinho	zoólito+N+DIM+M+SG
zoólitos	zoólito+N+M+PL
zoólito	zoólito+N+M+SG
zoologazinhas	zoólogo+N+DIM+F+PL
zoologuinhas	zoólogo+N+DIM+F+PL
zoologazinha	zoólogo+N+DIM+F+SG
zoologuinha	zoólogo+N+DIM+F+SG
zoologozinhos	zoólogo+N+DIM+M+PL
zoologuinhos	zoólogo+N+DIM+M+PL
zoologozinho	zoólogo+N+DIM+M+SG
zoologuinho	zoólogo+N+DIM+M+SG
zoólogas	zoólogo+N+F+PL
zoóloga	zoólogo+N+F+SG
zoólogos	zoólogo+N+M+PL
zoólogo	zoólogo+N+M+SG
zoomaninhos	zoómano+N+DIM+M+PL
zoomanozinhos	zoómano+N+DIM+M+PL
zoomaninho	zoómano+N+DIM+M+SG
zoomanozinho	zoómano+N+DIM+M+SG
zoómanos	zoómano+N+M+PL
zoómano	zoómano+N+M+SG
zooniminhos	zoónimo+N+DIM+M+PL
zoonimozinhos	zoónimo+N+DIM+M+PL
zooniminho	zoónimo+N+DIM+M+SG
zoonimozinho	zoónimo+N+DIM+M+SG
zoónimos	zoónimo+N+M+PL
zoónimo	zoónimo+N+M+SG
zoonominhos	zoónomo+N+DIM+M+PL
zoonomozinhos	zoónomo+N+DIM+M+PL
zoonominho	zoónomo+N+DIM+M+SG
zoonomozinho	zoónomo+N+DIM+M+SG
zoónomos	zoónomo+N+M+PL
zoónomo	zoónomo+N+M+SG
zoosporinhos	zoósporo+N+DIM+M+PL
zoosporozinhos	zoósporo+N+DIM+M+PL
zoosporinho	zoósporo+N+DIM+M+SG
zoosporozinho	zoósporo+N+DIM+M+SG
zoósporos	zoósporo+N+M+PL
zoósporo	zoósporo+N+M+SG
zoomaninhos	zoômano+N+DIM+M+PL
zoomanozinhos	zoômano+N+DIM+M+PL
zoomaninho	zoômano+N+DIM+M+SG
zoomanozinho	zoômano+N+DIM+M+SG
zoômanos	zoômano+N+M+PL
zoômano	zoômano+N+M+SG
zooniminhos	zoônimo+N+DIM+M+PL
zoonimozinhos	zoônimo+N+DIM+M+PL
zooniminho	zoônimo+N+DIM+M+SG
zoonimozinho	zoônimo+N+DIM+M+SG
zoônimos	zoônimo+N+M+PL
zoônimo	zoônimo+N+M+SG
zoonominhos	zoônomo+N+DIM+M+PL
zoonomozinhos	zoônomo+N+DIM+M+PL
zoonominho	zoônomo+N+DIM+M+SG
zoonomozinho	zoônomo+N+DIM+M+SG
zoônomos	zoônomo+N+M+PL
zoônomo	zoônomo+N+M+SG
zuaquezinhos	zuaque+N+DIM+M+PL
zuaquinhos	zuaque+N+DIM+M+PL
zuaquezinho	zuaque+N+DIM+M+SG
zuaquinho	zuaque+N+DIM+M+SG
zuaques	zuaque+N+M+PL
zuaque	zuaque+N+M+SG
zuartezinhos	zuarte+N+DIM+M+PL
zuartinhos	zuarte+N+DIM+M+PL
zuartezinho	zuarte+N+DIM+M+SG
zuartinho	zuarte+N+DIM+M+SG
zuartes	zuarte+N+M+PL
zuarte	zuarte+N+M+SG
zuatezinhos	zuate+N+DIM+M+PL
zuatinhos	zuate+N+DIM+M+PL
zuatezinho	zuate+N+DIM+M+SG
zuatinho	zuate+N+DIM+M+SG
zuates	zuate+N+M+PL
zuate	zuate+N+M+SG
zuavinhos	zuavo+N+DIM+M+PL
zuavozinhos	zuavo+N+DIM+M+PL
zuavinho	zuavo+N+DIM+M+SG
zuavozinho	zuavo+N+DIM+M+SG
zuavos	zuavo+N+M+PL
zuavo	zuavo+N+M+SG
zucazinhas	zuca+N+DIM+F+PL
zucazinha	zuca+N+DIM+F+SG
zucazinhos	zuca+N+DIM+M+PL
zucazinho	zuca+N+DIM+M+SG
zuquinhas	zuca+N+DIM+PL
zuquinha	zuca+N+DIM+SG
zucas	zuca+N+PL
zuca	zuca+N+SG
zuidoirinhos	zuidoiro+N+DIM+M+PL
zuidoirozinhos	zuidoiro+N+DIM+M+PL
zuidoirinho	zuidoiro+N+DIM+M+SG
zuidoirozinho	zuidoiro+N+DIM+M+SG
zuidoiros	zuidoiro+N+M+PL
zuidoiro	zuidoiro+N+M+SG
zuidourinhos	zuidouro+N+DIM+M+PL
zuidourozinhos	zuidouro+N+DIM+M+PL
zuidourinho	zuidouro+N+DIM+M+SG
zuidourozinho	zuidouro+N+DIM+M+SG
zuidouros	zuidouro+N+M+PL
zuidouro	zuidouro+N+M+SG
zuinglianisminhos	zuinglianismo+N+DIM+M+PL
zuinglianismozinhos	zuinglianismo+N+DIM+M+PL
zuinglianisminho	zuinglianismo+N+DIM+M+SG
zuinglianismozinho	zuinglianismo+N+DIM+M+SG
zuinglianismos	zuinglianismo+N+M+PL
zuinglianismo	zuinglianismo+N+M+SG
zuinglianazinhas	zuingliano+N+DIM+F+PL
zuinglianinhas	zuingliano+N+DIM+F+PL
zuinglianazinha	zuingliano+N+DIM+F+SG
zuinglianinha	zuingliano+N+DIM+F+SG
zuinglianinhos	zuingliano+N+DIM+M+PL
zuinglianozinhos	zuingliano+N+DIM+M+PL
zuinglianinho	zuingliano+N+DIM+M+SG
zuinglianozinho	zuingliano+N+DIM+M+SG
zuinglianas	zuingliano+N+F+PL
zuingliana	zuingliano+N+F+SG
zuinglianos	zuingliano+N+M+PL
zuingliano	zuingliano+N+M+SG
zulozinhas	zulo+N+DIM+F+PL
zulozinha	zulo+N+DIM+F+SG
zulozinhos	zulo+N+DIM+M+PL
zulozinho	zulo+N+DIM+M+SG
zulinhos	zulo+N+DIM+PL
zulinho	zulo+N+DIM+SG
zulos	zulo+N+PL
zulo	zulo+N+SG
zuluzinhas	zulu+N+DIM+F+PL
zuluzinha	zulu+N+DIM+F+SG
zuluzinhos	zulu+N+DIM+M+PL
zuluzinho	zulu+N+DIM+M+SG
zulus	zulu+N+PL
zulu	zulu+N+SG
zulunidadezinhas	zulunidade+N+DIM+F+PL
zulunidadinhas	zulunidade+N+DIM+F+PL
zulunidadezinha	zulunidade+N+DIM+F+SG
zulunidadinha	zulunidade+N+DIM+F+SG
zulunidades	zulunidade+N+F+PL
zulunidade	zulunidade+N+F+SG
zumbaiazinhas	zumbaia+N+DIM+F+PL
zumbainhas	zumbaia+N+DIM+F+PL
zumbaiazinha	zumbaia+N+DIM+F+SG
zumbainha	zumbaia+N+DIM+F+SG
zumbaias	zumbaia+N+F+PL
zumbaia	zumbaia+N+F+SG
zumbaieirazinhas	zumbaieiro+N+DIM+F+PL
zumbaieirinhas	zumbaieiro+N+DIM+F+PL
zumbaieirazinha	zumbaieiro+N+DIM+F+SG
zumbaieirinha	zumbaieiro+N+DIM+F+SG
zumbaieirinhos	zumbaieiro+N+DIM+M+PL
zumbaieirozinhos	zumbaieiro+N+DIM+M+PL
zumbaieirinho	zumbaieiro+N+DIM+M+SG
zumbaieirozinho	zumbaieiro+N+DIM+M+SG
zumbaieiras	zumbaieiro+N+F+PL
zumbaieira	zumbaieiro+N+F+SG
zumbaieiros	zumbaieiro+N+M+PL
zumbaieiro	zumbaieiro+N+M+SG
zumbizinhos	zumbi+N+DIM+M+PL
zumbizinho	zumbi+N+DIM+M+SG
zumbis	zumbi+N+M+PL
zumbi	zumbi+N+M+SG
zumbidinhos	zumbido+N+DIM+M+PL
zumbidozinhos	zumbido+N+DIM+M+PL
zumbidinho	zumbido+N+DIM+M+SG
zumbidozinho	zumbido+N+DIM+M+SG
zumbidos	zumbido+N+M+PL
zumbido	zumbido+N+M+SG
zumbirzinho	zumbir+N+DIM+M+SG
zumbir	zumbir+N+M+SG
zumbinhos	zumbo+N+DIM+M+PL
zumbozinhos	zumbo+N+DIM+M+PL
zumbinho	zumbo+N+DIM+M+SG
zumbozinho	zumbo+N+DIM+M+SG
zumbos	zumbo+N+M+PL
zumbo	zumbo+N+M+SG
zunazinhas	zuna+N+DIM+F+PL
zuninhas	zuna+N+DIM+F+PL
zunazinha	zuna+N+DIM+F+SG
zuninha	zuna+N+DIM+F+SG
zunas	zuna+N+F+PL
zuna	zuna+N+F+SG
zungatinhos	zungato+N+DIM+M+PL
zungatozinhos	zungato+N+DIM+M+PL
zungatinho	zungato+N+DIM+M+SG
zungatozinho	zungato+N+DIM+M+SG
zungatos	zungato+N+M+PL
zungato	zungato+N+M+SG
zunidazinhas	zunida+N+DIM+F+PL
zunidinhas	zunida+N+DIM+F+PL
zunidazinha	zunida+N+DIM+F+SG
zunidinha	zunida+N+DIM+F+SG
zunidas	zunida+N+F+PL
zunida	zunida+N+F+SG
zunideirazinhas	zunideira+N+DIM+F+PL
zunideirinhas	zunideira+N+DIM+F+PL
zunideirazinha	zunideira+N+DIM+F+SG
zunideirinha	zunideira+N+DIM+F+SG
zunideiras	zunideira+N+F+PL
zunideira	zunideira+N+F+SG
zunidazinhas	zunido+N+DIM+F+PL
zunidinhas	zunido+N+DIM+F+PL
zunidazinha	zunido+N+DIM+F+SG
zunidinha	zunido+N+DIM+F+SG
zunidinhos	zunido+N+DIM+M+PL
zunidozinhos	zunido+N+DIM+M+PL
zunidinho	zunido+N+DIM+M+SG
zunidozinho	zunido+N+DIM+M+SG
zunidas	zunido+N+F+PL
zunida	zunido+N+F+SG
zunidos	zunido+N+M+PL
zunido	zunido+N+M+SG
zunimentinhos	zunimento+N+DIM+M+PL
zunimentozinhos	zunimento+N+DIM+M+PL
zunimentinho	zunimento+N+DIM+M+SG
zunimentozinho	zunimento+N+DIM+M+SG
zunimentos	zunimento+N+M+PL
zunimento	zunimento+N+M+SG
zunzunzinhos	zunzum+N+DIM+M+PL
zunzunzinho	zunzum+N+DIM+M+SG
zunzuns	zunzum+N+M+PL
zunzum	zunzum+N+M+SG
zunzunzunzinhos	zunzunzum+N+DIM+M+PL
zunzunzunzinho	zunzunzum+N+DIM+M+SG
zunzunzuns	zunzunzum+N+M+PL
zunzunzum	zunzunzum+N+M+SG
zupadorazinhas	zupador+N+DIM+F+PL
zupadorinhas	zupador+N+DIM+F+PL
zupadorazinha	zupador+N+DIM+F+SG
zupadorinha	zupador+N+DIM+F+SG
zupadorezinhos	zupador+N+DIM+M+PL
zupadorzinhos	zupador+N+DIM+M+PL
zupadorzinho	zupador+N+DIM+M+SG
zupadoras	zupador+N+F+PL
zupadora	zupador+N+F+SG
zupadores	zupador+N+M+PL
zupador	zupador+N+M+SG
zuraquezinhos	zuraque+N+DIM+M+PL
zuraquinhos	zuraque+N+DIM+M+PL
zuraquezinho	zuraque+N+DIM+M+SG
zuraquinho	zuraque+N+DIM+M+SG
zuraques	zuraque+N+M+PL
zuraque	zuraque+N+M+SG
zurbadazinhas	zurbada+N+DIM+F+PL
zurbadinhas	zurbada+N+DIM+F+PL
zurbadazinha	zurbada+N+DIM+F+SG
zurbadinha	zurbada+N+DIM+F+SG
zurbadas	zurbada+N+F+PL
zurbada	zurbada+N+F+SG
zurcazinhas	zurca+N+DIM+F+PL
zurquinhas	zurca+N+DIM+F+PL
zurcazinha	zurca+N+DIM+F+SG
zurquinha	zurca+N+DIM+F+SG
zurcas	zurca+N+F+PL
zurca	zurca+N+F+SG
zuretazinhas	zureta+N+DIM+F+PL
zuretazinha	zureta+N+DIM+F+SG
zuretazinhos	zureta+N+DIM+M+PL
zuretazinho	zureta+N+DIM+M+SG
zuretinhas	zureta+N+DIM+PL
zuretinha	zureta+N+DIM+SG
zuretas	zureta+N+PL
zureta	zureta+N+SG
zurpazinhas	zurpa+N+DIM+F+PL
zurpinhas	zurpa+N+DIM+F+PL
zurpazinha	zurpa+N+DIM+F+SG
zurpinha	zurpa+N+DIM+F+SG
zurpas	zurpa+N+F+PL
zurpa	zurpa+N+F+SG
zurradazinhas	zurrada+N+DIM+F+PL
zurradinhas	zurrada+N+DIM+F+PL
zurradazinha	zurrada+N+DIM+F+SG
zurradinha	zurrada+N+DIM+F+SG
zurradas	zurrada+N+F+PL
zurrada	zurrada+N+F+SG
zurradorazinhas	zurrador+N+DIM+F+PL
zurradorinhas	zurrador+N+DIM+F+PL
zurradorazinha	zurrador+N+DIM+F+SG
zurradorinha	zurrador+N+DIM+F+SG
zurradorezinhos	zurrador+N+DIM+M+PL
zurradorzinhos	zurrador+N+DIM+M+PL
zurradorzinho	zurrador+N+DIM+M+SG
zurradoras	zurrador+N+F+PL
zurradora	zurrador+N+F+SG
zurradores	zurrador+N+M+PL
zurrador	zurrador+N+M+SG
zurrapazinhas	zurrapa+N+DIM+F+PL
zurrapinhas	zurrapa+N+DIM+F+PL
zurrapazinha	zurrapa+N+DIM+F+SG
zurrapinha	zurrapa+N+DIM+F+SG
zurrapas	zurrapa+N+F+PL
zurrapa	zurrapa+N+F+SG
zurrariazinhas	zurraria+N+DIM+F+PL
zurrarinhas	zurraria+N+DIM+F+PL
zurrariazinha	zurraria+N+DIM+F+SG
zurrarinha	zurraria+N+DIM+F+SG
zurrarias	zurraria+N+F+PL
zurraria	zurraria+N+F+SG
zurrinhos	zurro+N+DIM+M+PL
zurrozinhos	zurro+N+DIM+M+PL
zurrinho	zurro+N+DIM+M+SG
zurrozinho	zurro+N+DIM+M+SG
zurros	zurro+N+M+PL
zurro	zurro+N+M+SG
zurvadazinhas	zurvada+N+DIM+F+PL
zurvadinhas	zurvada+N+DIM+F+PL
zurvadazinha	zurvada+N+DIM+F+SG
zurvadinha	zurvada+N+DIM+F+SG
zurvadas	zurvada+N+F+PL
zurvada	zurvada+N+F+SG
zurvanadazinhas	zurvanada+N+DIM+F+PL
zurvanadinhas	zurvanada+N+DIM+F+PL
zurvanadazinha	zurvanada+N+DIM+F+SG
zurvanadinha	zurvanada+N+DIM+F+SG
zurvanadas	zurvanada+N+F+PL
zurvanada	zurvanada+N+F+SG
zurzazinhas	zurza+N+DIM+F+PL
zurzinhas	zurza+N+DIM+F+PL
zurzazinha	zurza+N+DIM+F+SG
zurzinha	zurza+N+DIM+F+SG
zurzas	zurza+N+F+PL
zurza	zurza+N+F+SG
zurzidelazinhas	zurzidela+N+DIM+F+PL
zurzidelinhas	zurzidela+N+DIM+F+PL
zurzidelazinha	zurzidela+N+DIM+F+SG
zurzidelinha	zurzidela+N+DIM+F+SG
zurzidelas	zurzidela+N+F+PL
zurzidela	zurzidela+N+F+SG
zurzidorazinhas	zurzidor+N+DIM+F+PL
zurzidorinhas	zurzidor+N+DIM+F+PL
zurzidorazinha	zurzidor+N+DIM+F+SG
zurzidorinha	zurzidor+N+DIM+F+SG
zurzidorezinhos	zurzidor+N+DIM+M+PL
zurzidorzinhos	zurzidor+N+DIM+M+PL
zurzidorzinho	zurzidor+N+DIM+M+SG
zurzidoras	zurzidor+N+F+PL
zurzidora	zurzidor+N+F+SG
zurzidores	zurzidor+N+M+PL
zurzidor	zurzidor+N+M+SG
zuidinhos	zuído+N+DIM+M+PL
zuidozinhos	zuído+N+DIM+M+PL
zuidinho	zuído+N+DIM+M+SG
zuidozinho	zuído+N+DIM+M+SG
zuídos	zuído+N+M+PL
zuído	zuído+N+M+SG
zacorinhos	zácoro+N+DIM+M+PL
zacorozinhos	zácoro+N+DIM+M+PL
zacorinho	zácoro+N+DIM+M+SG
zacorozinho	zácoro+N+DIM+M+SG
zácoros	zácoro+N+M+PL
zácoro	zácoro+N+M+SG
zapetezinhos	zápete+N+DIM+M+PL
zapetinhos	zápete+N+DIM+M+PL
zapetezinho	zápete+N+DIM+M+SG
zapetinho	zápete+N+DIM+M+SG
zápetes	zápete+N+M+PL
zápete	zápete+N+M+SG
zamiazinhas	zâmia+N+DIM+F+PL
zaminhas	zâmia+N+DIM+F+PL
zamiazinha	zâmia+N+DIM+F+SG
zaminha	zâmia+N+DIM+F+SG
zâmias	zâmia+N+F+PL
zâmia	zâmia+N+F+SG
zanganinhos	zângano+N+DIM+M+PL
zanganozinhos	zângano+N+DIM+M+PL
zanganinho	zângano+N+DIM+M+SG
zanganozinho	zângano+N+DIM+M+SG
zânganos	zângano+N+M+PL
zângano	zângano+N+M+SG
zangãozinhos	zângão+N+DIM+M+PL
zangõezinhos	zângão+N+DIM+M+PL
zangãozinho	zângão+N+DIM+M+SG
zângãos	zângão+N+M+PL
zângões	zângão+N+M+PL
zângão	zângão+N+M+SG
zantinhos	zântio+N+DIM+M+PL
zantiozinhos	zântio+N+DIM+M+PL
zantinho	zântio+N+DIM+M+SG
zantiozinho	zântio+N+DIM+M+SG
zântios	zântio+N+M+PL
zântio	zântio+N+M+SG
zanzerezinhos	zânzere+N+DIM+M+PL
zanzerinhos	zânzere+N+DIM+M+PL
zanzerzinhos	zânzere+N+DIM+M+PL
zanzerezinho	zânzere+N+DIM+M+SG
zanzerinho	zânzere+N+DIM+M+SG
zânzeres	zânzere+N+M+PL
zânzere	zânzere+N+M+SG
zezinhos	zé+N+DIM+M+PL
zezinho	zé+N+DIM+M+SG
zés	zé+N+M+PL
zé	zé+N+M+SG
zés-dos-anzoizinhos	zé-dos-anzóis+N+DIM+M+PL
zé-dos-anzoisinho	zé-dos-anzóis+N+DIM+M+SG
zés-dos-anzóis	zé-dos-anzóis+N+M+PL
zé-dos-anzóis	zé-dos-anzóis+N+M+SG
zé-marinhas	zé-maria+N+DIM+M+PL
zé-mariazinho	zé-maria+N+DIM+M+SG
zé-marinha	zé-maria+N+DIM+M+SG
zé-maria	zé-maria+N+M+SG
zés-ninguenzinhos	zé-ninguém+N+DIM+M+PL
zé-ninguenzinho	zé-ninguém+N+DIM+M+SG
zés-ninguém	zé-ninguém+N+M+PL
zés-ninguéns	zé-ninguém+N+M+PL
zé-ninguém	zé-ninguém+N+M+SG
zé-pereirazinhos	zé-pereira+N+DIM+M+PL
zé-pereirinhas	zé-pereira+N+DIM+M+PL
zé-pereirazinho	zé-pereira+N+DIM+M+SG
zé-pereirinha	zé-pereira+N+DIM+M+SG
zé-pereiras	zé-pereira+N+M+PL
zé-pereira	zé-pereira+N+M+SG
zé-povinhinhos	zé-povinho+N+DIM+M+PL
zé-povinhozinhos	zé-povinho+N+DIM+M+PL
zé-povinhinho	zé-povinho+N+DIM+M+SG
zé-povinhozinho	zé-povinho+N+DIM+M+SG
zé-povinhos	zé-povinho+N+M+PL
zé-povinho	zé-povinho+N+M+SG
zé-povinhos	zé-povo+N+DIM+M+PL
zé-povozinhos	zé-povo+N+DIM+M+PL
zé-povinho	zé-povo+N+DIM+M+SG
zé-povozinho	zé-povo+N+DIM+M+SG
zé-povos	zé-povo+N+M+PL
zé-povo	zé-povo+N+M+SG
zé-pregosinhas	zé-pregos+N+DIM+F+PL
zé-pregosinhos	zé-pregos+N+DIM+M+PL
zé-pregosinho	zé-pregos+N+DIM+M+SG
zé-pregos	zé-pregos+N+M
zecorazinhas	zécora+N+DIM+F+PL
zecorinhas	zécora+N+DIM+F+PL
zecorazinha	zécora+N+DIM+F+SG
zecorinha	zécora+N+DIM+F+SG
zécoras	zécora+N+F+PL
zécora	zécora+N+F+SG
zefirinhos	zéfiro+N+DIM+M+PL
zefirozinhos	zéfiro+N+DIM+M+PL
zefirinho	zéfiro+N+DIM+M+SG
zefirozinho	zéfiro+N+DIM+M+SG
zéfiros	zéfiro+N+M+PL
zéfiro	zéfiro+N+M+SG
zeidazinhas	zéida+N+DIM+F+PL
zeidinhas	zéida+N+DIM+F+PL
zeidazinha	zéida+N+DIM+F+SG
zeidinha	zéida+N+DIM+F+SG
zéidas	zéida+N+F+PL
zéida	zéida+N+F+SG
zenitezinhos	zénite+N+DIM+M+PL
zenitinhos	zénite+N+DIM+M+PL
zenitezinho	zénite+N+DIM+M+SG
zenitinho	zénite+N+DIM+M+SG
zénites	zénite+N+M+PL
zénite	zénite+N+M+SG
zezinhos	zê+N+DIM+M+PL
zezinho	zê+N+DIM+M+SG
zês	zê+N+M+PL
zê	zê+N+M+SG
zenitezinhos	zênite+N+DIM+M+PL
zenitinhos	zênite+N+DIM+M+PL
zenitezinho	zênite+N+DIM+M+SG
zenitinho	zênite+N+DIM+M+SG
zênites	zênite+N+M+PL
zênite	zênite+N+M+SG
zigniazinhas	zígnia+N+DIM+F+PL
zigninhas	zígnia+N+DIM+F+PL
zigniazinha	zígnia+N+DIM+F+SG
zigninha	zígnia+N+DIM+F+SG
zígnias	zígnia+N+F+PL
zígnia	zígnia+N+F+SG
zimasezinhas	zímase+N+DIM+F+PL
zimasinhas	zímase+N+DIM+F+PL
zimasezinha	zímase+N+DIM+F+SG
zimasinha	zímase+N+DIM+F+SG
zímases	zímase+N+F+PL
zímase	zímase+N+F+SG
zingarazinhas	zíngaro+N+DIM+F+PL
zingarinhas	zíngaro+N+DIM+F+PL
zingarazinha	zíngaro+N+DIM+F+SG
zingarinha	zíngaro+N+DIM+F+SG
zingarinhos	zíngaro+N+DIM+M+PL
zingarozinhos	zíngaro+N+DIM+M+PL
zingarinho	zíngaro+N+DIM+M+SG
zingarozinho	zíngaro+N+DIM+M+SG
zíngaras	zíngaro+N+F+PL
zíngara	zíngaro+N+F+SG
zíngaros	zíngaro+N+M+PL
zíngaro	zíngaro+N+M+SG
ziniazinhas	zínia+N+DIM+F+PL
zininhas	zínia+N+DIM+F+PL
ziniazinha	zínia+N+DIM+F+SG
zininha	zínia+N+DIM+F+SG
zínias	zínia+N+F+PL
zínia	zínia+N+F+SG
ziperezinhos	zíper+N+DIM+M+PL
ziperzinhos	zíper+N+DIM+M+PL
ziperzinho	zíper+N+DIM+M+SG
zíperes	zíper+N+M+PL
zíper	zíper+N+M+SG
zizifinhos	zízifo+N+DIM+M+PL
zizifozinhos	zízifo+N+DIM+M+PL
zizifinho	zízifo+N+DIM+M+SG
zizifozinho	zízifo+N+DIM+M+SG
zízifos	zízifo+N+M+PL
zízifo	zízifo+N+M+SG
zoidezinhos	zóide+N+DIM+M+PL
zoidinhos	zóide+N+DIM+M+PL
zoidezinho	zóide+N+DIM+M+SG
zoidinho	zóide+N+DIM+M+SG
zóides	zóide+N+M+PL
zóide	zóide+N+M+SG
zonulazinhas	zónula+N+DIM+F+PL
zonulinhas	zónula+N+DIM+F+PL
zonulazinha	zónula+N+DIM+F+SG
zonulinha	zónula+N+DIM+F+SG
zónulas	zónula+N+F+PL
zónula	zónula+N+F+SG
zosterezinhos	zóster+N+DIM+M+PL
zosterzinhos	zóster+N+DIM+M+PL
zosterzinho	zóster+N+DIM+M+SG
zósteres	zóster+N+M+PL
zóster	zóster+N+M+SG
zonulazinhas	zônula+N+DIM+F+PL
zonulinhas	zônula+N+DIM+F+PL
zonulazinha	zônula+N+DIM+F+SG
zonulinha	zônula+N+DIM+F+SG
zônulas	zônula+N+F+PL
zônula	zônula+N+F+SG
zoinhos	zôo+N+DIM+M+PL
zoozinhos	zôo+N+DIM+M+PL
zoinho	zôo+N+DIM+M+SG
zoozinho	zôo+N+DIM+M+SG
zôos	zôo+N+M+PL
zôo	zôo+N+M+SG
abacozinhos	ábaco+N+DIM+M+PL
abaquinhos	ábaco+N+DIM+M+PL
abacozinho	ábaco+N+DIM+M+SG
abaquinho	ábaco+N+DIM+M+SG
ábacos	ábaco+N+M+PL
ábaco	ábaco+N+M+SG
abregozinhos	ábrego+N+DIM+M+PL
abreguinhos	ábrego+N+DIM+M+PL
abregozinho	ábrego+N+DIM+M+SG
abreguinho	ábrego+N+DIM+M+SG
ábregos	ábrego+N+M+PL
ábrego	ábrego+N+M+SG
absidezinhas	ábside+N+DIM+F+PL
absidinhas	ábside+N+DIM+F+PL
absidezinha	ábside+N+DIM+F+SG
absidinha	ábside+N+DIM+F+SG
ábsides	ábside+N+F+PL
ábside	ábside+N+F+SG
acarinhos	ácaro+N+DIM+M+PL
acarozinhos	ácaro+N+DIM+M+PL
acarinho	ácaro+N+DIM+M+SG
acarozinho	ácaro+N+DIM+M+SG
ácaros	ácaro+N+M+PL
ácaro	ácaro+N+M+SG
acerinhos	ácero+N+DIM+M+PL
acerozinhos	ácero+N+DIM+M+PL
acerinho	ácero+N+DIM+M+SG
acerozinho	ácero+N+DIM+M+SG
áceros	ácero+N+M+PL
ácero	ácero+N+M+SG
acidazinhas	ácido+N+DIM+F+PL
acidinhas	ácido+N+DIM+F+PL
acidazinha	ácido+N+DIM+F+SG
acidinha	ácido+N+DIM+F+SG
acidinhos	ácido+N+DIM+M+PL
acidozinhos	ácido+N+DIM+M+PL
acidinho	ácido+N+DIM+M+SG
acidozinho	ácido+N+DIM+M+SG
ácidas	ácido+N+F+PL
ácida	ácido+N+F+SG
ácidos	ácido+N+M+PL
ácido	ácido+N+M+SG
acinhas	ácie+N+DIM+F+PL
aciezinha	ácie+N+DIM+F+SG
acinha	ácie+N+DIM+F+SG
ácie	ácie+N+F+SG
acininhos	ácino+N+DIM+M+PL
acinozinhos	ácino+N+DIM+M+PL
acininho	ácino+N+DIM+M+SG
acinozinho	ácino+N+DIM+M+SG
ácinos	ácino+N+M+PL
ácino	ácino+N+M+SG
aclidezinhas	áclide+N+DIM+F+PL
aclidinhas	áclide+N+DIM+F+PL
aclidezinha	áclide+N+DIM+F+SG
aclidinha	áclide+N+DIM+F+SG
áclides	áclide+N+F+PL
áclide	áclide+N+F+SG
acnuazinhas	ácnua+N+DIM+F+PL
acnuinhas	ácnua+N+DIM+F+PL
acnuazinha	ácnua+N+DIM+F+SG
acnuinha	ácnua+N+DIM+F+SG
ácnuas	ácnua+N+F+PL
ácnua	ácnua+N+F+SG
acorinhos	ácoro+N+DIM+M+PL
acorozinhos	ácoro+N+DIM+M+PL
acorinho	ácoro+N+DIM+M+SG
acorozinho	ácoro+N+DIM+M+SG
ácoros	ácoro+N+M+PL
ácoro	ácoro+N+M+SG
acratazinhas	ácrata+N+DIM+F+PL
acratazinha	ácrata+N+DIM+F+SG
acratazinhos	ácrata+N+DIM+M+PL
acratazinho	ácrata+N+DIM+M+SG
acratinhas	ácrata+N+DIM+PL
acratinha	ácrata+N+DIM+SG
ácratas	ácrata+N+PL
ácrata	ácrata+N+SG
adipezinhas	ádipe+N+DIM+F+PL
adipinhas	ádipe+N+DIM+F+PL
adipezinha	ádipe+N+DIM+F+SG
adipinha	ádipe+N+DIM+F+SG
ádipes	ádipe+N+F+PL
ádipe	ádipe+N+F+SG
adipinhos	ádipo+N+DIM+M+PL
adipozinhos	ádipo+N+DIM+M+PL
adipinho	ádipo+N+DIM+M+SG
adipozinho	ádipo+N+DIM+M+SG
ádipos	ádipo+N+M+PL
ádipo	ádipo+N+M+SG
aditinhos	ádito+N+DIM+M+PL
aditozinhos	ádito+N+DIM+M+PL
aditinho	ádito+N+DIM+M+SG
aditozinho	ádito+N+DIM+M+SG
áditos	ádito+N+M+PL
ádito	ádito+N+M+SG
advenazinhas	ádvena+N+DIM+F+PL
advenazinha	ádvena+N+DIM+F+SG
advenazinhos	ádvena+N+DIM+M+PL
advenazinho	ádvena+N+DIM+M+SG
adveninhas	ádvena+N+DIM+PL
adveninha	ádvena+N+DIM+SG
ádvenas	ádvena+N+PL
ádvena	ádvena+N+SG
afidinhos	áfido+N+DIM+M+PL
afidozinhos	áfido+N+DIM+M+PL
afidinho	áfido+N+DIM+M+SG
afidozinho	áfido+N+DIM+M+SG
áfidos	áfido+N+M+PL
áfido	áfido+N+M+SG
africazinhas	áfrica+N+DIM+F+PL
afriquinhas	áfrica+N+DIM+F+PL
africazinha	áfrica+N+DIM+F+SG
afriquinha	áfrica+N+DIM+F+SG
áfricas	áfrica+N+F+PL
áfrica	áfrica+N+F+SG
africazinhas	áfrico+N+DIM+F+PL
afriquinhas	áfrico+N+DIM+F+PL
africazinha	áfrico+N+DIM+F+SG
afriquinha	áfrico+N+DIM+F+SG
africozinhos	áfrico+N+DIM+M+PL
afriquinhos	áfrico+N+DIM+M+PL
africozinho	áfrico+N+DIM+M+SG
afriquinho	áfrico+N+DIM+M+SG
áfricas	áfrico+N+F+PL
áfrica	áfrico+N+F+SG
áfricos	áfrico+N+M+PL
áfrico	áfrico+N+M+SG
agapazinhas	ágapa+N+DIM+F+PL
agapinhas	ágapa+N+DIM+F+PL
agapazinha	ágapa+N+DIM+F+SG
agapinha	ágapa+N+DIM+F+SG
ágapas	ágapa+N+F+PL
ágapa	ágapa+N+F+SG
agapezinhas	ágape+N+DIM+F+PL
agapinhas	ágape+N+DIM+F+PL
agapezinha	ágape+N+DIM+F+SG
agapinha	ágape+N+DIM+F+SG
agapezinhos	ágape+N+DIM+M+PL
agapinhos	ágape+N+DIM+M+PL
agapezinho	ágape+N+DIM+M+SG
agapinho	ágape+N+DIM+M+SG
ágapes	ágape+N+PL
ágape	ágape+N+SG
agarezinhos	ágar+N+DIM+M+PL
agarzinhos	ágar+N+DIM+M+PL
agarzinho	ágar+N+DIM+M+SG
ágares	ágar+N+M+PL
ágar	ágar+N+M+SG
agatazinhas	ágata+N+DIM+F+PL
agatinhas	ágata+N+DIM+F+PL
agatazinha	ágata+N+DIM+F+SG
agatinha	ágata+N+DIM+F+SG
ágatas	ágata+N+F+PL
ágata	ágata+N+F+SG
agatezinhos	ágate+N+DIM+M+PL
agatinhos	ágate+N+DIM+M+PL
agatezinho	ágate+N+DIM+M+SG
agatinho	ágate+N+DIM+M+SG
ágates	ágate+N+M+PL
ágate	ágate+N+M+SG
aginhos	ágio+N+DIM+M+PL
agiozinhos	ágio+N+DIM+M+PL
aginho	ágio+N+DIM+M+SG
agiozinho	ágio+N+DIM+M+SG
ágios	ágio+N+M+PL
ágio	ágio+N+M+SG
agnatinhos	ágnato+N+DIM+M+PL
agnatozinhos	ágnato+N+DIM+M+PL
agnatinho	ágnato+N+DIM+M+SG
agnatozinho	ágnato+N+DIM+M+SG
ágnatos	ágnato+N+M+PL
ágnato	ágnato+N+M+SG
agorazinhas	ágora+N+DIM+F+PL
agorinhas	ágora+N+DIM+F+PL
agorazinha	ágora+N+DIM+F+SG
agorinha	ágora+N+DIM+F+SG
ágoras	ágora+N+F+PL
ágora	ágora+N+F+SG
aguazinhas	água+N+DIM+F+PL
aguinhas	água+N+DIM+F+PL
aguitas	água+N+DIM+F+PL
agüinhas	água+N+DIM+F+PL
aguazinha	água+N+DIM+F+SG
aguinha	água+N+DIM+F+SG
aguita	água+N+DIM+F+SG
agüinha	água+N+DIM+F+SG
águas	água+N+F+PL
água	água+N+F+SG
aguabresazinhas	águabresa+N+DIM+F+PL
aguabresinhas	águabresa+N+DIM+F+PL
aguabresazinha	águabresa+N+DIM+F+SG
aguabresinha	águabresa+N+DIM+F+SG
águabresas	águabresa+N+F+PL
águabresa	águabresa+N+F+SG
aguiazinhas	águia+N+DIM+F+PL
aguiazinha	águia+N+DIM+F+SG
aguiazinhos	águia+N+DIM+M+PL
aguiazinho	águia+N+DIM+M+SG
aguinhas	águia+N+DIM+PL
aguinha	águia+N+DIM+SG
águias	águia+N+PL
águia	águia+N+SG
aguilazinhas	águila+N+DIM+F+PL
aguilinhas	águila+N+DIM+F+PL
aguilazinha	águila+N+DIM+F+SG
aguilinha	águila+N+DIM+F+SG
águilas	águila+N+F+PL
águila	águila+N+F+SG
alaminhos	álamo+N+DIM+M+PL
alamozinhos	álamo+N+DIM+M+PL
alaminho	álamo+N+DIM+M+SG
alamozinho	álamo+N+DIM+M+SG
álamos	álamo+N+M+PL
álamo	álamo+N+M+SG
albunzinhas	álbum+N+DIM+F+PL
albunzinha	álbum+N+DIM+F+SG
albunzinhos	álbum+N+DIM+M+PL
albunzinho	álbum+N+DIM+M+SG
álbuns	álbum+N+PL
álbum	álbum+N+SG
alcalizinhos	álcali+N+DIM+M+PL
alcalizinho	álcali+N+DIM+M+SG
álcalis	álcali+N+M+PL
álcali	álcali+N+M+SG
alceazinhas	álcea+N+DIM+F+PL
alceinhas	álcea+N+DIM+F+PL
alceazinha	álcea+N+DIM+F+SG
alceinha	álcea+N+DIM+F+SG
álceas	álcea+N+F+PL
álcea	álcea+N+F+SG
alcidazinhas	álcida+N+DIM+F+PL
alcidinhas	álcida+N+DIM+F+PL
alcidazinha	álcida+N+DIM+F+SG
alcidinha	álcida+N+DIM+F+SG
álcidas	álcida+N+F+PL
álcida	álcida+N+F+SG
alcooizinhos	álcool+N+DIM+M+PL
alcoolzinho	álcool+N+DIM+M+SG
álcoois	álcool+N+M+PL
álcool	álcool+N+M+SG
aleazinhas	álea+N+DIM+F+PL
aleinhas	álea+N+DIM+F+PL
aleazinha	álea+N+DIM+F+SG
aleinha	álea+N+DIM+F+SG
áleas	álea+N+F+PL
álea	álea+N+F+SG
algebrazinhas	álgebra+N+DIM+F+PL
algebrinhas	álgebra+N+DIM+F+PL
algebrazinha	álgebra+N+DIM+F+SG
algebrinha	álgebra+N+DIM+F+SG
álgebras	álgebra+N+F+PL
álgebra	álgebra+N+F+SG
alibizinhos	álibi+N+DIM+M+PL
alibizinho	álibi+N+DIM+M+SG
álibis	álibi+N+M+PL
álibi	álibi+N+M+SG
alicazinhas	álica+N+DIM+F+PL
aliquinhas	álica+N+DIM+F+PL
alicazinha	álica+N+DIM+F+SG
aliquinha	álica+N+DIM+F+SG
álicas	álica+N+F+PL
álica	álica+N+F+SG
aliosinhas	álios+N+DIM+F+PL
aliosinhos	álios+N+DIM+M+PL
aliosinho	álios+N+DIM+M+SG
álios	álios+N+M
alticazinhas	áltica+N+DIM+F+PL
altiquinhas	áltica+N+DIM+F+PL
alticazinha	áltica+N+DIM+F+SG
altiquinha	áltica+N+DIM+F+SG
álticas	áltica+N+F+PL
áltica	áltica+N+F+SG
alulazinhas	álula+N+DIM+F+PL
alulinhas	álula+N+DIM+F+PL
alulazinha	álula+N+DIM+F+SG
alulinha	álula+N+DIM+F+SG
álulas	álula+N+F+PL
álula	álula+N+F+SG
alveinhos	álveo+N+DIM+M+PL
alveozinhos	álveo+N+DIM+M+PL
alveinho	álveo+N+DIM+M+SG
alveozinho	álveo+N+DIM+M+SG
álveos	álveo+N+M+PL
álveo	álveo+N+M+SG
alvidrinhos	álvidro+N+DIM+M+PL
alvidrozinhos	álvidro+N+DIM+M+PL
alvidrinho	álvidro+N+DIM+M+SG
alvidrozinho	álvidro+N+DIM+M+SG
álvidros	álvidro+N+M+PL
álvidro	álvidro+N+M+SG
apicezinhos	ápice+N+DIM+M+PL
apicinhos	ápice+N+DIM+M+PL
apicezinho	ápice+N+DIM+M+SG
apicinho	ápice+N+DIM+M+SG
ápices	ápice+N+M+PL
ápice	ápice+N+M+SG
apocazinhas	ápoca+N+DIM+F+PL
apoquinhas	ápoca+N+DIM+F+PL
apocazinha	ápoca+N+DIM+F+SG
apoquinha	ápoca+N+DIM+F+SG
ápocas	ápoca+N+F+PL
ápoca	ápoca+N+F+SG
apodezinhas	ápode+N+DIM+F+PL
apodinhas	ápode+N+DIM+F+PL
apodezinha	ápode+N+DIM+F+SG
apodinha	ápode+N+DIM+F+SG
apodezinhos	ápode+N+DIM+M+PL
apodinhos	ápode+N+DIM+M+PL
apodezinho	ápode+N+DIM+M+SG
apodinho	ápode+N+DIM+M+SG
ápodes	ápode+N+PL
ápode	ápode+N+SG
apodazinhas	ápodo+N+DIM+F+PL
apodinhas	ápodo+N+DIM+F+PL
apodazinha	ápodo+N+DIM+F+SG
apodinha	ápodo+N+DIM+F+SG
apodinhos	ápodo+N+DIM+M+PL
apodozinhos	ápodo+N+DIM+M+PL
apodinho	ápodo+N+DIM+M+SG
apodozinho	ápodo+N+DIM+M+SG
ápodas	ápodo+N+F+PL
ápoda	ápodo+N+F+SG
ápodos	ápodo+N+M+PL
ápodo	ápodo+N+M+SG
aporinhos	áporo+N+DIM+M+PL
aporozinhos	áporo+N+DIM+M+PL
aporinho	áporo+N+DIM+M+SG
aporozinho	áporo+N+DIM+M+SG
áporos	áporo+N+M+PL
áporo	áporo+N+M+SG
apsidezinhas	ápside+N+DIM+F+PL
apsidinhas	ápside+N+DIM+F+PL
apsidezinha	ápside+N+DIM+F+SG
apsidinha	ápside+N+DIM+F+SG
ápsides	ápside+N+F+PL
ápside	ápside+N+F+SG
apterazinhas	áptero+N+DIM+F+PL
apterinhas	áptero+N+DIM+F+PL
apterazinha	áptero+N+DIM+F+SG
apterinha	áptero+N+DIM+F+SG
apterinhos	áptero+N+DIM+M+PL
apterozinhos	áptero+N+DIM+M+PL
apterinho	áptero+N+DIM+M+SG
apterozinho	áptero+N+DIM+M+SG
ápteras	áptero+N+F+PL
áptera	áptero+N+F+SG
ápteros	áptero+N+M+PL
áptero	áptero+N+M+SG
apticozinhos	áptico+N+DIM+M+PL
aptiquinhos	áptico+N+DIM+M+PL
apticozinho	áptico+N+DIM+M+SG
aptiquinho	áptico+N+DIM+M+SG
ápticos	áptico+N+M+PL
áptico	áptico+N+M+SG
arabezinhas	árabe+N+DIM+F+PL
arabinhas	árabe+N+DIM+F+PL
arabezinha	árabe+N+DIM+F+SG
arabinha	árabe+N+DIM+F+SG
arabezinhos	árabe+N+DIM+M+PL
arabinhos	árabe+N+DIM+M+PL
arabezinho	árabe+N+DIM+M+SG
arabinho	árabe+N+DIM+M+SG
árabes	árabe+N+PL
árabe	árabe+N+SG
araquezinhos	áraque+N+DIM+M+PL
araquinhos	áraque+N+DIM+M+PL
araquezinho	áraque+N+DIM+M+SG
araquinho	áraque+N+DIM+M+SG
áraques	áraque+N+M+PL
áraque	áraque+N+M+SG
arbitrazinhas	árbitro+N+DIM+F+PL
arbitrinhas	árbitro+N+DIM+F+PL
arbitrazinha	árbitro+N+DIM+F+SG
arbitrinha	árbitro+N+DIM+F+SG
arbitrinhos	árbitro+N+DIM+M+PL
arbitrozinhos	árbitro+N+DIM+M+PL
arbitrinho	árbitro+N+DIM+M+SG
arbitrozinho	árbitro+N+DIM+M+SG
árbitras	árbitro+N+F+PL
árbitra	árbitro+N+F+SG
árbitros	árbitro+N+M+PL
árbitro	árbitro+N+M+SG
arcadezinhas	árcade+N+DIM+F+PL
arcadinhas	árcade+N+DIM+F+PL
arcadezinha	árcade+N+DIM+F+SG
arcadinha	árcade+N+DIM+F+SG
arcadezinhos	árcade+N+DIM+M+PL
arcadinhos	árcade+N+DIM+M+PL
arcadezinho	árcade+N+DIM+M+SG
arcadinho	árcade+N+DIM+M+SG
árcades	árcade+N+PL
árcade	árcade+N+SG
arcticozinhos	árctico+N+DIM+M+PL
arctiquinhos	árctico+N+DIM+M+PL
arcticozinho	árctico+N+DIM+M+SG
arctiquinho	árctico+N+DIM+M+SG
árcticos	árctico+N+M+PL
árctico	árctico+N+M+SG
areazinhas	área+N+DIM+F+PL
areinhas	área+N+DIM+F+PL
areazinha	área+N+DIM+F+SG
areinha	área+N+DIM+F+SG
áreas	área+N+F+PL
área	área+N+F+SG
argonzinho	árgon+N+DIM+M+SG
árgon	árgon+N+M+SG
ariazinhas	ária+N+DIM+F+PL
ariazinha	ária+N+DIM+F+SG
ariazinhos	ária+N+DIM+M+PL
ariazinho	ária+N+DIM+M+SG
arinhas	ária+N+DIM+PL
arinha	ária+N+DIM+SG
árias	ária+N+PL
ária	ária+N+SG
arsisinha	ársis+N+DIM+F+SG
ársis	ársis+N+F+SG
arulazinhas	árula+N+DIM+F+PL
arulinhas	árula+N+DIM+F+PL
arulazinha	árula+N+DIM+F+SG
arulinha	árula+N+DIM+F+SG
árulas	árula+N+F+PL
árula	árula+N+F+SG
arvoretas	árvore+N+DIM+F+PL
arvorezinhas	árvore+N+DIM+F+PL
arvorezitas	árvore+N+DIM+F+PL
arvorinhas	árvore+N+DIM+F+PL
arvorzinhas	árvore+N+DIM+F+PL
arvoreta	árvore+N+DIM+F+SG
arvorezinha	árvore+N+DIM+F+SG
arvorezita	árvore+N+DIM+F+SG
arvorinha	árvore+N+DIM+F+SG
árvores	árvore+N+F+PL
árvore	árvore+N+F+SG
asezinhos	ás+N+DIM+M+PL
asinhos	ás+N+DIM+M+PL
asinho	ás+N+DIM+M+SG
ases	ás+N+M+PL
áses	ás+N+M+PL
ás	ás+N+M+SG
asarinhos	ásaro+N+DIM+M+PL
asarozinhos	ásaro+N+DIM+M+PL
asarinho	ásaro+N+DIM+M+SG
asarozinho	ásaro+N+DIM+M+SG
ásaros	ásaro+N+M+PL
ásaro	ásaro+N+M+SG
ascelezinhas	áscele+N+DIM+F+PL
ascelinhas	áscele+N+DIM+F+PL
ascelezinha	áscele+N+DIM+F+SG
ascelinha	áscele+N+DIM+F+SG
ascelezinhos	áscele+N+DIM+M+PL
ascelinhos	áscele+N+DIM+M+PL
ascelezinho	áscele+N+DIM+M+SG
ascelinho	áscele+N+DIM+M+SG
ásceles	áscele+N+PL
áscele	áscele+N+SG
ascelinhos	áscelo+N+DIM+M+PL
ascelozinhos	áscelo+N+DIM+M+PL
ascelinho	áscelo+N+DIM+M+SG
ascelozinho	áscelo+N+DIM+M+SG
áscelos	áscelo+N+M+PL
áscelo	áscelo+N+M+SG
ascinhos	áscio+N+DIM+M+PL
asciozinhos	áscio+N+DIM+M+PL
ascinho	áscio+N+DIM+M+SG
asciozinho	áscio+N+DIM+M+SG
áscios	áscio+N+M+PL
áscio	áscio+N+M+SG
ascoazinhas	áscoa+N+DIM+F+PL
ascoinhas	áscoa+N+DIM+F+PL
ascoazinha	áscoa+N+DIM+F+SG
ascoinha	áscoa+N+DIM+F+SG
áscoas	áscoa+N+F+PL
áscoa	áscoa+N+F+SG
asconezinhos	áscon+N+DIM+M+PL
asconzinhos	áscon+N+DIM+M+PL
asconzinho	áscon+N+DIM+M+SG
áscones	áscon+N+M+PL
áscons	áscon+N+M+PL
áscon	áscon+N+M+SG
ascuazinhas	áscua+N+DIM+F+PL
ascuinhas	áscua+N+DIM+F+PL
ascuazinha	áscua+N+DIM+F+SG
ascuinha	áscua+N+DIM+F+SG
áscuas	áscua+N+F+PL
áscua	áscua+N+F+SG
aspidezinhas	áspide+N+DIM+F+PL
aspidinhas	áspide+N+DIM+F+PL
aspidezinha	áspide+N+DIM+F+SG
aspidinha	áspide+N+DIM+F+SG
aspidezinhos	áspide+N+DIM+M+PL
aspidinhos	áspide+N+DIM+M+PL
aspidezinho	áspide+N+DIM+M+SG
aspidinho	áspide+N+DIM+M+SG
áspides	áspide+N+PL
áspide	áspide+N+SG
astatinhos	ástato+N+DIM+M+PL
astatozinhos	ástato+N+DIM+M+PL
astatinho	ástato+N+DIM+M+SG
astatozinho	ástato+N+DIM+M+SG
ástatos	ástato+N+M+PL
ástato	ástato+N+M+SG
asterezinhos	áster+N+DIM+M+PL
asterzinhos	áster+N+DIM+M+PL
asterzinho	áster+N+DIM+M+SG
ásteres	áster+N+M+PL
áster	áster+N+M+SG
asturezinhas	ásture+N+DIM+F+PL
asturinhas	ásture+N+DIM+F+PL
asturzinhas	ásture+N+DIM+F+PL
asturezinha	ásture+N+DIM+F+SG
asturinha	ásture+N+DIM+F+SG
asturezinhos	ásture+N+DIM+M+PL
asturinhos	ásture+N+DIM+M+PL
asturzinhos	ásture+N+DIM+M+PL
asturezinho	ásture+N+DIM+M+SG
asturinho	ásture+N+DIM+M+SG
ástures	ásture+N+PL
ásture	ásture+N+SG
aticazinhas	ático+N+DIM+F+PL
atiquinhas	ático+N+DIM+F+PL
aticazinha	ático+N+DIM+F+SG
atiquinha	ático+N+DIM+F+SG
aticozinhos	ático+N+DIM+M+PL
atiquinhos	ático+N+DIM+M+PL
aticozinho	ático+N+DIM+M+SG
atiquinho	ático+N+DIM+M+SG
áticas	ático+N+F+PL
ática	ático+N+F+SG
áticos	ático+N+M+PL
ático	ático+N+M+SG
atiminhos	átimo+N+DIM+M+PL
atimozinhos	átimo+N+DIM+M+PL
atiminho	átimo+N+DIM+M+SG
atimozinho	átimo+N+DIM+M+SG
átimos	átimo+N+M+PL
átimo	átimo+N+M+SG
atominhos	átomo+N+DIM+M+PL
atomozinhos	átomo+N+DIM+M+PL
atominho	átomo+N+DIM+M+SG
atomozinho	átomo+N+DIM+M+SG
átomos	átomo+N+M+PL
átomo	átomo+N+M+SG
atrinhos	átrio+N+DIM+M+PL
atriozinhos	átrio+N+DIM+M+PL
atrinho	átrio+N+DIM+M+SG
atriozinho	átrio+N+DIM+M+SG
átrios	átrio+N+M+PL
átrio	átrio+N+M+SG
atropinhos	átropo+N+DIM+M+PL
atropozinhos	átropo+N+DIM+M+PL
atropinho	átropo+N+DIM+M+SG
atropozinho	átropo+N+DIM+M+SG
átropos	átropo+N+M+PL
átropo	átropo+N+M+SG
audinhos	áudio+N+DIM+M+PL
audiozinhos	áudio+N+DIM+M+PL
audinho	áudio+N+DIM+M+SG
audiozinho	áudio+N+DIM+M+SG
áudios	áudio+N+M+PL
áudio	áudio+N+M+SG
auguratrizezinhas	áugure+N+DIM+F+PL
auguratrizinhas	áugure+N+DIM+F+PL
auguratrizinha	áugure+N+DIM+F+SG
augurezinhos	áugure+N+DIM+M+PL
augurinhos	áugure+N+DIM+M+PL
augurzinhos	áugure+N+DIM+M+PL
augurezinho	áugure+N+DIM+M+SG
augurinho	áugure+N+DIM+M+SG
áuguratrizes	áugure+N+F+PL
áuguratriz	áugure+N+F+SG
áugures	áugure+N+M+PL
áugure	áugure+N+M+SG
aulicazinhas	áulico+N+DIM+F+PL
auliquinhas	áulico+N+DIM+F+PL
aulicazinha	áulico+N+DIM+F+SG
auliquinha	áulico+N+DIM+F+SG
aulicozinhos	áulico+N+DIM+M+PL
auliquinhos	áulico+N+DIM+M+PL
aulicozinho	áulico+N+DIM+M+SG
auliquinho	áulico+N+DIM+M+SG
áulicas	áulico+N+F+PL
áulica	áulico+N+F+SG
áulicos	áulico+N+M+PL
áulico	áulico+N+M+SG
aureazinhas	áureo+N+DIM+F+PL
aureinhas	áureo+N+DIM+F+PL
aureazinha	áureo+N+DIM+F+SG
aureinha	áureo+N+DIM+F+SG
aureinhos	áureo+N+DIM+M+PL
aureozinhos	áureo+N+DIM+M+PL
aureinho	áureo+N+DIM+M+SG
aureozinho	áureo+N+DIM+M+SG
áureas	áureo+N+F+PL
áurea	áureo+N+F+SG
áureos	áureo+N+M+PL
áureo	áureo+N+M+SG
avilazinhas	ávila+N+DIM+F+PL
avilinhas	ávila+N+DIM+F+PL
avilazinha	ávila+N+DIM+F+SG
avilinha	ávila+N+DIM+F+SG
ávilas	ávila+N+F+PL
ávila	ávila+N+F+SG
axisinhas	áxis+N+DIM+F+PL
axisinhos	áxis+N+DIM+M+PL
axisinho	áxis+N+DIM+M+SG
áxis	áxis+N+M
amagozinhos	âmago+N+DIM+M+PL
amaguinhos	âmago+N+DIM+M+PL
amagozinho	âmago+N+DIM+M+SG
amaguinho	âmago+N+DIM+M+SG
âmagos	âmago+N+M+PL
âmago	âmago+N+M+SG
ambarezinhos	âmbar+N+DIM+M+PL
ambarzinhos	âmbar+N+DIM+M+PL
ambarzinho	âmbar+N+DIM+M+SG
âmbares	âmbar+N+M+PL
âmbar	âmbar+N+M+SG
ambitinhos	âmbito+N+DIM+M+PL
ambitozinhos	âmbito+N+DIM+M+PL
ambitinho	âmbito+N+DIM+M+SG
ambitozinho	âmbito+N+DIM+M+SG
âmbitos	âmbito+N+M+PL
âmbito	âmbito+N+M+SG
ambulazinhas	âmbula+N+DIM+F+PL
ambulinhas	âmbula+N+DIM+F+PL
ambulazinha	âmbula+N+DIM+F+SG
ambulinha	âmbula+N+DIM+F+SG
âmbulas	âmbula+N+F+PL
âmbula	âmbula+N+F+SG
amninhos	âmnio+N+DIM+M+PL
amniozinhos	âmnio+N+DIM+M+PL
amninho	âmnio+N+DIM+M+SG
amniozinho	âmnio+N+DIM+M+SG
âmnios	âmnio+N+M+PL
âmnio	âmnio+N+M+SG
ancorazinhas	âncora+N+DIM+F+PL
ancorinhas	âncora+N+DIM+F+PL
ancorazinha	âncora+N+DIM+F+SG
ancorinha	âncora+N+DIM+F+SG
âncoras	âncora+N+F+PL
âncora	âncora+N+F+SG
anditinhos	ândito+N+DIM+M+PL
anditozinhos	ândito+N+DIM+M+PL
anditinho	ândito+N+DIM+M+SG
anditozinho	ândito+N+DIM+M+SG
ânditos	ândito+N+M+PL
ândito	ândito+N+M+SG
anforazinhas	ânfora+N+DIM+F+PL
anforinhas	ânfora+N+DIM+F+PL
anforazinha	ânfora+N+DIM+F+SG
anforinha	ânfora+N+DIM+F+SG
ânforas	ânfora+N+F+PL
ânfora	ânfora+N+F+SG
angelusinhas	ângelus+N+DIM+F+PL
angelusinhos	ângelus+N+DIM+M+PL
angelusinho	ângelus+N+DIM+M+SG
ângelus	ângelus+N+M
angulinhos	ângulo+N+DIM+M+PL
angulozinhos	ângulo+N+DIM+M+PL
angulinho	ângulo+N+DIM+M+SG
angulozinho	ângulo+N+DIM+M+SG
ângulos	ângulo+N+M+PL
ângulo	ângulo+N+M+SG
animinhos	ânimo+N+DIM+M+PL
animozinhos	ânimo+N+DIM+M+PL
animinho	ânimo+N+DIM+M+SG
animozinho	ânimo+N+DIM+M+SG
ânimos	ânimo+N+M+PL
ânimo	ânimo+N+M+SG
anionzinhos	ânion+N+DIM+M+PL
anionzinho	ânion+N+DIM+M+SG
ânions	ânion+N+M+PL
ânion	ânion+N+M+SG
anodinhos	ânodo+N+DIM+M+PL
anodozinhos	ânodo+N+DIM+M+PL
anodinho	ânodo+N+DIM+M+SG
anodozinho	ânodo+N+DIM+M+SG
ânodos	ânodo+N+M+PL
ânodo	ânodo+N+M+SG
ansiazinhas	ânsia+N+DIM+F+PL
ansinhas	ânsia+N+DIM+F+PL
ansiazinha	ânsia+N+DIM+F+SG
ansinha	ânsia+N+DIM+F+SG
ânsias	ânsia+N+F+PL
ânsia	ânsia+N+F+SG
anulinhos	ânulo+N+DIM+M+PL
anulozinhos	ânulo+N+DIM+M+PL
anulinho	ânulo+N+DIM+M+SG
anulozinho	ânulo+N+DIM+M+SG
ânulos	ânulo+N+M+PL
ânulo	ânulo+N+M+SG
anusinhas	ânus+N+DIM+F+PL
anusinhos	ânus+N+DIM+M+PL
anusinho	ânus+N+DIM+M+SG
ânus	ânus+N+M
ebaninhos	ébano+N+DIM+M+PL
ebanozinhos	ébano+N+DIM+M+PL
ebaninho	ébano+N+DIM+M+SG
ebanozinho	ébano+N+DIM+M+SG
ébanos	ébano+N+M+PL
ébano	ébano+N+M+SG
ebeninhos	ébeno+N+DIM+M+PL
ebenozinhos	ébeno+N+DIM+M+PL
ebeninho	ébeno+N+DIM+M+SG
ebenozinho	ébeno+N+DIM+M+SG
ébenos	ébeno+N+M+PL
ébeno	ébeno+N+M+SG
ebolazinhos	ébola+N+DIM+M+PL
ebolinhas	ébola+N+DIM+M+PL
ebolazinho	ébola+N+DIM+M+SG
ebolinha	ébola+N+DIM+M+SG
ebolas	ébola+N+M+PL
ébolas	ébola+N+M+PL
ebola	ébola+N+M+SG
ébola	ébola+N+M+SG
ebriazinhas	ébrio+N+DIM+F+PL
ebrinhas	ébrio+N+DIM+F+PL
ebriazinha	ébrio+N+DIM+F+SG
ebrinha	ébrio+N+DIM+F+SG
ebrinhos	ébrio+N+DIM+M+PL
ebriozinhos	ébrio+N+DIM+M+PL
ebrinho	ébrio+N+DIM+M+SG
ebriozinho	ébrio+N+DIM+M+SG
ébrias	ébrio+N+F+PL
ébria	ébrio+N+F+SG
ébrios	ébrio+N+M+PL
ébrio	ébrio+N+M+SG
ebulinhos	ébulo+N+DIM+M+PL
ebulozinhos	ébulo+N+DIM+M+PL
ebulinho	ébulo+N+DIM+M+SG
ebulozinho	ébulo+N+DIM+M+SG
ébulos	ébulo+N+M+PL
ébulo	ébulo+N+M+SG
ecartezinho	écarté+N+DIM+M+SG
écarté	écarté+N+M+SG
ecforazinhas	écfora+N+DIM+F+PL
ecforinhas	écfora+N+DIM+F+PL
ecforazinha	écfora+N+DIM+F+SG
ecforinha	écfora+N+DIM+F+SG
écforas	écfora+N+F+PL
écfora	écfora+N+F+SG
eclairzinho	éclair+N+DIM+M+SG
éclair	éclair+N+M+SG
eclogazinhas	écloga+N+DIM+F+PL
ecloguinhas	écloga+N+DIM+F+PL
eclogazinha	écloga+N+DIM+F+SG
ecloguinha	écloga+N+DIM+F+SG
éclogas	écloga+N+F+PL
écloga	écloga+N+F+SG
ecranzinhos	écran+N+DIM+M+PL
ecranzinho	écran+N+DIM+M+SG
écrans	écran+N+M+PL
écran	écran+N+M+SG
ectasezinhas	éctase+N+DIM+F+PL
ectasinhas	éctase+N+DIM+F+PL
ectasezinha	éctase+N+DIM+F+SG
ectasinha	éctase+N+DIM+F+SG
éctases	éctase+N+F+PL
éctase	éctase+N+F+SG
eculinhos	éculo+N+DIM+M+PL
eculozinhos	éculo+N+DIM+M+PL
eculinho	éculo+N+DIM+M+SG
eculozinho	éculo+N+DIM+M+SG
éculos	éculo+N+M+PL
éculo	éculo+N+M+SG
edenzinhos	éden+N+DIM+M+PL
edenzinho	éden+N+DIM+M+SG
édens	éden+N+M+PL
éden	éden+N+M+SG
edipinhos	édipo+N+DIM+M+PL
edipozinhos	édipo+N+DIM+M+PL
edipinho	édipo+N+DIM+M+SG
edipozinho	édipo+N+DIM+M+SG
édipos	édipo+N+M+PL
édipo	édipo+N+M+SG
editinhos	édito+N+DIM+M+PL
editozinhos	édito+N+DIM+M+PL
editinho	édito+N+DIM+M+SG
editozinho	édito+N+DIM+M+SG
éditos	édito+N+M+PL
édito	édito+N+M+SG
edredonzinhos	édredon+N+DIM+M+PL
edredonzinho	édredon+N+DIM+M+SG
édredons	édredon+N+M+PL
édredon	édredon+N+M+SG
eforinhos	éforo+N+DIM+M+PL
eforozinhos	éforo+N+DIM+M+PL
eforinho	éforo+N+DIM+M+SG
eforozinho	éforo+N+DIM+M+SG
éforos	éforo+N+M+PL
éforo	éforo+N+M+SG
egidezinhas	égide+N+DIM+F+PL
egidinhas	égide+N+DIM+F+PL
egidezinha	égide+N+DIM+F+SG
egidinha	égide+N+DIM+F+SG
égides	égide+N+F+PL
égide	égide+N+F+SG
eglogazinhas	égloga+N+DIM+F+PL
egloguinhas	égloga+N+DIM+F+PL
eglogazinha	égloga+N+DIM+F+SG
egloguinha	égloga+N+DIM+F+SG
églogas	égloga+N+F+PL
égloga	égloga+N+F+SG
egrinhos	égrio+N+DIM+M+PL
egriozinhos	égrio+N+DIM+M+PL
egrinho	égrio+N+DIM+M+SG
egriozinho	égrio+N+DIM+M+SG
égrios	égrio+N+M+PL
égrio	égrio+N+M+SG
eguazinhas	égua+N+DIM+F+PL
eguazitas	égua+N+DIM+F+PL
eguinhas	égua+N+DIM+F+PL
eguazinha	égua+N+DIM+F+SG
eguazita	égua+N+DIM+F+SG
eguinha	égua+N+DIM+F+SG
éguas	égua+N+F+PL
égua	égua+N+F+SG
elanzinhos	élan+N+DIM+M+PL
elanzinho	élan+N+DIM+M+SG
élans	élan+N+M+PL
élan	élan+N+M+SG
elatezinhos	élate+N+DIM+M+PL
elatinhos	élate+N+DIM+M+PL
elatezinho	élate+N+DIM+M+SG
elatinho	élate+N+DIM+M+SG
élates	élate+N+M+PL
élate	élate+N+M+SG
elitrinhos	élitro+N+DIM+M+PL
elitrozinhos	élitro+N+DIM+M+PL
elitrinho	élitro+N+DIM+M+SG
elitrozinho	élitro+N+DIM+M+SG
élitros	élitro+N+M+PL
élitro	élitro+N+M+SG
emulazinhas	émulo+N+DIM+F+PL
emulinhas	émulo+N+DIM+F+PL
emulazinha	émulo+N+DIM+F+SG
emulinha	émulo+N+DIM+F+SG
emulinhos	émulo+N+DIM+M+PL
emulozinhos	émulo+N+DIM+M+PL
emulinho	émulo+N+DIM+M+SG
emulozinho	émulo+N+DIM+M+SG
émulas	émulo+N+F+PL
émula	émulo+N+F+SG
émulos	émulo+N+M+PL
émulo	émulo+N+M+SG
enulazinhas	énula+N+DIM+F+PL
enulinhas	énula+N+DIM+F+PL
enulazinha	énula+N+DIM+F+SG
enulinha	énula+N+DIM+F+SG
énulas	énula+N+F+PL
énula	énula+N+F+SG
énula-campaninhas	énula-campana+N+DIM+F+PL
énulas-campanazinhas	énula-campana+N+DIM+F+PL
énula-campanazinha	énula-campana+N+DIM+F+SG
énula-campaninha	énula-campana+N+DIM+F+SG
énulas-campana	énula-campana+N+F+PL
énulas-campanas	énula-campana+N+F+PL
énula-campana	énula-campana+N+F+SG
enuplazinhas	énupla+N+DIM+F+PL
enuplinhas	énupla+N+DIM+F+PL
enuplazinha	énupla+N+DIM+F+SG
enuplinha	énupla+N+DIM+F+SG
énuplas	énupla+N+F+PL
énupla	énupla+N+F+SG
eolinhos	éolo+N+DIM+M+PL
eolozinhos	éolo+N+DIM+M+PL
eolinho	éolo+N+DIM+M+SG
eolozinho	éolo+N+DIM+M+SG
éolos	éolo+N+M+PL
éolo	éolo+N+M+SG
epicazinhas	épica+N+DIM+F+PL
epiquinhas	épica+N+DIM+F+PL
epicazinha	épica+N+DIM+F+SG
epiquinha	épica+N+DIM+F+SG
épicas	épica+N+F+PL
épica	épica+N+F+SG
epicazinhas	épico+N+DIM+F+PL
epiquinhas	épico+N+DIM+F+PL
epicazinha	épico+N+DIM+F+SG
epiquinha	épico+N+DIM+F+SG
epicozinhos	épico+N+DIM+M+PL
epiquinhos	épico+N+DIM+M+PL
epicozinho	épico+N+DIM+M+SG
epiquinho	épico+N+DIM+M+SG
épicas	épico+N+F+PL
épica	épico+N+F+SG
épicos	épico+N+M+PL
épico	épico+N+M+SG
epocazinhas	época+N+DIM+F+PL
epoquinhas	época+N+DIM+F+PL
epocazinha	época+N+DIM+F+SG
epoquinha	época+N+DIM+F+SG
épocas	época+N+F+PL
época	época+N+F+SG
epsilinhos	épsilo+N+DIM+M+PL
epsilozinhos	épsilo+N+DIM+M+PL
epsilinho	épsilo+N+DIM+M+SG
epsilozinho	épsilo+N+DIM+M+SG
épsilos	épsilo+N+M+PL
épsilo	épsilo+N+M+SG
epsilonezinhos	épsilon+N+DIM+M+PL
epsilonzinhos	épsilon+N+DIM+M+PL
epsilonzinho	épsilon+N+DIM+M+SG
épsilones	épsilon+N+M+PL
épsilons	épsilon+N+M+PL
épsilon	épsilon+N+M+SG
epsilõezinhos	épsilão+N+DIM+M+PL
epsilãozinho	épsilão+N+DIM+M+SG
épsilões	épsilão+N+M+PL
épsilão	épsilão+N+M+SG
epurazinhas	épura+N+DIM+F+PL
epurinhas	épura+N+DIM+F+PL
epurazinha	épura+N+DIM+F+SG
epurinha	épura+N+DIM+F+SG
épuras	épura+N+F+PL
épura	épura+N+F+SG
equidazinhos	équida+N+DIM+M+PL
equidinhas	équida+N+DIM+M+PL
equidazinho	équida+N+DIM+M+SG
equidinha	équida+N+DIM+M+SG
équidas	équida+N+M+PL
équida	équida+N+M+SG
equitezinhos	équite+N+DIM+M+PL
equitinhos	équite+N+DIM+M+PL
equitezinho	équite+N+DIM+M+SG
equitinho	équite+N+DIM+M+SG
équites	équite+N+M+PL
équite	équite+N+M+SG
eqüitezinhos	éqüite+N+DIM+M+PL
eqüitinhos	éqüite+N+DIM+M+PL
eqüitezinho	éqüite+N+DIM+M+SG
eqüitinho	éqüite+N+DIM+M+SG
éqüites	éqüite+N+M+PL
éqüite	éqüite+N+M+SG
erbinhos	érbio+N+DIM+M+PL
erbiozinhos	érbio+N+DIM+M+PL
erbinho	érbio+N+DIM+M+SG
erbiozinho	érbio+N+DIM+M+SG
érbios	érbio+N+M+PL
érbio	érbio+N+M+SG
esipinhos	ésipo+N+DIM+M+PL
esipozinhos	ésipo+N+DIM+M+PL
esipinho	ésipo+N+DIM+M+SG
esipozinho	ésipo+N+DIM+M+SG
ésipos	ésipo+N+M+PL
ésipo	ésipo+N+M+SG
esterezinhos	éster+N+DIM+M+PL
esterzinhos	éster+N+DIM+M+PL
esterzinho	éster+N+DIM+M+SG
ésteres	éster+N+M+PL
éster	éster+N+M+SG
esulazinhas	ésula+N+DIM+F+PL
esulinhas	ésula+N+DIM+F+PL
esulazinha	ésula+N+DIM+F+SG
esulinha	ésula+N+DIM+F+SG
ésulas	ésula+N+F+PL
ésula	ésula+N+F+SG
etaminezinhas	étamine+N+DIM+F+PL
etamininhas	étamine+N+DIM+F+PL
etaminezinha	étamine+N+DIM+F+SG
etamininha	étamine+N+DIM+F+SG
étamines	étamine+N+F+PL
étamine	étamine+N+F+SG
eterezinhos	éter+N+DIM+M+PL
eterzinhos	éter+N+DIM+M+PL
eterzinho	éter+N+DIM+M+SG
éteres	éter+N+M+PL
éter	éter+N+M+SG
eticazinhas	ética+N+DIM+F+PL
eticazinha	ética+N+DIM+F+SG
eticazinhos	ética+N+DIM+M+PL
eticazinho	ética+N+DIM+M+SG
etiquinhas	ética+N+DIM+PL
etiquinha	ética+N+DIM+SG
éticas	ética+N+PL
ética	ética+N+SG
etiminhos	étimo+N+DIM+M+PL
etimozinhos	étimo+N+DIM+M+PL
etiminho	étimo+N+DIM+M+SG
etimozinho	étimo+N+DIM+M+SG
étimos	étimo+N+M+PL
étimo	étimo+N+M+SG
excitonzinhos	éxciton+N+DIM+M+PL
excitonzinho	éxciton+N+DIM+M+SG
éxcitons	éxciton+N+M+PL
éxciton	éxciton+N+M+SG
eiderezinhos	êider+N+DIM+M+PL
eiderzinhos	êider+N+DIM+M+PL
eiderzinho	êider+N+DIM+M+SG
êideres	êider+N+M+PL
êider	êider+N+M+SG
embolinhos	êmbolo+N+DIM+M+PL
embolozinhos	êmbolo+N+DIM+M+PL
embolinho	êmbolo+N+DIM+M+SG
embolozinho	êmbolo+N+DIM+M+SG
êmbolos	êmbolo+N+M+PL
êmbolo	êmbolo+N+M+SG
enclisezinhas	ênclise+N+DIM+F+PL
enclisinhas	ênclise+N+DIM+F+PL
enclisezinha	ênclise+N+DIM+F+SG
enclisinha	ênclise+N+DIM+F+SG
ênclises	ênclise+N+F+PL
ênclise	ênclise+N+F+SG
enduazinhas	êndua+N+DIM+F+PL
enduinhas	êndua+N+DIM+F+PL
enduazinha	êndua+N+DIM+F+SG
enduinha	êndua+N+DIM+F+SG
ênduas	êndua+N+F+PL
êndua	êndua+N+F+SG
enfasezinhas	ênfase+N+DIM+F+PL
enfasinhas	ênfase+N+DIM+F+PL
enfasezinha	ênfase+N+DIM+F+SG
enfasinha	ênfase+N+DIM+F+SG
ênfases	ênfase+N+F+PL
ênfase	ênfase+N+F+SG
enterinhos	êntero+N+DIM+M+PL
enterozinhos	êntero+N+DIM+M+PL
enterinho	êntero+N+DIM+M+SG
enterozinho	êntero+N+DIM+M+SG
ênteros	êntero+N+M+PL
êntero	êntero+N+M+SG
enulazinhas	ênula+N+DIM+F+PL
enulinhas	ênula+N+DIM+F+PL
enulazinha	ênula+N+DIM+F+SG
enulinha	ênula+N+DIM+F+SG
ênulas	ênula+N+F+PL
ênula	ênula+N+F+SG
ênula-campaninhas	ênula-campana+N+DIM+F+PL
ênulas-campanazinhas	ênula-campana+N+DIM+F+PL
ênula-campanazinha	ênula-campana+N+DIM+F+SG
ênula-campaninha	ênula-campana+N+DIM+F+SG
ênulas-campana	ênula-campana+N+F+PL
ênulas-campanas	ênula-campana+N+F+PL
ênula-campana	ênula-campana+N+F+SG
ervedinhos	êrvedo+N+DIM+M+PL
ervedozinhos	êrvedo+N+DIM+M+PL
ervedinho	êrvedo+N+DIM+M+SG
ervedozinho	êrvedo+N+DIM+M+SG
êrvedos	êrvedo+N+M+PL
êrvedo	êrvedo+N+M+SG
ervodinhos	êrvodo+N+DIM+M+PL
ervodozinhos	êrvodo+N+DIM+M+PL
ervodinho	êrvodo+N+DIM+M+SG
ervodozinho	êrvodo+N+DIM+M+SG
êrvodos	êrvodo+N+M+PL
êrvodo	êrvodo+N+M+SG
euclasezinhas	êuclase+N+DIM+F+PL
euclasinhas	êuclase+N+DIM+F+PL
euclasezinha	êuclase+N+DIM+F+SG
euclasinha	êuclase+N+DIM+F+SG
êuclases	êuclase+N+F+PL
êuclase	êuclase+N+F+SG
eufonazinhas	êufono+N+DIM+F+PL
eufoninhas	êufono+N+DIM+F+PL
eufonazinha	êufono+N+DIM+F+SG
eufoninha	êufono+N+DIM+F+SG
eufoninhos	êufono+N+DIM+M+PL
eufonozinhos	êufono+N+DIM+M+PL
eufoninho	êufono+N+DIM+M+SG
eufonozinho	êufono+N+DIM+M+SG
êufonas	êufono+N+F+PL
êufona	êufono+N+F+SG
êufonos	êufono+N+M+PL
êufono	êufono+N+M+SG
eugrafinhos	êugrafo+N+DIM+M+PL
eugrafozinhos	êugrafo+N+DIM+M+PL
eugrafinho	êugrafo+N+DIM+M+SG
eugrafozinho	êugrafo+N+DIM+M+SG
êugrafos	êugrafo+N+M+PL
êugrafo	êugrafo+N+M+SG
euscarazinhas	êuscaro+N+DIM+F+PL
euscarinhas	êuscaro+N+DIM+F+PL
euscarazinha	êuscaro+N+DIM+F+SG
euscarinha	êuscaro+N+DIM+F+SG
euscarinhos	êuscaro+N+DIM+M+PL
euscarozinhos	êuscaro+N+DIM+M+PL
euscarinho	êuscaro+N+DIM+M+SG
euscarozinho	êuscaro+N+DIM+M+SG
êuscaras	êuscaro+N+F+PL
êuscara	êuscaro+N+F+SG
êuscaros	êuscaro+N+M+PL
êuscaro	êuscaro+N+M+SG
excetrazinhas	êxcetra+N+DIM+F+PL
excetrinhas	êxcetra+N+DIM+F+PL
excetrazinha	êxcetra+N+DIM+F+SG
excetrinha	êxcetra+N+DIM+F+SG
êxcetras	êxcetra+N+F+PL
êxcetra	êxcetra+N+F+SG
exedrazinhas	êxedra+N+DIM+F+PL
exedrinhas	êxedra+N+DIM+F+PL
exedrazinha	êxedra+N+DIM+F+SG
exedrinha	êxedra+N+DIM+F+SG
êxedras	êxedra+N+F+PL
êxedra	êxedra+N+F+SG
exitinhos	êxito+N+DIM+M+PL
exitozinhos	êxito+N+DIM+M+PL
exitinho	êxito+N+DIM+M+SG
exitozinho	êxito+N+DIM+M+SG
êxitos	êxito+N+M+PL
êxito	êxito+N+M+SG
exodinhos	êxodo+N+DIM+M+PL
exodozinhos	êxodo+N+DIM+M+PL
exodinho	êxodo+N+DIM+M+SG
exodozinho	êxodo+N+DIM+M+SG
êxodos	êxodo+N+M+PL
êxodo	êxodo+N+M+SG
extasezinhos	êxtase+N+DIM+M+PL
extasinhos	êxtase+N+DIM+M+PL
extasezinho	êxtase+N+DIM+M+SG
extasinho	êxtase+N+DIM+M+SG
êxtases	êxtase+N+M+PL
êxtase	êxtase+N+M+SG
íbis	íbis+N
ibisinhas	íbis+N+DIM+F+PL
ibisinha	íbis+N+DIM+F+SG
ibisinhos	íbis+N+DIM+M+PL
ibisinho	íbis+N+DIM+M+SG
icarinhos	ícaro+N+DIM+M+PL
icarozinhos	ícaro+N+DIM+M+PL
icarinho	ícaro+N+DIM+M+SG
icarozinho	ícaro+N+DIM+M+SG
ícaros	ícaro+N+M+PL
ícaro	ícaro+N+M+SG
iconezinhos	ícone+N+DIM+M+PL
iconinhos	ícone+N+DIM+M+PL
iconezinho	ícone+N+DIM+M+SG
iconinho	ícone+N+DIM+M+SG
ícones	ícone+N+M+PL
ícone	ícone+N+M+SG
idolazinhas	ídola+N+DIM+F+PL
idolinhas	ídola+N+DIM+F+PL
idolazinha	ídola+N+DIM+F+SG
idolinha	ídola+N+DIM+F+SG
ídolas	ídola+N+F+PL
ídola	ídola+N+F+SG
idolinhos	ídolo+N+DIM+M+PL
idolozinhos	ídolo+N+DIM+M+PL
idolinho	ídolo+N+DIM+M+SG
idolozinho	ídolo+N+DIM+M+SG
ídolos	ídolo+N+M+PL
ídolo	ídolo+N+M+SG
ileinhos	íleo+N+DIM+M+PL
ileozinhos	íleo+N+DIM+M+PL
ileinho	íleo+N+DIM+M+SG
ileozinho	íleo+N+DIM+M+SG
íleos	íleo+N+M+PL
íleo	íleo+N+M+SG
ilinhos	ílio+N+DIM+M+PL
iliozinhos	ílio+N+DIM+M+PL
ilinho	ílio+N+DIM+M+SG
iliozinho	ílio+N+DIM+M+SG
ílios	ílio+N+M+PL
ílio	ílio+N+M+SG
ilionzinhos	ílion+N+DIM+M+PL
ilionzinho	ílion+N+DIM+M+SG
ílions	ílion+N+M+PL
ílion	ílion+N+M+SG
imanzinhos	íman+N+DIM+M+PL
imanzinho	íman+N+DIM+M+SG
ímans	íman+N+M+PL
íman	íman+N+M+SG
imparezinhas	ímpar+N+DIM+F+PL
imparzinhas	ímpar+N+DIM+F+PL
imparzinha	ímpar+N+DIM+F+SG
imparezinhos	ímpar+N+DIM+M+PL
imparzinhos	ímpar+N+DIM+M+PL
imparzinho	ímpar+N+DIM+M+SG
ímpares	ímpar+N+PL
ímpar	ímpar+N+SG
imparidadezinhas	ímparidade+N+DIM+F+PL
imparidadinhas	ímparidade+N+DIM+F+PL
imparidadezinha	ímparidade+N+DIM+F+SG
imparidadinha	ímparidade+N+DIM+F+SG
ímparidades	ímparidade+N+F+PL
ímparidade	ímparidade+N+F+SG
impetinhos	ímpeto+N+DIM+M+PL
impetozinhos	ímpeto+N+DIM+M+PL
impetinho	ímpeto+N+DIM+M+SG
impetozinho	ímpeto+N+DIM+M+SG
ímpetos	ímpeto+N+M+PL
ímpeto	ímpeto+N+M+SG
impiazinhas	ímpio+N+DIM+F+PL
impinhas	ímpio+N+DIM+F+PL
impiazinha	ímpio+N+DIM+F+SG
impinha	ímpio+N+DIM+F+SG
impinhos	ímpio+N+DIM+M+PL
impiozinhos	ímpio+N+DIM+M+PL
impinho	ímpio+N+DIM+M+SG
impiozinho	ímpio+N+DIM+M+SG
ímpias	ímpio+N+F+PL
ímpia	ímpio+N+F+SG
ímpios	ímpio+N+M+PL
ímpio	ímpio+N+M+SG
imãzinhos	ímã+N+DIM+M+PL
imãzinho	ímã+N+DIM+M+SG
ímãs	ímã+N+M+PL
ímã	ímã+N+M+SG
incolazinhas	íncola+N+DIM+F+PL
incolazinha	íncola+N+DIM+F+SG
incolazinhos	íncola+N+DIM+M+PL
incolazinho	íncola+N+DIM+M+SG
incolinhas	íncola+N+DIM+PL
incolinha	íncola+N+DIM+SG
íncolas	íncola+N+PL
íncola	íncola+N+SG
incubinhos	íncubo+N+DIM+M+PL
incubozinhos	íncubo+N+DIM+M+PL
incubinho	íncubo+N+DIM+M+SG
incubozinho	íncubo+N+DIM+M+SG
íncubos	íncubo+N+M+PL
íncubo	íncubo+N+M+SG
indicezinhos	índex+N+DIM+M+PL
indexzinho	índex+N+DIM+M+SG
índices	índex+N+M+PL
índex	índex+N+M+SG
indicezinhos	índice+N+DIM+M+PL
indicinhos	índice+N+DIM+M+PL
indicezinho	índice+N+DIM+M+SG
indicinho	índice+N+DIM+M+SG
índices	índice+N+M+PL
índice	índice+N+M+SG
indigozinhos	índigo+N+DIM+M+PL
indiguinhos	índigo+N+DIM+M+PL
indigozinho	índigo+N+DIM+M+SG
indiguinho	índigo+N+DIM+M+SG
índigos	índigo+N+M+PL
índigo	índigo+N+M+SG
indiazinhas	índio+N+DIM+F+PL
indinhas	índio+N+DIM+F+PL
indiazinha	índio+N+DIM+F+SG
indinha	índio+N+DIM+F+SG
indinhos	índio+N+DIM+M+PL
indiozinhos	índio+N+DIM+M+PL
indinho	índio+N+DIM+M+SG
indiozinho	índio+N+DIM+M+SG
índias	índio+N+F+PL
índia	índio+N+F+SG
índios	índio+N+M+PL
índio	índio+N+M+SG
indolezinhas	índole+N+DIM+F+PL
indolinhas	índole+N+DIM+F+PL
indolezinha	índole+N+DIM+F+SG
indolinha	índole+N+DIM+F+SG
índoles	índole+N+F+PL
índole	índole+N+F+SG
induazinhas	índua+N+DIM+F+PL
induinhas	índua+N+DIM+F+PL
induazinha	índua+N+DIM+F+SG
induinha	índua+N+DIM+F+SG
índuas	índua+N+F+PL
índua	índua+N+F+SG
inguazinhas	íngua+N+DIM+F+PL
inguinhas	íngua+N+DIM+F+PL
inguazinha	íngua+N+DIM+F+SG
inguinha	íngua+N+DIM+F+SG
ínguas	íngua+N+F+PL
íngua	íngua+N+F+SG
ininhos	ínio+N+DIM+M+PL
iniozinhos	ínio+N+DIM+M+PL
ininho	ínio+N+DIM+M+SG
iniozinho	ínio+N+DIM+M+SG
ínios	ínio+N+M+PL
ínio	ínio+N+M+SG
insuazinhas	ínsua+N+DIM+F+PL
insuinhas	ínsua+N+DIM+F+PL
insuazinha	ínsua+N+DIM+F+SG
insuinha	ínsua+N+DIM+F+SG
ínsuas	ínsua+N+F+PL
ínsua	ínsua+N+F+SG
insulazinhas	ínsula+N+DIM+F+PL
insulinhas	ínsula+N+DIM+F+PL
insulazinha	ínsula+N+DIM+F+SG
insulinha	ínsula+N+DIM+F+SG
ínsulas	ínsula+N+F+PL
ínsula	ínsula+N+F+SG
integrazinhas	íntegra+N+DIM+F+PL
integrinhas	íntegra+N+DIM+F+PL
integrazinha	íntegra+N+DIM+F+SG
integrinha	íntegra+N+DIM+F+SG
íntegras	íntegra+N+F+PL
íntegra	íntegra+N+F+SG
integrazinhas	íntegro+N+DIM+F+PL
integrinhas	íntegro+N+DIM+F+PL
integrazinha	íntegro+N+DIM+F+SG
integrinha	íntegro+N+DIM+F+SG
integrinhos	íntegro+N+DIM+M+PL
integrozinhos	íntegro+N+DIM+M+PL
integrinho	íntegro+N+DIM+M+SG
integrozinho	íntegro+N+DIM+M+SG
íntegras	íntegro+N+F+PL
íntegra	íntegro+N+F+SG
íntegros	íntegro+N+M+PL
íntegro	íntegro+N+M+SG
interinzinhos	ínterim+N+DIM+M+PL
interinzinho	ínterim+N+DIM+M+SG
ínterins	ínterim+N+M+PL
ínterim	ínterim+N+M+SG
intimazinhas	íntimo+N+DIM+F+PL
intiminhas	íntimo+N+DIM+F+PL
intimazinha	íntimo+N+DIM+F+SG
intiminha	íntimo+N+DIM+F+SG
intiminhos	íntimo+N+DIM+M+PL
intimozinhos	íntimo+N+DIM+M+PL
intiminho	íntimo+N+DIM+M+SG
intimozinho	íntimo+N+DIM+M+SG
íntimas	íntimo+N+F+PL
íntima	íntimo+N+F+SG
íntimos	íntimo+N+M+PL
íntimo	íntimo+N+M+SG
ionzinhos	íon+N+DIM+M+PL
ionzinho	íon+N+DIM+M+SG
íons	íon+N+M+PL
íon	íon+N+M+SG
ipsilinhos	ípsilo+N+DIM+M+PL
ipsilozinhos	ípsilo+N+DIM+M+PL
ipsilinho	ípsilo+N+DIM+M+SG
ipsilozinho	ípsilo+N+DIM+M+SG
ípsilos	ípsilo+N+M+PL
ípsilo	ípsilo+N+M+SG
ipsilonzinhos	ípsilon+N+DIM+M+PL
ipsilonzinho	ípsilon+N+DIM+M+SG
ípsilons	ípsilon+N+M+PL
ípsilon	ípsilon+N+M+SG
íris	íris+N
irisinhas	íris+N+DIM+F+PL
irisinha	íris+N+DIM+F+SG
irisinhos	íris+N+DIM+M+PL
irisinho	íris+N+DIM+M+SG
isquinhos	ísquio+N+DIM+M+PL
isquiozinhos	ísquio+N+DIM+M+PL
isquinho	ísquio+N+DIM+M+SG
isquiozinho	ísquio+N+DIM+M+SG
ísquios	ísquio+N+M+PL
ísquio	ísquio+N+M+SG
isquionzinhos	ísquion+N+DIM+M+PL
isquionzinho	ísquion+N+DIM+M+SG
ísquions	ísquion+N+M+PL
ísquion	ísquion+N+M+SG
istmicazinhas	ístmico+N+DIM+F+PL
istmiquinhas	ístmico+N+DIM+F+PL
istmicazinha	ístmico+N+DIM+F+SG
istmiquinha	ístmico+N+DIM+F+SG
istmicozinhos	ístmico+N+DIM+M+PL
istmiquinhos	ístmico+N+DIM+M+PL
istmicozinho	ístmico+N+DIM+M+SG
istmiquinho	ístmico+N+DIM+M+SG
ístmicas	ístmico+N+F+PL
ístmica	ístmico+N+F+SG
ístmicos	ístmico+N+M+PL
ístmico	ístmico+N+M+SG
istmicosinhas	ístmicos+N+DIM+F+PL
istmicosinhos	ístmicos+N+DIM+M+PL
ístmicos	ístmicos+N+M+PL
italazinhas	ítalo+N+DIM+F+PL
italinhas	ítalo+N+DIM+F+PL
italazinha	ítalo+N+DIM+F+SG
italinha	ítalo+N+DIM+F+SG
italinhos	ítalo+N+DIM+M+PL
italozinhos	ítalo+N+DIM+M+PL
italinho	ítalo+N+DIM+M+SG
italozinho	ítalo+N+DIM+M+SG
ítalas	ítalo+N+F+PL
ítala	ítalo+N+F+SG
ítalos	ítalo+N+M+PL
ítalo	ítalo+N+M+SG
itrinhos	ítrio+N+DIM+M+PL
itriozinhos	ítrio+N+DIM+M+PL
itrinho	ítrio+N+DIM+M+SG
itriozinho	ítrio+N+DIM+M+SG
ítrios	ítrio+N+M+PL
ítrio	ítrio+N+M+SG
ozinhos	ó+N+DIM+M+PL
ozinho	ó+N+DIM+M+SG
ós	ó+N+M+PL
ó	ó+N+M+SG
obelinhos	óbelo+N+DIM+M+PL
obelozinhos	óbelo+N+DIM+M+PL
obelinho	óbelo+N+DIM+M+SG
obelozinho	óbelo+N+DIM+M+SG
óbelos	óbelo+N+M+PL
óbelo	óbelo+N+M+SG
obicezinhos	óbice+N+DIM+M+PL
obicinhos	óbice+N+DIM+M+PL
obicezinho	óbice+N+DIM+M+SG
obicinho	óbice+N+DIM+M+SG
óbices	óbice+N+M+PL
óbice	óbice+N+M+SG
obitinhos	óbito+N+DIM+M+PL
obitozinhos	óbito+N+DIM+M+PL
obitinho	óbito+N+DIM+M+SG
obitozinho	óbito+N+DIM+M+SG
óbitos	óbito+N+M+PL
óbito	óbito+N+M+SG
obolinhos	óbolo+N+DIM+M+PL
obolozinhos	óbolo+N+DIM+M+PL
obolinho	óbolo+N+DIM+M+SG
obolozinho	óbolo+N+DIM+M+SG
óbolos	óbolo+N+M+PL
óbolo	óbolo+N+M+SG
occiputezinhos	ócciput+N+DIM+M+PL
occiputzinho	ócciput+N+DIM+M+SG
ócciputes	ócciput+N+M+PL
ócciput	ócciput+N+M+SG
ocinhos	ócio+N+DIM+M+PL
ociozinhos	ócio+N+DIM+M+PL
ocinho	ócio+N+DIM+M+SG
ociozinho	ócio+N+DIM+M+SG
ócios	ócio+N+M+PL
ócio	ócio+N+M+SG
ocreazinhas	ócrea+N+DIM+F+PL
ocreinhas	ócrea+N+DIM+F+PL
ocreazinha	ócrea+N+DIM+F+SG
ocreinha	ócrea+N+DIM+F+SG
ócreas	ócrea+N+F+PL
ócrea	ócrea+N+F+SG
octuplinhos	óctuplo+N+DIM+M+PL
octuplozinhos	óctuplo+N+DIM+M+PL
octuplinho	óctuplo+N+DIM+M+SG
octuplozinho	óctuplo+N+DIM+M+SG
óctuplos	óctuplo+N+M+PL
óctuplo	óctuplo+N+M+SG
oculinhos	óculo+N+DIM+M+PL
oculozinhos	óculo+N+DIM+M+PL
oculinho	óculo+N+DIM+M+SG
oculozinho	óculo+N+DIM+M+SG
óculos	óculo+N+M+PL
óculo	óculo+N+M+SG
oculosinhas	óculos+N+DIM+F+PL
oculosinhos	óculos+N+DIM+M+PL
oculosinho	óculos+N+DIM+M+SG
óculos	óculos+N+M
odinhos	ódio+N+DIM+M+PL
odiozinhos	ódio+N+DIM+M+PL
odiozitos	ódio+N+DIM+M+PL
odinho	ódio+N+DIM+M+SG
odiozinho	ódio+N+DIM+M+SG
odiozito	ódio+N+DIM+M+SG
ódios	ódio+N+M+PL
ódio	ódio+N+M+SG
ofrinhos	ófrio+N+DIM+M+PL
ofriozinhos	ófrio+N+DIM+M+PL
ofrinho	ófrio+N+DIM+M+SG
ofriozinho	ófrio+N+DIM+M+SG
ófrios	ófrio+N+M+PL
ófrio	ófrio+N+M+SG
olacezinhos	ólace+N+DIM+M+PL
olacinhos	ólace+N+DIM+M+PL
olacezinho	ólace+N+DIM+M+SG
olacinho	ólace+N+DIM+M+SG
ólaces	ólace+N+M+PL
ólace	ólace+N+M+SG
oleinhos	óleo+N+DIM+M+PL
oleozinhos	óleo+N+DIM+M+PL
oleinho	óleo+N+DIM+M+SG
oleozinho	óleo+N+DIM+M+SG
óleos	óleo+N+M+PL
óleo	óleo+N+M+SG
omegazinhos	ómega+N+DIM+M+PL
omeguinhas	ómega+N+DIM+M+PL
omegazinho	ómega+N+DIM+M+SG
omeguinha	ómega+N+DIM+M+SG
ómegas	ómega+N+M+PL
ómega	ómega+N+M+SG
omicrinhos	ómicro+N+DIM+M+PL
omicrozinhos	ómicro+N+DIM+M+PL
omicrinho	ómicro+N+DIM+M+SG
omicrozinho	ómicro+N+DIM+M+SG
ómicros	ómicro+N+M+PL
ómicro	ómicro+N+M+SG
omicronzinhos	ómicron+N+DIM+M+PL
omicronzinho	ómicron+N+DIM+M+SG
ómicrons	ómicron+N+M+PL
ómicron	ómicron+N+M+SG
onagrazinhas	ónagra+N+DIM+F+PL
onagrinhas	ónagra+N+DIM+F+PL
onagrazinha	ónagra+N+DIM+F+SG
onagrinha	ónagra+N+DIM+F+SG
ónagras	ónagra+N+F+PL
ónagra	ónagra+N+F+SG
onagrinhos	ónagro+N+DIM+M+PL
onagrozinhos	ónagro+N+DIM+M+PL
onagrinho	ónagro+N+DIM+M+SG
onagrozinho	ónagro+N+DIM+M+SG
onagros	ónagro+N+M+PL
ónagros	ónagro+N+M+PL
onagro	ónagro+N+M+SG
ónagro	ónagro+N+M+SG
onibusinhas	ónibus+N+DIM+F+PL
onibusinhos	ónibus+N+DIM+M+PL
onibusinho	ónibus+N+DIM+M+SG
ónibus	ónibus+N+M
onixzinhos	ónix+N+DIM+M+PL
onixzinho	ónix+N+DIM+M+SG
ónix	ónix+N+M
onusinhas	ónus+N+DIM+F+PL
onusinhos	ónus+N+DIM+M+PL
onusinho	ónus+N+DIM+M+SG
ónus	ónus+N+M
opalinhos	ópalo+N+DIM+M+PL
opalozinhos	ópalo+N+DIM+M+PL
opalinho	ópalo+N+DIM+M+SG
opalozinho	ópalo+N+DIM+M+SG
ópalos	ópalo+N+M+PL
ópalo	ópalo+N+M+SG
operazinhas	ópera+N+DIM+F+PL
operinhas	ópera+N+DIM+F+PL
operazinha	ópera+N+DIM+F+SG
operinha	ópera+N+DIM+F+SG
óperas	ópera+N+F+PL
ópera	ópera+N+F+SG
opidinhos	ópido+N+DIM+M+PL
opidozinhos	ópido+N+DIM+M+PL
opidinho	ópido+N+DIM+M+SG
opidozinho	ópido+N+DIM+M+SG
ópidos	ópido+N+M+PL
ópido	ópido+N+M+SG
opinhos	ópio+N+DIM+M+PL
opiozinhos	ópio+N+DIM+M+PL
opinho	ópio+N+DIM+M+SG
opiozinho	ópio+N+DIM+M+SG
ópios	ópio+N+M+PL
ópio	ópio+N+M+SG
opticazinhas	óptica+N+DIM+F+PL
optiquinhas	óptica+N+DIM+F+PL
opticazinha	óptica+N+DIM+F+SG
optiquinha	óptica+N+DIM+F+SG
ópticas	óptica+N+F+PL
óptica	óptica+N+F+SG
opticazinhas	óptico+N+DIM+F+PL
optiquinhas	óptico+N+DIM+F+PL
opticazinha	óptico+N+DIM+F+SG
optiquinha	óptico+N+DIM+F+SG
opticozinhos	óptico+N+DIM+M+PL
optiquinhos	óptico+N+DIM+M+PL
opticozinho	óptico+N+DIM+M+SG
optiquinho	óptico+N+DIM+M+SG
ópticas	óptico+N+F+PL
óptica	óptico+N+F+SG
ópticos	óptico+N+M+PL
óptico	óptico+N+M+SG
optiminhos	óptimo+N+DIM+M+PL
optimozinhos	óptimo+N+DIM+M+PL
optiminho	óptimo+N+DIM+M+SG
optimozinho	óptimo+N+DIM+M+SG
óptimos	óptimo+N+M+PL
óptimo	óptimo+N+M+SG
orbitazinhas	órbita+N+DIM+F+PL
orbitinhas	órbita+N+DIM+F+PL
orbitazinha	órbita+N+DIM+F+SG
orbitinha	órbita+N+DIM+F+SG
órbitas	órbita+N+F+PL
órbita	órbita+N+F+SG
orfãzinhas	órfão+N+DIM+F+PL
orfãzinha	órfão+N+DIM+F+SG
orfãozinhos	órfão+N+DIM+M+PL
orfãozinho	órfão+N+DIM+M+SG
órfãs	órfão+N+F+PL
órfã	órfão+N+F+SG
órfãos	órfão+N+M+PL
órfão	órfão+N+M+SG
orgãozinhos	órgão+N+DIM+M+PL
orgãozinho	órgão+N+DIM+M+SG
órgãos	órgão+N+M+PL
órgão	órgão+N+M+SG
orobinhos	órobo+N+DIM+M+PL
orobozinhos	órobo+N+DIM+M+PL
orobinho	órobo+N+DIM+M+SG
orobozinho	órobo+N+DIM+M+SG
órobos	órobo+N+M+PL
órobo	órobo+N+M+SG
oscarezinhos	óscar+N+DIM+M+PL
oscarzinhos	óscar+N+DIM+M+PL
oscarzinho	óscar+N+DIM+M+SG
óscares	óscar+N+M+PL
óscar	óscar+N+M+SG
osculinhos	ósculo+N+DIM+M+PL
osculozinhos	ósculo+N+DIM+M+PL
osculinho	ósculo+N+DIM+M+SG
osculozinho	ósculo+N+DIM+M+SG
ósculos	ósculo+N+M+PL
ósculo	ósculo+N+M+SG
osminhos	ósmio+N+DIM+M+PL
osmiozinhos	ósmio+N+DIM+M+PL
osminho	ósmio+N+DIM+M+SG
osmiozinho	ósmio+N+DIM+M+SG
ósmios	ósmio+N+M+PL
ósmio	ósmio+N+M+SG
oticazinhas	ótica+N+DIM+F+PL
otiquinhas	ótica+N+DIM+F+PL
oticazinha	ótica+N+DIM+F+SG
otiquinha	ótica+N+DIM+F+SG
óticas	ótica+N+F+PL
ótica	ótica+N+F+SG
ovalinhos	óvalo+N+DIM+M+PL
ovalozinhos	óvalo+N+DIM+M+PL
ovalinho	óvalo+N+DIM+M+SG
ovalozinho	óvalo+N+DIM+M+SG
óvalos	óvalo+N+M+PL
óvalo	óvalo+N+M+SG
ovaninhos	óvano+N+DIM+M+PL
ovanozinhos	óvano+N+DIM+M+PL
ovaninho	óvano+N+DIM+M+SG
ovanozinho	óvano+N+DIM+M+SG
óvanos	óvano+N+M+PL
óvano	óvano+N+M+SG
ovnizinhos	óvni+N+DIM+M+PL
ovnizinho	óvni+N+DIM+M+SG
óvnis	óvni+N+M+PL
óvni	óvni+N+M+SG
ovulinhos	óvulo+N+DIM+M+PL
ovulozinhos	óvulo+N+DIM+M+PL
ovulinho	óvulo+N+DIM+M+SG
ovulozinho	óvulo+N+DIM+M+SG
óvulos	óvulo+N+M+PL
óvulo	óvulo+N+M+SG
oxidinhos	óxido+N+DIM+M+PL
oxidozinhos	óxido+N+DIM+M+PL
oxidinho	óxido+N+DIM+M+SG
oxidozinho	óxido+N+DIM+M+SG
óxidos	óxido+N+M+PL
óxido	óxido+N+M+SG
omegazinhos	ômega+N+DIM+M+PL
omeguinhas	ômega+N+DIM+M+PL
omegazinho	ômega+N+DIM+M+SG
omeguinha	ômega+N+DIM+M+SG
ômegas	ômega+N+M+PL
ômega	ômega+N+M+SG
omicronezinhos	ômicron+N+DIM+M+PL
omicronzinho	ômicron+N+DIM+M+SG
ômicrones	ômicron+N+M+PL
ômicron	ômicron+N+M+SG
onagrazinhas	ônagra+N+DIM+F+PL
onagrinhas	ônagra+N+DIM+F+PL
onagrazinha	ônagra+N+DIM+F+SG
onagrinha	ônagra+N+DIM+F+SG
ônagras	ônagra+N+F+PL
ônagra	ônagra+N+F+SG
onagrinhos	ônagro+N+DIM+M+PL
onagrozinhos	ônagro+N+DIM+M+PL
onagrinho	ônagro+N+DIM+M+SG
onagrozinho	ônagro+N+DIM+M+SG
ônagros	ônagro+N+M+PL
ônagro	ônagro+N+M+SG
ondulazinhas	ôndula+N+DIM+F+PL
ondulinhas	ôndula+N+DIM+F+PL
ondulazinha	ôndula+N+DIM+F+SG
ondulinha	ôndula+N+DIM+F+SG
ôndulas	ôndula+N+F+PL
ôndula	ôndula+N+F+SG
onibusinhas	ônibus+N+DIM+F+PL
onibusinhos	ônibus+N+DIM+M+PL
onibusinho	ônibus+N+DIM+M+SG
ônibus	ônibus+N+M
onixzinhos	ônix+N+DIM+M+PL
onixzinho	ônix+N+DIM+M+SG
ônix	ônix+N+M
onticazinhas	ôntico+N+DIM+F+PL
ontiquinhas	ôntico+N+DIM+F+PL
onticazinha	ôntico+N+DIM+F+SG
ontiquinha	ôntico+N+DIM+F+SG
onticozinhos	ôntico+N+DIM+M+PL
ontiquinhos	ôntico+N+DIM+M+PL
onticozinho	ôntico+N+DIM+M+SG
ontiquinho	ôntico+N+DIM+M+SG
ônticas	ôntico+N+F+PL
ôntica	ôntico+N+F+SG
ônticos	ôntico+N+M+PL
ôntico	ôntico+N+M+SG
onusinhas	ônus+N+DIM+F+PL
onusinhos	ônus+N+DIM+M+PL
onusinho	ônus+N+DIM+M+SG
ônus	ônus+N+M
uberezinhas	úbere+N+DIM+F+PL
uberinhas	úbere+N+DIM+F+PL
uberzinhas	úbere+N+DIM+F+PL
uberezinha	úbere+N+DIM+F+SG
uberinha	úbere+N+DIM+F+SG
uberezinhos	úbere+N+DIM+M+PL
uberinhos	úbere+N+DIM+M+PL
uberzinhos	úbere+N+DIM+M+PL
uberezinho	úbere+N+DIM+M+SG
uberinho	úbere+N+DIM+M+SG
úberes	úbere+N+PL
úbere	úbere+N+SG
uberinhos	úbero+N+DIM+M+PL
uberozinhos	úbero+N+DIM+M+PL
uberinho	úbero+N+DIM+M+SG
uberozinho	úbero+N+DIM+M+SG
úberos	úbero+N+M+PL
úbero	úbero+N+M+SG
ulcerazinhas	úlcera+N+DIM+F+PL
ulcerinhas	úlcera+N+DIM+F+PL
ulcerazinha	úlcera+N+DIM+F+SG
ulcerinha	úlcera+N+DIM+F+SG
úlceras	úlcera+N+F+PL
úlcera	úlcera+N+F+SG
ultimazinhas	última+N+DIM+F+PL
ultiminhas	última+N+DIM+F+PL
ultimazinha	última+N+DIM+F+SG
ultiminha	última+N+DIM+F+SG
últimas	última+N+F+PL
última	última+N+F+SG
ultimazinhas	último+N+DIM+F+PL
ultiminhas	último+N+DIM+F+PL
ultimazinha	último+N+DIM+F+SG
ultiminha	último+N+DIM+F+SG
ultiminhos	último+N+DIM+M+PL
ultimozinhos	último+N+DIM+M+PL
ultiminho	último+N+DIM+M+SG
ultimozinho	último+N+DIM+M+SG
últimos	último+N+M+PL
último	último+N+M+SG
umbriazinhas	úmbrio+N+DIM+F+PL
umbrinhas	úmbrio+N+DIM+F+PL
umbriazinha	úmbrio+N+DIM+F+SG
umbrinha	úmbrio+N+DIM+F+SG
umbrinhos	úmbrio+N+DIM+M+PL
umbriozinhos	úmbrio+N+DIM+M+PL
umbrinho	úmbrio+N+DIM+M+SG
umbriozinho	úmbrio+N+DIM+M+SG
úmbrias	úmbrio+N+F+PL
úmbria	úmbrio+N+F+SG
úmbrios	úmbrio+N+M+PL
úmbrio	úmbrio+N+M+SG
umerinhos	úmero+N+DIM+M+PL
umerozinhos	úmero+N+DIM+M+PL
umerinho	úmero+N+DIM+M+SG
umerozinho	úmero+N+DIM+M+SG
úmeros	úmero+N+M+PL
úmero	úmero+N+M+SG
unguezinhos	úngue+N+DIM+M+PL
unguinhos	úngue+N+DIM+M+PL
unguezinho	úngue+N+DIM+M+SG
unguinho	úngue+N+DIM+M+SG
úngues	úngue+N+M+PL
úngue	úngue+N+M+SG
unguisinhas	únguis+N+DIM+F+PL
unguisinhos	únguis+N+DIM+M+PL
unguisinho	únguis+N+DIM+M+SG
únguis	únguis+N+M
ungulazinhas	úngula+N+DIM+F+PL
ungulinhas	úngula+N+DIM+F+PL
ungulazinha	úngula+N+DIM+F+SG
ungulinha	úngula+N+DIM+F+SG
úngulas	úngula+N+F+PL
úngula	úngula+N+F+SG
ungüezinhos	úngüe+N+DIM+M+PL
ungüinhos	úngüe+N+DIM+M+PL
ungüezinho	úngüe+N+DIM+M+SG
ungüinho	úngüe+N+DIM+M+SG
úngües	úngüe+N+M+PL
úngüe	úngüe+N+M+SG
unicazinhas	único+N+DIM+F+PL
uniquinhas	único+N+DIM+F+PL
unicazinha	único+N+DIM+F+SG
uniquinha	único+N+DIM+F+SG
unicozinhos	único+N+DIM+M+PL
uniquinhos	único+N+DIM+M+PL
unicozinho	único+N+DIM+M+SG
uniquinho	único+N+DIM+M+SG
únicas	único+N+F+PL
única	único+N+F+SG
únicos	único+N+M+PL
único	único+N+M+SG
urnulazinhas	úrnula+N+DIM+F+PL
urnulinhas	úrnula+N+DIM+F+PL
urnulazinha	úrnula+N+DIM+F+SG
urnulinha	úrnula+N+DIM+F+SG
úrnulas	úrnula+N+F+PL
úrnula	úrnula+N+F+SG
usneazinhas	úsnea+N+DIM+F+PL
usneinhas	úsnea+N+DIM+F+PL
usneazinha	úsnea+N+DIM+F+SG
usneinha	úsnea+N+DIM+F+SG
úsneas	úsnea+N+F+PL
úsnea	úsnea+N+F+SG
ustiazinhas	ústia+N+DIM+F+PL
ustinhas	ústia+N+DIM+F+PL
ustiazinha	ústia+N+DIM+F+SG
ustinha	ústia+N+DIM+F+SG
ústias	ústia+N+F+PL
ústia	ústia+N+F+SG
uterinhos	útero+N+DIM+M+PL
uterozinhos	útero+N+DIM+M+PL
uterinho	útero+N+DIM+M+SG
uterozinho	útero+N+DIM+M+SG
úteros	útero+N+M+PL
útero	útero+N+M+SG
uteizinhas	útil+N+DIM+F+PL
utilzinha	útil+N+DIM+F+SG
uteizinhos	útil+N+DIM+M+PL
utilzinho	útil+N+DIM+M+SG
úteis	útil+N+PL
útil	útil+N+SG
uvulazinhas	úvula+N+DIM+F+PL
uvulinhas	úvula+N+DIM+F+PL
uvulazinha	úvula+N+DIM+F+SG
uvulinha	úvula+N+DIM+F+SG
úvulas	úvula+N+F+PL
úvula	úvula+N+F+SG
