q	q+N+M+SG
qq	q+N+M+PL
quacre	quacre+N+SG
quacres	quacre+N+PL
quacrezinha	quacre+N+DIM+F+SG
quacrezinhas	quacre+N+DIM+F+PL
quacrezinho	quacre+N+DIM+M+SG
quacrezinhos	quacre+N+DIM+M+PL
quacrinha	quacre+N+DIM+F+SG
quacrinhas	quacre+N+DIM+F+PL
quacrinho	quacre+N+DIM+M+SG
quacrinhos	quacre+N+DIM+M+PL
quacrisminho	quacrismo+N+DIM+M+SG
quacrisminhos	quacrismo+N+DIM+M+PL
quacrismo	quacrismo+N+M+SG
quacrismos	quacrismo+N+M+PL
quacrismozinho	quacrismo+N+DIM+M+SG
quacrismozinhos	quacrismo+N+DIM+M+PL
quaderna	quaderna+N+F+SG
quadernas	quaderna+N+F+PL
quadernazinha	quaderna+N+DIM+F+SG
quadernazinhas	quaderna+N+DIM+F+PL
quaderninha	quaderna+N+DIM+F+SG
quaderninhas	quaderna+N+DIM+F+PL
quadernais	quadernal+N+M+PL
quadernaizinhos	quadernal+N+DIM+M+PL
quadernal	quadernal+N+M+SG
quadernalzinho	quadernal+N+DIM+M+SG
quadra	quadra+N+F+SG
quadras	quadra+N+F+PL
quadrazinha	quadra+N+DIM+F+SG
quadrazinhas	quadra+N+DIM+F+PL
quadrinha	quadra+N+DIM+F+SG
quadrinhas	quadra+N+DIM+F+PL
quadrita	quadra+N+DIM+F+SG
quadritas	quadra+N+DIM+F+PL
quadrada	quadrado+N+F+SG
quadradas	quadrado+N+F+PL
quadradazinha	quadrado+N+DIM+F+SG
quadradazinhas	quadrado+N+DIM+F+PL
quadradinha	quadrado+N+DIM+F+SG
quadradinhas	quadrado+N+DIM+F+PL
quadradinho	quadrado+N+DIM+M+SG
quadradinhos	quadrado+N+DIM+M+PL
quadradito	quadrado+N+DIM+M+SG
quadraditos	quadrado+N+DIM+M+PL
quadrado	quadrado+N+M+SG
quadrados	quadrado+N+M+PL
quadradozinho	quadrado+N+DIM+M+SG
quadradozinhos	quadrado+N+DIM+M+PL
quadrador	quadrador+N+M+SG
quadradora	quadrador+N+F+SG
quadradoras	quadrador+N+F+PL
quadradorazinha	quadrador+N+DIM+F+SG
quadradorazinhas	quadrador+N+DIM+F+PL
quadradores	quadrador+N+M+PL
quadradorezinhos	quadrador+N+DIM+M+PL
quadradorinha	quadrador+N+DIM+F+SG
quadradorinhas	quadrador+N+DIM+F+PL
quadradorzinho	quadrador+N+DIM+M+SG
quadradorzinhos	quadrador+N+DIM+M+PL
quadradura	quadradura+N+F+SG
quadraduras	quadradura+N+F+PL
quadradurazinha	quadradura+N+DIM+F+SG
quadradurazinhas	quadradura+N+DIM+F+PL
quadradurinha	quadradura+N+DIM+F+SG
quadradurinhas	quadradura+N+DIM+F+PL
quadragenariazinha	quadragenário+N+DIM+F+SG
quadragenariazinhas	quadragenário+N+DIM+F+PL
quadragenarinha	quadragenário+N+DIM+F+SG
quadragenarinhas	quadragenário+N+DIM+F+PL
quadragenarinho	quadragenário+N+DIM+M+SG
quadragenarinhos	quadragenário+N+DIM+M+PL
quadragenariozinho	quadragenário+N+DIM+M+SG
quadragenariozinhos	quadragenário+N+DIM+M+PL
quadragenária	quadragenário+N+F+SG
quadragenárias	quadragenário+N+F+PL
quadragenário	quadragenário+N+M+SG
quadragenários	quadragenário+N+M+PL
quadragesimalidade	quadragesimalidade+N+F+SG
quadragesimalidades	quadragesimalidade+N+F+PL
quadragesimalidadezinha	quadragesimalidade+N+DIM+F+SG
quadragesimalidadezinhas	quadragesimalidade+N+DIM+F+PL
quadragesimalidadinha	quadragesimalidade+N+DIM+F+SG
quadragesimalidadinhas	quadragesimalidade+N+DIM+F+PL
quadragesimazinha	quadragésima+N+DIM+F+SG
quadragesimazinhas	quadragésima+N+DIM+F+PL
quadragesiminha	quadragésima+N+DIM+F+SG
quadragesiminhas	quadragésima+N+DIM+F+PL
quadragésima	quadragésima+N+F+SG
quadragésimas	quadragésima+N+F+PL
quadragesimazinha	quadragésimo+N+DIM+F+SG
quadragesimazinhas	quadragésimo+N+DIM+F+PL
quadragesiminha	quadragésimo+N+DIM+F+SG
quadragesiminhas	quadragésimo+N+DIM+F+PL
quadragesiminho	quadragésimo+N+DIM+M+SG
quadragesiminhos	quadragésimo+N+DIM+M+PL
quadragesimozinho	quadragésimo+N+DIM+M+SG
quadragesimozinhos	quadragésimo+N+DIM+M+PL
quadragésima	quadragésimo+N+F+SG
quadragésimas	quadragésimo+N+F+PL
quadragésimo	quadragésimo+N+M+SG
quadragésimos	quadragésimo+N+M+PL
quadrangular	quadrangular+N+SG
quadrangulares	quadrangular+N+PL
quadrangularezinhas	quadrangular+N+DIM+F+PL
quadrangularezinhos	quadrangular+N+DIM+M+PL
quadrangularzinha	quadrangular+N+DIM+F+SG
quadrangularzinhas	quadrangular+N+DIM+F+PL
quadrangularzinho	quadrangular+N+DIM+M+SG
quadrangularzinhos	quadrangular+N+DIM+M+PL
quadrangularidade	quadrangularidade+N+F+SG
quadrangularidades	quadrangularidade+N+F+PL
quadrangularidadezinha	quadrangularidade+N+DIM+F+SG
quadrangularidadezinhas	quadrangularidade+N+DIM+F+PL
quadrangularidadinha	quadrangularidade+N+DIM+F+SG
quadrangularidadinhas	quadrangularidade+N+DIM+F+PL
quadrangulação	quadrangulação+N+F+SG
quadrangulaçãozinha	quadrangulação+N+DIM+F+SG
quadrangulações	quadrangulação+N+F+PL
quadrangulaçõezinhas	quadrangulação+N+DIM+F+PL
quadrante	quadrante+N+M+SG
quadrantes	quadrante+N+M+PL
quadrantezinho	quadrante+N+DIM+M+SG
quadrantezinhos	quadrante+N+DIM+M+PL
quadrantinho	quadrante+N+DIM+M+SG
quadrantinhos	quadrante+N+DIM+M+PL
quadraticidade	quadraticidade+N+F+SG
quadraticidades	quadraticidade+N+F+PL
quadraticidadezinha	quadraticidade+N+DIM+F+SG
quadraticidadezinhas	quadraticidade+N+DIM+F+PL
quadraticidadinha	quadraticidade+N+DIM+F+SG
quadraticidadinhas	quadraticidade+N+DIM+F+PL
quadratim	quadratim+N+M+SG
quadratins	quadratim+N+M+PL
quadratinzinho	quadratim+N+DIM+M+SG
quadratinzinhos	quadratim+N+DIM+M+PL
quadratura	quadratura+N+F+SG
quadraturas	quadratura+N+F+PL
quadraturazinha	quadratura+N+DIM+F+SG
quadraturazinhas	quadratura+N+DIM+F+PL
quadraturinha	quadratura+N+DIM+F+SG
quadraturinhas	quadratura+N+DIM+F+PL
quadraturista	quadraturista+N+SG
quadraturistas	quadraturista+N+PL
quadraturistazinha	quadraturista+N+DIM+F+SG
quadraturistazinhas	quadraturista+N+DIM+F+PL
quadraturistazinho	quadraturista+N+DIM+M+SG
quadraturistazinhos	quadraturista+N+DIM+M+PL
quadraturistinha	quadraturista+N+DIM+SG
quadraturistinhas	quadraturista+N+DIM+PL
quadraçais	quadraçal+N+M+PL
quadraçaizinhos	quadraçal+N+DIM+M+PL
quadraçal	quadraçal+N+M+SG
quadraçalzinho	quadraçal+N+DIM+M+SG
quadrela	quadrela+N+F+SG
quadrelas	quadrela+N+F+PL
quadrelazinha	quadrela+N+DIM+F+SG
quadrelazinhas	quadrela+N+DIM+F+PL
quadrelinha	quadrela+N+DIM+F+SG
quadrelinhas	quadrela+N+DIM+F+PL
quadrelinho	quadrelo+N+DIM+M+SG
quadrelinhos	quadrelo+N+DIM+M+PL
quadrelo	quadrelo+N+M+SG
quadrelos	quadrelo+N+M+PL
quadrelozinho	quadrelo+N+DIM+M+SG
quadrelozinhos	quadrelo+N+DIM+M+PL
quadriaceleração	quadriaceleração+N+F+SG
quadriaceleraçãozinha	quadriaceleração+N+DIM+F+SG
quadriacelerações	quadriaceleração+N+F+PL
quadriaceleraçõezinhas	quadriaceleração+N+DIM+F+PL
quadricapsularidade	quadricapsularidade+N+F+SG
quadricapsularidades	quadricapsularidade+N+F+PL
quadricapsularidadezinha	quadricapsularidade+N+DIM+F+SG
quadricapsularidadezinhas	quadricapsularidade+N+DIM+F+PL
quadricapsularidadinha	quadricapsularidade+N+DIM+F+SG
quadricapsularidadinhas	quadricapsularidade+N+DIM+F+PL
quadricentenariazinha	quadricentenário+N+DIM+F+SG
quadricentenariazinhas	quadricentenário+N+DIM+F+PL
quadricentenarinha	quadricentenário+N+DIM+F+SG
quadricentenarinhas	quadricentenário+N+DIM+F+PL
quadricentenarinho	quadricentenário+N+DIM+M+SG
quadricentenarinhos	quadricentenário+N+DIM+M+PL
quadricentenariozinho	quadricentenário+N+DIM+M+SG
quadricentenariozinhos	quadricentenário+N+DIM+M+PL
quadricentenária	quadricentenário+N+F+SG
quadricentenárias	quadricentenário+N+F+PL
quadricentenário	quadricentenário+N+M+SG
quadricentenários	quadricentenário+N+M+PL
quadriciclinho	quadriciclo+N+DIM+M+SG
quadriciclinhos	quadriciclo+N+DIM+M+PL
quadriciclo	quadriciclo+N+M+SG
quadriciclos	quadriciclo+N+M+PL
quadriciclozinho	quadriciclo+N+DIM+M+SG
quadriciclozinhos	quadriciclo+N+DIM+M+PL
quadricromia	quadricromia+N+F+SG
quadricromias	quadricromia+N+F+PL
quadricromiazinha	quadricromia+N+DIM+F+SG
quadricromiazinhas	quadricromia+N+DIM+F+PL
quadricrominha	quadricromia+N+DIM+F+SG
quadricrominhas	quadricromia+N+DIM+F+PL
quadricromicidade	quadricromicidade+N+F+SG
quadricromicidades	quadricromicidade+N+F+PL
quadricromicidadezinha	quadricromicidade+N+DIM+F+SG
quadricromicidadezinhas	quadricromicidade+N+DIM+F+PL
quadricromicidadinha	quadricromicidade+N+DIM+F+SG
quadricromicidadinhas	quadricromicidade+N+DIM+F+PL
quadriculadinho	quadriculado+N+DIM+M+SG
quadriculadinhos	quadriculado+N+DIM+M+PL
quadriculado	quadriculado+N+M+SG
quadriculados	quadriculado+N+M+PL
quadriculadozinho	quadriculado+N+DIM+M+SG
quadriculadozinhos	quadriculado+N+DIM+M+PL
quadricularidade	quadricularidade+N+F+SG
quadricularidades	quadricularidade+N+F+PL
quadricularidadezinha	quadricularidade+N+DIM+F+SG
quadricularidadezinhas	quadricularidade+N+DIM+F+PL
quadricularidadinha	quadricularidade+N+DIM+F+SG
quadricularidadinhas	quadricularidade+N+DIM+F+PL
quadricipitezinho	quadricípite+N+DIM+M+SG
quadricipitezinhos	quadricípite+N+DIM+M+PL
quadricipitinho	quadricípite+N+DIM+M+SG
quadricipitinhos	quadricípite+N+DIM+M+PL
quadricípite	quadricípite+N+M+SG
quadricípites	quadricípite+N+M+PL
quadrienalidade	quadrienalidade+N+F+SG
quadrienalidades	quadrienalidade+N+F+PL
quadrienalidadezinha	quadrienalidade+N+DIM+F+SG
quadrienalidadezinhas	quadrienalidade+N+DIM+F+PL
quadrienalidadinha	quadrienalidade+N+DIM+F+SG
quadrienalidadinhas	quadrienalidade+N+DIM+F+PL
quadrificidade	quadrificidade+N+F+SG
quadrificidades	quadrificidade+N+F+PL
quadrificidadezinha	quadrificidade+N+DIM+F+SG
quadrificidadezinhas	quadrificidade+N+DIM+F+PL
quadrificidadinha	quadrificidade+N+DIM+F+SG
quadrificidadinhas	quadrificidade+N+DIM+F+PL
quadriga	quadriga+N+F+SG
quadrigas	quadriga+N+F+PL
quadrigazinha	quadriga+N+DIM+F+SG
quadrigazinhas	quadriga+N+DIM+F+PL
quadriguinha	quadriga+N+DIM+F+SG
quadriguinhas	quadriga+N+DIM+F+PL
quadrigariazinha	quadrigário+N+DIM+F+SG
quadrigariazinhas	quadrigário+N+DIM+F+PL
quadrigarinha	quadrigário+N+DIM+F+SG
quadrigarinhas	quadrigário+N+DIM+F+PL
quadrigarinho	quadrigário+N+DIM+M+SG
quadrigarinhos	quadrigário+N+DIM+M+PL
quadrigariozinho	quadrigário+N+DIM+M+SG
quadrigariozinhos	quadrigário+N+DIM+M+PL
quadrigária	quadrigário+N+F+SG
quadrigárias	quadrigário+N+F+PL
quadrigário	quadrigário+N+M+SG
quadrigários	quadrigário+N+M+PL
quadrigemeazinha	quadrigémeo+N+DIM+F+SG
quadrigemeazinhas	quadrigémeo+N+DIM+F+PL
quadrigemeinha	quadrigémeo+N+DIM+F+SG
quadrigemeinhas	quadrigémeo+N+DIM+F+PL
quadrigemeinho	quadrigémeo+N+DIM+M+SG
quadrigemeinhos	quadrigémeo+N+DIM+M+PL
quadrigemeozinho	quadrigémeo+N+DIM+M+SG
quadrigemeozinhos	quadrigémeo+N+DIM+M+PL
quadrigémea	quadrigémeo+N+F+SG
quadrigémeas	quadrigémeo+N+F+PL
quadrigémeo	quadrigémeo+N+M+SG
quadrigémeos	quadrigémeo+N+M+PL
quadril	quadril+N+M+SG
quadrilzinho	quadril+N+DIM+M+SG
quadris	quadril+N+M+PL
quadrizinhos	quadril+N+DIM+M+PL
quadrilateralidade	quadrilateralidade+N+F+SG
quadrilateralidades	quadrilateralidade+N+F+PL
quadrilateralidadezinha	quadrilateralidade+N+DIM+F+SG
quadrilateralidadezinhas	quadrilateralidade+N+DIM+F+PL
quadrilateralidadinha	quadrilateralidade+N+DIM+F+SG
quadrilateralidadinhas	quadrilateralidade+N+DIM+F+PL
quadrilha	quadrilha+N+F+SG
quadrilhas	quadrilha+N+F+PL
quadrilhazinha	quadrilha+N+DIM+F+SG
quadrilhazinhas	quadrilha+N+DIM+F+PL
quadrilhinha	quadrilha+N+DIM+F+SG
quadrilhinhas	quadrilha+N+DIM+F+PL
quadrilhadinho	quadrilhado+N+DIM+M+SG
quadrilhadinhos	quadrilhado+N+DIM+M+PL
quadrilhado	quadrilhado+N+M+SG
quadrilhados	quadrilhado+N+M+PL
quadrilhadozinho	quadrilhado+N+DIM+M+SG
quadrilhadozinhos	quadrilhado+N+DIM+M+PL
quadrilheira	quadrilheiro+N+F+SG
quadrilheiras	quadrilheiro+N+F+PL
quadrilheirazinha	quadrilheiro+N+DIM+F+SG
quadrilheirazinhas	quadrilheiro+N+DIM+F+PL
quadrilheirinha	quadrilheiro+N+DIM+F+SG
quadrilheirinhas	quadrilheiro+N+DIM+F+PL
quadrilheirinho	quadrilheiro+N+DIM+M+SG
quadrilheirinhos	quadrilheiro+N+DIM+M+PL
quadrilheiro	quadrilheiro+N+M+SG
quadrilheiros	quadrilheiro+N+M+PL
quadrilheirozinho	quadrilheiro+N+DIM+M+SG
quadrilheirozinhos	quadrilheiro+N+DIM+M+PL
quadrilocularidade	quadrilocularidade+N+F+SG
quadrilocularidades	quadrilocularidade+N+F+PL
quadrilocularidadezinha	quadrilocularidade+N+DIM+F+SG
quadrilocularidadezinhas	quadrilocularidade+N+DIM+F+PL
quadrilocularidadinha	quadrilocularidade+N+DIM+F+SG
quadrilocularidadinhas	quadrilocularidade+N+DIM+F+PL
quadrilaterazinha	quadrilátero+N+DIM+F+SG
quadrilaterazinhas	quadrilátero+N+DIM+F+PL
quadrilaterinha	quadrilátero+N+DIM+F+SG
quadrilaterinhas	quadrilátero+N+DIM+F+PL
quadrilaterinho	quadrilátero+N+DIM+M+SG
quadrilaterinhos	quadrilátero+N+DIM+M+PL
quadrilaterozinho	quadrilátero+N+DIM+M+SG
quadrilaterozinhos	quadrilátero+N+DIM+M+PL
quadrilátera	quadrilátero+N+F+SG
quadriláteras	quadrilátero+N+F+PL
quadrilátero	quadrilátero+N+M+SG
quadriláteros	quadrilátero+N+M+PL
quadrilobulinho	quadrilóbulo+N+DIM+M+SG
quadrilobulinhos	quadrilóbulo+N+DIM+M+PL
quadrilobulozinho	quadrilóbulo+N+DIM+M+SG
quadrilobulozinhos	quadrilóbulo+N+DIM+M+PL
quadrilóbulo	quadrilóbulo+N+M+SG
quadrilóbulos	quadrilóbulo+N+M+PL
quadrimentinho	quadrimento+N+DIM+M+SG
quadrimentinhos	quadrimento+N+DIM+M+PL
quadrimento	quadrimento+N+M+SG
quadrimentos	quadrimento+N+M+PL
quadrimentozinho	quadrimento+N+DIM+M+SG
quadrimentozinhos	quadrimento+N+DIM+M+PL
quadrimenta	quadrimentum+N+M+PL
quadrimentazinhos	quadrimentum+N+DIM+M+PL
quadrimentum	quadrimentum+N+M+SG
quadrimentunzinho	quadrimentum+N+DIM+M+SG
quadrimestralidade	quadrimestralidade+N+F+SG
quadrimestralidades	quadrimestralidade+N+F+PL
quadrimestralidadezinha	quadrimestralidade+N+DIM+F+SG
quadrimestralidadezinhas	quadrimestralidade+N+DIM+F+PL
quadrimestralidadinha	quadrimestralidade+N+DIM+F+SG
quadrimestralidadinhas	quadrimestralidade+N+DIM+F+PL
quadrimestre	quadrimestre+N+M+SG
quadrimestres	quadrimestre+N+M+PL
quadrimestrezinho	quadrimestre+N+DIM+M+SG
quadrimestrezinhos	quadrimestre+N+DIM+M+PL
quadrimestrinho	quadrimestre+N+DIM+M+SG
quadrimestrinhos	quadrimestre+N+DIM+M+PL
quadrimotor	quadrimotor+N+M+SG
quadrimotora	quadrimotor+N+F+SG
quadrimotoras	quadrimotor+N+F+PL
quadrimotorazinha	quadrimotor+N+DIM+F+SG
quadrimotorazinhas	quadrimotor+N+DIM+F+PL
quadrimotores	quadrimotor+N+M+PL
quadrimotorezinhos	quadrimotor+N+DIM+M+PL
quadrimotorinha	quadrimotor+N+DIM+F+SG
quadrimotorinhas	quadrimotor+N+DIM+F+PL
quadrimotorzinho	quadrimotor+N+DIM+M+SG
quadrimotorzinhos	quadrimotor+N+DIM+M+PL
quadringentenarinho	quadringentenário+N+DIM+M+SG
quadringentenarinhos	quadringentenário+N+DIM+M+PL
quadringentenariozinho	quadringentenário+N+DIM+M+SG
quadringentenariozinhos	quadringentenário+N+DIM+M+PL
quadringentenário	quadringentenário+N+M+SG
quadringentenários	quadringentenário+N+M+PL
quadringentesimazinha	quadringentésimo+N+DIM+F+SG
quadringentesimazinhas	quadringentésimo+N+DIM+F+PL
quadringentesiminha	quadringentésimo+N+DIM+F+SG
quadringentesiminhas	quadringentésimo+N+DIM+F+PL
quadringentesiminho	quadringentésimo+N+DIM+M+SG
quadringentesiminhos	quadringentésimo+N+DIM+M+PL
quadringentesimozinho	quadringentésimo+N+DIM+M+SG
quadringentesimozinhos	quadringentésimo+N+DIM+M+PL
quadringentésima	quadringentésimo+N+F+SG
quadringentésimas	quadringentésimo+N+F+PL
quadringentésimo	quadringentésimo+N+M+SG
quadringentésimos	quadringentésimo+N+M+PL
quadrinominho	quadrinómio+N+DIM+M+SG
quadrinominhos	quadrinómio+N+DIM+M+PL
quadrinomiozinho	quadrinómio+N+DIM+M+SG
quadrinomiozinhos	quadrinómio+N+DIM+M+PL
quadrinómio	quadrinómio+N+M+SG
quadrinómios	quadrinómio+N+M+PL
quadrinominho	quadrinômio+N+DIM+M+SG
quadrinominhos	quadrinômio+N+DIM+M+PL
quadrinomiozinho	quadrinômio+N+DIM+M+SG
quadrinomiozinhos	quadrinômio+N+DIM+M+PL
quadrinômio	quadrinômio+N+M+SG
quadrinômios	quadrinômio+N+M+PL
quadriplegicidade	quadriplegicidade+N+F+SG
quadriplegicidades	quadriplegicidade+N+F+PL
quadriplegicidadezinha	quadriplegicidade+N+DIM+F+SG
quadriplegicidadezinhas	quadriplegicidade+N+DIM+F+PL
quadriplegicidadinha	quadriplegicidade+N+DIM+F+SG
quadriplegicidadinhas	quadriplegicidade+N+DIM+F+PL
quadriplicação	quadriplicação+N+F+SG
quadriplicaçãozinha	quadriplicação+N+DIM+F+SG
quadriplicações	quadriplicação+N+F+PL
quadriplicaçõezinhas	quadriplicação+N+DIM+F+PL
quadripolinho	quadripolo+N+DIM+M+SG
quadripolinhos	quadripolo+N+DIM+M+PL
quadripolo	quadripolo+N+M+SG
quadripolos	quadripolo+N+M+PL
quadripolozinho	quadripolo+N+DIM+M+SG
quadripolozinhos	quadripolo+N+DIM+M+PL
quadriposição	quadriposição+N+F+SG
quadriposiçãozinha	quadriposição+N+DIM+F+SG
quadriposições	quadriposição+N+F+PL
quadriposiçõezinhas	quadriposição+N+DIM+F+PL
quadripotenciais	quadripotencial+N+M+PL
quadripotenciaizinhos	quadripotencial+N+DIM+M+PL
quadripotencial	quadripotencial+N+M+SG
quadripotencialzinho	quadripotencial+N+DIM+M+SG
quadrirreator	quadrirreator+N+M+SG
quadrirreatores	quadrirreator+N+M+PL
quadrirreatorezinhos	quadrirreator+N+DIM+M+PL
quadrirreatorzinho	quadrirreator+N+DIM+M+SG
quadrirreatorzinhos	quadrirreator+N+DIM+M+PL
quadrirreme	quadrirreme+N+M+SG
quadrirremes	quadrirreme+N+M+PL
quadrirremezinho	quadrirreme+N+DIM+M+SG
quadrirremezinhos	quadrirreme+N+DIM+M+PL
quadrirreminho	quadrirreme+N+DIM+M+SG
quadrirreminhos	quadrirreme+N+DIM+M+PL
quadrissecularidade	quadrissecularidade+N+F+SG
quadrissecularidades	quadrissecularidade+N+F+PL
quadrissecularidadezinha	quadrissecularidade+N+DIM+F+SG
quadrissecularidadezinhas	quadrissecularidade+N+DIM+F+PL
quadrissecularidadinha	quadrissecularidade+N+DIM+F+SG
quadrissecularidadinhas	quadrissecularidade+N+DIM+F+PL
quadrissemana	quadrissemana+N+F+SG
quadrissemanas	quadrissemana+N+F+PL
quadrissemanazinha	quadrissemana+N+DIM+F+SG
quadrissemanazinhas	quadrissemana+N+DIM+F+PL
quadrissemaninha	quadrissemana+N+DIM+F+SG
quadrissemaninhas	quadrissemana+N+DIM+F+PL
quadrissemanalidade	quadrissemanalidade+N+F+SG
quadrissemanalidades	quadrissemanalidade+N+F+PL
quadrissemanalidadezinha	quadrissemanalidade+N+DIM+F+SG
quadrissemanalidadezinhas	quadrissemanalidade+N+DIM+F+PL
quadrissemanalidadinha	quadrissemanalidade+N+DIM+F+SG
quadrissemanalidadinhas	quadrissemanalidade+N+DIM+F+PL
quadrissilabicidade	quadrissilabicidade+N+F+SG
quadrissilabicidades	quadrissilabicidade+N+F+PL
quadrissilabicidadezinha	quadrissilabicidade+N+DIM+F+SG
quadrissilabicidadezinhas	quadrissilabicidade+N+DIM+F+PL
quadrissilabicidadinha	quadrissilabicidade+N+DIM+F+SG
quadrissilabicidadinhas	quadrissilabicidade+N+DIM+F+PL
quadrissilabazinha	quadrissílabo+N+DIM+F+SG
quadrissilabazinhas	quadrissílabo+N+DIM+F+PL
quadrissilabinha	quadrissílabo+N+DIM+F+SG
quadrissilabinhas	quadrissílabo+N+DIM+F+PL
quadrissilabinho	quadrissílabo+N+DIM+M+SG
quadrissilabinhos	quadrissílabo+N+DIM+M+PL
quadrissilabozinho	quadrissílabo+N+DIM+M+SG
quadrissilabozinhos	quadrissílabo+N+DIM+M+PL
quadrissílaba	quadrissílabo+N+F+SG
quadrissílabas	quadrissílabo+N+F+PL
quadrissílabo	quadrissílabo+N+M+SG
quadrissílabos	quadrissílabo+N+M+PL
quadrivalvularidade	quadrivalvularidade+N+F+SG
quadrivalvularidades	quadrivalvularidade+N+F+PL
quadrivalvularidadezinha	quadrivalvularidade+N+DIM+F+SG
quadrivalvularidadezinhas	quadrivalvularidade+N+DIM+F+PL
quadrivalvularidadinha	quadrivalvularidade+N+DIM+F+SG
quadrivalvularidadinhas	quadrivalvularidade+N+DIM+F+PL
quadrivector	quadrivector+N+M+SG
quadrivectores	quadrivector+N+M+PL
quadrivectorezinhos	quadrivector+N+DIM+M+PL
quadrivectorzinho	quadrivector+N+DIM+M+SG
quadrivectorzinhos	quadrivector+N+DIM+M+PL
quadriangulinho	quadriângulo+N+DIM+M+SG
quadriangulinhos	quadriângulo+N+DIM+M+PL
quadriangulozinho	quadriângulo+N+DIM+M+SG
quadriangulozinhos	quadriângulo+N+DIM+M+PL
quadriângulo	quadriângulo+N+M+SG
quadriângulos	quadriângulo+N+M+PL
quadrieninho	quadriénio+N+DIM+M+SG
quadrieninhos	quadriénio+N+DIM+M+PL
quadrieniozinho	quadriénio+N+DIM+M+SG
quadrieniozinhos	quadriénio+N+DIM+M+PL
quadriénio	quadriénio+N+M+SG
quadriénios	quadriénio+N+M+PL
quadrieninho	quadriênio+N+DIM+M+SG
quadrieninhos	quadriênio+N+DIM+M+PL
quadrieniozinho	quadriênio+N+DIM+M+SG
quadrieniozinhos	quadriênio+N+DIM+M+PL
quadriênio	quadriênio+N+M+SG
quadriênios	quadriênio+N+M+PL
quadrinho	quadro+N+DIM+M+SG
quadrinhos	quadro+N+DIM+M+PL
quadrito	quadro+N+DIM+M+SG
quadritos	quadro+N+DIM+M+PL
quadro	quadro+N+M+SG
quadros	quadro+N+M+PL
quadrozinho	quadro+N+DIM+M+SG
quadrozinhos	quadro+N+DIM+M+PL
quadrozito	quadro+N+DIM+M+SG
quadrozitos	quadro+N+DIM+M+PL
quadro-negrinho	quadro-negro+N+DIM+M+SG
quadro-negrinhos	quadro-negro+N+DIM+M+PL
quadro-negro	quadro-negro+N+M+SG
quadro-negrozinho	quadro-negro+N+DIM+M+SG
quadros-negros	quadro-negro+N+M+PL
quadros-negrozinhos	quadro-negro+N+DIM+M+PL
quadrunviratinho	quadrunvirato+N+DIM+M+SG
quadrunviratinhos	quadrunvirato+N+DIM+M+PL
quadrunvirato	quadrunvirato+N+M+SG
quadrunviratos	quadrunvirato+N+M+PL
quadrunviratozinho	quadrunvirato+N+DIM+M+SG
quadrunviratozinhos	quadrunvirato+N+DIM+M+PL
quadrupletinho	quadrupleto+N+DIM+M+SG
quadrupletinhos	quadrupleto+N+DIM+M+PL
quadrupleto	quadrupleto+N+M+SG
quadrupletos	quadrupleto+N+M+PL
quadrupletozinho	quadrupleto+N+DIM+M+SG
quadrupletozinhos	quadrupleto+N+DIM+M+PL
quadruplicabilidade	quadruplicabilidade+N+F+SG
quadruplicabilidades	quadruplicabilidade+N+F+PL
quadruplicabilidadezinha	quadruplicabilidade+N+DIM+F+SG
quadruplicabilidadezinhas	quadruplicabilidade+N+DIM+F+PL
quadruplicabilidadinha	quadruplicabilidade+N+DIM+F+SG
quadruplicabilidadinhas	quadruplicabilidade+N+DIM+F+PL
quadruplicação	quadruplicação+N+F+SG
quadruplicaçãozinha	quadruplicação+N+DIM+F+SG
quadruplicações	quadruplicação+N+F+PL
quadruplicaçõezinhas	quadruplicação+N+DIM+F+PL
quadrupolinho	quadrupolo+N+DIM+M+SG
quadrupolinhos	quadrupolo+N+DIM+M+PL
quadrupolo	quadrupolo+N+M+SG
quadrupolos	quadrupolo+N+M+PL
quadrupolozinho	quadrupolo+N+DIM+M+SG
quadrupolozinhos	quadrupolo+N+DIM+M+PL
quadraticazinha	quadrática+N+DIM+F+SG
quadraticazinhas	quadrática+N+DIM+F+PL
quadratiquinha	quadrática+N+DIM+F+SG
quadratiquinhas	quadrática+N+DIM+F+PL
quadrática	quadrática+N+F+SG
quadráticas	quadrática+N+F+PL
quadraticazinha	quadrático+N+DIM+F+SG
quadraticazinhas	quadrático+N+DIM+F+PL
quadraticozinho	quadrático+N+DIM+M+SG
quadraticozinhos	quadrático+N+DIM+M+PL
quadratiquinha	quadrático+N+DIM+F+SG
quadratiquinhas	quadrático+N+DIM+F+PL
quadratiquinho	quadrático+N+DIM+M+SG
quadratiquinhos	quadrático+N+DIM+M+PL
quadrática	quadrático+N+F+SG
quadráticas	quadrático+N+F+PL
quadrático	quadrático+N+M+SG
quadráticos	quadrático+N+M+PL
quadrangulinho	quadrângulo+N+DIM+M+SG
quadrangulinhos	quadrângulo+N+DIM+M+PL
quadrangulozinho	quadrângulo+N+DIM+M+SG
quadrangulozinhos	quadrângulo+N+DIM+M+PL
quadrângulo	quadrângulo+N+M+SG
quadrângulos	quadrângulo+N+M+PL
quadricepsinha	quadríceps+N+DIM+F+SG
quadricepsinhas	quadríceps+N+DIM+F+PL
quadricepsinho	quadríceps+N+DIM+M+SG
quadricepsinhos	quadríceps+N+DIM+M+PL
quadríceps	quadríceps+N
quadriculazinha	quadrícula+N+DIM+F+SG
quadriculazinhas	quadrícula+N+DIM+F+PL
quadriculinha	quadrícula+N+DIM+F+SG
quadriculinhas	quadrícula+N+DIM+F+PL
quadrícula	quadrícula+N+F+SG
quadrículas	quadrícula+N+F+PL
quadriculazinha	quadrículo+N+DIM+F+SG
quadriculazinhas	quadrículo+N+DIM+F+PL
quadriculinha	quadrículo+N+DIM+F+SG
quadriculinhas	quadrículo+N+DIM+F+PL
quadriculinho	quadrículo+N+DIM+M+SG
quadriculinhos	quadrículo+N+DIM+M+PL
quadriculozinho	quadrículo+N+DIM+M+SG
quadriculozinhos	quadrículo+N+DIM+M+PL
quadrícula	quadrículo+N+F+SG
quadrículas	quadrículo+N+F+PL
quadrículo	quadrículo+N+M+SG
quadrículos	quadrículo+N+M+PL
quadrivinho	quadrívio+N+DIM+M+SG
quadrivinhos	quadrívio+N+DIM+M+PL
quadriviozinho	quadrívio+N+DIM+M+SG
quadriviozinhos	quadrívio+N+DIM+M+PL
quadrívio	quadrívio+N+M+SG
quadrívios	quadrívio+N+M+PL
quadrumanazinha	quadrúmano+N+DIM+F+SG
quadrumanazinhas	quadrúmano+N+DIM+F+PL
quadrumaninha	quadrúmano+N+DIM+F+SG
quadrumaninhas	quadrúmano+N+DIM+F+PL
quadrumaninho	quadrúmano+N+DIM+M+SG
quadrumaninhos	quadrúmano+N+DIM+M+PL
quadrumanozinho	quadrúmano+N+DIM+M+SG
quadrumanozinhos	quadrúmano+N+DIM+M+PL
quadrúmana	quadrúmano+N+F+SG
quadrúmanas	quadrúmano+N+F+PL
quadrúmano	quadrúmano+N+M+SG
quadrúmanos	quadrúmano+N+M+PL
quadrunvirazinha	quadrúnviro+N+DIM+F+SG
quadrunvirazinhas	quadrúnviro+N+DIM+F+PL
quadrunvirinha	quadrúnviro+N+DIM+F+SG
quadrunvirinhas	quadrúnviro+N+DIM+F+PL
quadrunvirinho	quadrúnviro+N+DIM+M+SG
quadrunvirinhos	quadrúnviro+N+DIM+M+PL
quadrunvirozinho	quadrúnviro+N+DIM+M+SG
quadrunvirozinhos	quadrúnviro+N+DIM+M+PL
quadrúnvira	quadrúnviro+N+F+SG
quadrúnviras	quadrúnviro+N+F+PL
quadrúnviro	quadrúnviro+N+M+SG
quadrúnviros	quadrúnviro+N+M+PL
quadrupedezinha	quadrúpede+N+DIM+F+SG
quadrupedezinhas	quadrúpede+N+DIM+F+PL
quadrupedezinho	quadrúpede+N+DIM+M+SG
quadrupedezinhos	quadrúpede+N+DIM+M+PL
quadrupedinha	quadrúpede+N+DIM+F+SG
quadrupedinhas	quadrúpede+N+DIM+F+PL
quadrupedinho	quadrúpede+N+DIM+M+SG
quadrupedinhos	quadrúpede+N+DIM+M+PL
quadrúpede	quadrúpede+N+SG
quadrúpedes	quadrúpede+N+PL
qualidade	qualidade+N+F+SG
qualidades	qualidade+N+F+PL
qualidadezinha	qualidade+N+DIM+F+SG
qualidadezinhas	qualidade+N+DIM+F+PL
qualidadinha	qualidade+N+DIM+F+SG
qualidadinhas	qualidade+N+DIM+F+PL
qualificabilidade	qualificabilidade+N+F+SG
qualificabilidades	qualificabilidade+N+F+PL
qualificabilidadezinha	qualificabilidade+N+DIM+F+SG
qualificabilidadezinhas	qualificabilidade+N+DIM+F+PL
qualificabilidadinha	qualificabilidade+N+DIM+F+SG
qualificabilidadinhas	qualificabilidade+N+DIM+F+PL
qualificada	qualificado+N+F+SG
qualificadas	qualificado+N+F+PL
qualificadazinha	qualificado+N+DIM+F+SG
qualificadazinhas	qualificado+N+DIM+F+PL
qualificadinha	qualificado+N+DIM+F+SG
qualificadinhas	qualificado+N+DIM+F+PL
qualificadinho	qualificado+N+DIM+M+SG
qualificadinhos	qualificado+N+DIM+M+PL
qualificado	qualificado+N+M+SG
qualificados	qualificado+N+M+PL
qualificadozinho	qualificado+N+DIM+M+SG
qualificadozinhos	qualificado+N+DIM+M+PL
qualificador	qualificador+N+M+SG
qualificadora	qualificador+N+F+SG
qualificadoras	qualificador+N+F+PL
qualificadorazinha	qualificador+N+DIM+F+SG
qualificadorazinhas	qualificador+N+DIM+F+PL
qualificadores	qualificador+N+M+PL
qualificadorezinhos	qualificador+N+DIM+M+PL
qualificadorinha	qualificador+N+DIM+F+SG
qualificadorinhas	qualificador+N+DIM+F+PL
qualificadorzinho	qualificador+N+DIM+M+SG
qualificadorzinhos	qualificador+N+DIM+M+PL
qualificatividade	qualificatividade+N+F+SG
qualificatividades	qualificatividade+N+F+PL
qualificatividadezinha	qualificatividade+N+DIM+F+SG
qualificatividadezinhas	qualificatividade+N+DIM+F+PL
qualificatividadinha	qualificatividade+N+DIM+F+SG
qualificatividadinhas	qualificatividade+N+DIM+F+PL
qualificativa	qualificativo+N+F+SG
qualificativas	qualificativo+N+F+PL
qualificativazinha	qualificativo+N+DIM+F+SG
qualificativazinhas	qualificativo+N+DIM+F+PL
qualificativinha	qualificativo+N+DIM+F+SG
qualificativinhas	qualificativo+N+DIM+F+PL
qualificativinho	qualificativo+N+DIM+M+SG
qualificativinhos	qualificativo+N+DIM+M+PL
qualificativo	qualificativo+N+M+SG
qualificativos	qualificativo+N+M+PL
qualificativozinho	qualificativo+N+DIM+M+SG
qualificativozinhos	qualificativo+N+DIM+M+PL
qualificação	qualificação+N+F+SG
qualificaçãozinha	qualificação+N+DIM+F+SG
qualificações	qualificação+N+F+PL
qualificaçõezinhas	qualificação+N+DIM+F+PL
qualitatividade	qualitatividade+N+F+SG
qualitatividades	qualitatividade+N+F+PL
qualitatividadezinha	qualitatividade+N+DIM+F+SG
qualitatividadezinhas	qualitatividade+N+DIM+F+PL
qualitatividadinha	qualitatividade+N+DIM+F+SG
qualitatividadinhas	qualitatividade+N+DIM+F+PL
quantia	quantia+N+F+SG
quantias	quantia+N+F+PL
quantiazinha	quantia+N+DIM+F+SG
quantiazinhas	quantia+N+DIM+F+PL
quantinha	quantia+N+DIM+F+SG
quantinhas	quantia+N+DIM+F+PL
quanticidade	quanticidade+N+F+SG
quanticidades	quanticidade+N+F+PL
quanticidadezinha	quanticidade+N+DIM+F+SG
quanticidadezinhas	quanticidade+N+DIM+F+PL
quanticidadinha	quanticidade+N+DIM+F+SG
quanticidadinhas	quanticidade+N+DIM+F+PL
quantidade	quantidade+N+F+SG
quantidades	quantidade+N+F+PL
quantidadezinha	quantidade+N+DIM+F+SG
quantidadezinhas	quantidade+N+DIM+F+PL
quantidadinha	quantidade+N+DIM+F+SG
quantidadinhas	quantidade+N+DIM+F+PL
quantificabilidade	quantificabilidade+N+F+SG
quantificabilidades	quantificabilidade+N+F+PL
quantificabilidadezinha	quantificabilidade+N+DIM+F+SG
quantificabilidadezinhas	quantificabilidade+N+DIM+F+PL
quantificabilidadinha	quantificabilidade+N+DIM+F+SG
quantificabilidadinhas	quantificabilidade+N+DIM+F+PL
quantificação	quantificação+N+F+SG
quantificaçãozinha	quantificação+N+DIM+F+SG
quantificações	quantificação+N+F+PL
quantificaçõezinhas	quantificação+N+DIM+F+PL
quantil	quantil+N+M+SG
quantilzinho	quantil+N+DIM+M+SG
quantis	quantil+N+M+PL
quantizinhos	quantil+N+DIM+M+PL
quantiosidade	quantiosidade+N+F+SG
quantiosidades	quantiosidade+N+F+PL
quantiosidadezinha	quantiosidade+N+DIM+F+SG
quantiosidadezinhas	quantiosidade+N+DIM+F+PL
quantiosidadinha	quantiosidade+N+DIM+F+SG
quantiosidadinhas	quantiosidade+N+DIM+F+PL
quantitatividade	quantitatividade+N+F+SG
quantitatividades	quantitatividade+N+F+PL
quantitatividadezinha	quantitatividade+N+DIM+F+SG
quantitatividadezinhas	quantitatividade+N+DIM+F+PL
quantitatividadinha	quantitatividade+N+DIM+F+SG
quantitatividadinhas	quantitatividade+N+DIM+F+PL
quantitativa	quantitativo+N+F+SG
quantitativas	quantitativo+N+F+PL
quantitativazinha	quantitativo+N+DIM+F+SG
quantitativazinhas	quantitativo+N+DIM+F+PL
quantitativinha	quantitativo+N+DIM+F+SG
quantitativinhas	quantitativo+N+DIM+F+PL
quantitativinho	quantitativo+N+DIM+M+SG
quantitativinhos	quantitativo+N+DIM+M+PL
quantitativo	quantitativo+N+M+SG
quantitativos	quantitativo+N+M+PL
quantitativozinho	quantitativo+N+DIM+M+SG
quantitativozinhos	quantitativo+N+DIM+M+PL
quantização	quantização+N+F+SG
quantizaçãozinha	quantização+N+DIM+F+SG
quantizações	quantização+N+F+PL
quantizaçõezinhas	quantização+N+DIM+F+PL
quantofrenia	quantofrenia+N+F+SG
quantofrenias	quantofrenia+N+F+PL
quantofreniazinha	quantofrenia+N+DIM+F+SG
quantofreniazinhas	quantofrenia+N+DIM+F+PL
quantofreninha	quantofrenia+N+DIM+F+SG
quantofreninhas	quantofrenia+N+DIM+F+PL
quanta	quantum+N+PL
quantazinhas	quantum+N+DIM+F+PL
quantazinhos	quantum+N+DIM+M+PL
quantinho	quantum+N+DIM+M+SG
quantinhos	quantum+N+DIM+M+PL
quanto	quantum+N+M+SG
quantozinho	quantum+N+DIM+M+SG
quantum	quantum+N+M+SG
quantunzinho	quantum+N+DIM+M+SG
quantometrinho	quantómetro+N+DIM+M+SG
quantometrinhos	quantómetro+N+DIM+M+PL
quantometrozinho	quantómetro+N+DIM+M+SG
quantometrozinhos	quantómetro+N+DIM+M+PL
quantómetro	quantómetro+N+M+SG
quantómetros	quantómetro+N+M+PL
quanza	quanza+N+M+SG
quanzas	quanza+N+M+PL
quanzazinho	quanza+N+DIM+M+SG
quanzazinhos	quanza+N+DIM+M+PL
quanzinha	quanza+N+DIM+M+SG
quanzinhas	quanza+N+DIM+M+PL
quapoia	quapoia+N+F+SG
quapoias	quapoia+N+F+PL
quapoiazinha	quapoia+N+DIM+F+SG
quapoiazinhas	quapoia+N+DIM+F+PL
quapoinha	quapoia+N+DIM+F+SG
quapoinhas	quapoia+N+DIM+F+PL
quarador	quarador+N+M+SG
quaradores	quarador+N+M+PL
quaradorezinhos	quarador+N+DIM+M+PL
quaradorzinho	quarador+N+DIM+M+SG
quaradorzinhos	quarador+N+DIM+M+PL
quaradourinho	quaradouro+N+DIM+M+SG
quaradourinhos	quaradouro+N+DIM+M+PL
quaradouro	quaradouro+N+M+SG
quaradouros	quaradouro+N+M+PL
quaradourozinho	quaradouro+N+DIM+M+SG
quaradourozinhos	quaradouro+N+DIM+M+PL
quarenta	quarenta+N+M+SG
quarentas	quarenta+N+M+PL
quarentazinho	quarenta+N+DIM+M+SG
quarentazinhos	quarenta+N+DIM+M+PL
quarentinha	quarenta+N+DIM+M+SG
quarentinhas	quarenta+N+DIM+M+PL
quarentena	quarentena+N+F+SG
quarentenas	quarentena+N+F+PL
quarentenazinha	quarentena+N+DIM+F+SG
quarentenazinhas	quarentena+N+DIM+F+PL
quarenteninha	quarentena+N+DIM+F+SG
quarenteninhas	quarentena+N+DIM+F+PL
quarentenariazinha	quarentenário+N+DIM+F+SG
quarentenariazinhas	quarentenário+N+DIM+F+PL
quarentenarinha	quarentenário+N+DIM+F+SG
quarentenarinhas	quarentenário+N+DIM+F+PL
quarentenarinho	quarentenário+N+DIM+M+SG
quarentenarinhos	quarentenário+N+DIM+M+PL
quarentenariozinho	quarentenário+N+DIM+M+SG
quarentenariozinhos	quarentenário+N+DIM+M+PL
quarentenária	quarentenário+N+F+SG
quarentenárias	quarentenário+N+F+PL
quarentenário	quarentenário+N+M+SG
quarentenários	quarentenário+N+M+PL
quarentona	quarentão+N+F+SG
quarentonas	quarentão+N+F+PL
quarentonazinha	quarentão+N+DIM+F+SG
quarentonazinhas	quarentão+N+DIM+F+PL
quarentoninha	quarentão+N+DIM+F+SG
quarentoninhas	quarentão+N+DIM+F+PL
quarentão	quarentão+N+M+SG
quarentãozinho	quarentão+N+DIM+M+SG
quarentões	quarentão+N+M+PL
quarentõezinhos	quarentão+N+DIM+M+PL
quaresma	quaresma+N+F+SG
quaresmas	quaresma+N+F+PL
quaresmazinha	quaresma+N+DIM+F+SG
quaresmazinhas	quaresma+N+DIM+F+PL
quaresminha	quaresma+N+DIM+F+SG
quaresminhas	quaresma+N+DIM+F+PL
quaresmalidade	quaresmalidade+N+F+SG
quaresmalidades	quaresmalidade+N+F+PL
quaresmalidadezinha	quaresmalidade+N+DIM+F+SG
quaresmalidadezinhas	quaresmalidade+N+DIM+F+PL
quaresmalidadinha	quaresmalidade+N+DIM+F+SG
quaresmalidadinhas	quaresmalidade+N+DIM+F+PL
quaresmeira	quaresmeira+N+F+SG
quaresmeiras	quaresmeira+N+F+PL
quaresmeirazinha	quaresmeira+N+DIM+F+SG
quaresmeirazinhas	quaresmeira+N+DIM+F+PL
quaresmeirinha	quaresmeira+N+DIM+F+SG
quaresmeirinhas	quaresmeira+N+DIM+F+PL
quark	quark+N+M+SG
quarks	quark+N+M+PL
quarkzinho	quark+N+DIM+M+SG
quarkzinhos	quark+N+DIM+M+PL
quart	quart+N+M+SG
quartzinho	quart+N+DIM+M+SG
quarta	quarta+N+F+SG
quartas	quarta+N+F+PL
quartazinha	quarta+N+DIM+F+SG
quartazinhas	quarta+N+DIM+F+PL
quartinha	quarta+N+DIM+F+SG
quartinhas	quarta+N+DIM+F+PL
quarta-doencinha	quarta-doença+N+DIM+F+SG
quarta-doencinhas	quarta-doença+N+DIM+F+PL
quarta-doença	quarta-doença+N+F+SG
quarta-doençazinha	quarta-doença+N+DIM+F+SG
quartas-doenças	quarta-doença+N+F+PL
quartas-doençazinhas	quarta-doença+N+DIM+F+PL
quarta-feira	quarta-feira+N+F+SG
quarta-feirazinha	quarta-feira+N+DIM+F+SG
quarta-feirinha	quarta-feira+N+DIM+F+SG
quarta-feirinhas	quarta-feira+N+DIM+F+PL
quartas-feiras	quarta-feira+N+F+PL
quartas-feirazinhas	quarta-feira+N+DIM+F+PL
quartanista	quartanista+N+SG
quartanistas	quartanista+N+PL
quartanistazinha	quartanista+N+DIM+F+SG
quartanistazinhas	quartanista+N+DIM+F+PL
quartanistazinho	quartanista+N+DIM+M+SG
quartanistazinhos	quartanista+N+DIM+M+PL
quartanistinha	quartanista+N+DIM+SG
quartanistinhas	quartanista+N+DIM+PL
quartanarinho	quartanário+N+DIM+M+SG
quartanarinhos	quartanário+N+DIM+M+PL
quartanariozinho	quartanário+N+DIM+M+SG
quartanariozinhos	quartanário+N+DIM+M+PL
quartanário	quartanário+N+M+SG
quartanários	quartanário+N+M+PL
quartapisa	quartapisa+N+F+SG
quartapisas	quartapisa+N+F+PL
quartapisazinha	quartapisa+N+DIM+F+SG
quartapisazinhas	quartapisa+N+DIM+F+PL
quartapisinha	quartapisa+N+DIM+F+SG
quartapisinhas	quartapisa+N+DIM+F+PL
quartau	quartau+N+M+SG
quartaus	quartau+N+M+PL
quartauzinho	quartau+N+DIM+M+SG
quartauzinhos	quartau+N+DIM+M+PL
quarteinho	quarteio+N+DIM+M+SG
quarteinhos	quarteio+N+DIM+M+PL
quarteio	quarteio+N+M+SG
quarteios	quarteio+N+M+PL
quarteiozinho	quarteio+N+DIM+M+SG
quarteiozinhos	quarteio+N+DIM+M+PL
quarteirização	quarteirização+N+F+SG
quarteirizaçãozinha	quarteirização+N+DIM+F+SG
quarteirizações	quarteirização+N+F+PL
quarteirizaçõezinhas	quarteirização+N+DIM+F+PL
quarteira	quarteiro+N+F+SG
quarteiras	quarteiro+N+F+PL
quarteirazinha	quarteiro+N+DIM+F+SG
quarteirazinhas	quarteiro+N+DIM+F+PL
quarteirinha	quarteiro+N+DIM+F+SG
quarteirinhas	quarteiro+N+DIM+F+PL
quarteirinho	quarteiro+N+DIM+M+SG
quarteirinhos	quarteiro+N+DIM+M+PL
quarteiro	quarteiro+N+M+SG
quarteiros	quarteiro+N+M+PL
quarteirozinho	quarteiro+N+DIM+M+SG
quarteirozinhos	quarteiro+N+DIM+M+PL
quarteirão	quarteirão+N+M+SG
quarteirãozinho	quarteirão+N+DIM+M+SG
quarteirões	quarteirão+N+M+PL
quarteirõezinhos	quarteirão+N+DIM+M+PL
quarteizinhos	quartel+N+DIM+M+PL
quartel	quartel+N+M+SG
quartelzinho	quartel+N+DIM+M+SG
quartéis	quartel+N+M+PL
quartel-general	quartel-general+N+M+SG
quartel-generalzinho	quartel-general+N+DIM+M+SG
quartéis-generais	quartel-general+N+M+PL
quartéis-generaizinhos	quartel-general+N+DIM+M+PL
quarteis-gerais	quartel-geral+N+M+PL
quarteis-geraizinhos	quartel-geral+N+DIM+M+PL
quartel-geral	quartel-geral+N+M+SG
quartel-geralzinho	quartel-geral+N+DIM+M+SG
quartela	quartela+N+F+SG
quartelas	quartela+N+F+PL
quartelazinha	quartela+N+DIM+F+SG
quartelazinhas	quartela+N+DIM+F+PL
quartelinha	quartela+N+DIM+F+SG
quartelinhas	quartela+N+DIM+F+PL
quartelada	quartelada+N+F+SG
quarteladas	quartelada+N+F+PL
quarteladazinha	quartelada+N+DIM+F+SG
quarteladazinhas	quartelada+N+DIM+F+PL
quarteladinha	quartelada+N+DIM+F+SG
quarteladinhas	quartelada+N+DIM+F+PL
quarteleirinho	quarteleiro+N+DIM+M+SG
quarteleirinhos	quarteleiro+N+DIM+M+PL
quarteleiro	quarteleiro+N+M+SG
quarteleiros	quarteleiro+N+M+PL
quarteleirozinho	quarteleiro+N+DIM+M+SG
quarteleirozinhos	quarteleiro+N+DIM+M+PL
quarterona	quarterão+N+F+SG
quarteronas	quarterão+N+F+PL
quarteronazinha	quarterão+N+DIM+F+SG
quarteronazinhas	quarterão+N+DIM+F+PL
quarteroninha	quarterão+N+DIM+F+SG
quarteroninhas	quarterão+N+DIM+F+PL
quarterão	quarterão+N+M+SG
quarterãozinho	quarterão+N+DIM+M+SG
quarterões	quarterão+N+M+PL
quarterõezinhos	quarterão+N+DIM+M+PL
quartetinho	quarteto+N+DIM+M+SG
quartetinhos	quarteto+N+DIM+M+PL
quarteto	quarteto+N+M+SG
quartetos	quarteto+N+M+PL
quartetozinho	quarteto+N+DIM+M+SG
quartetozinhos	quarteto+N+DIM+M+PL
quartil	quartil+N+M+SG
quartilzinho	quartil+N+DIM+M+SG
quartis	quartil+N+M+PL
quartizinhos	quartil+N+DIM+M+PL
quartilhada	quartilhada+N+F+SG
quartilhadas	quartilhada+N+F+PL
quartilhadazinha	quartilhada+N+DIM+F+SG
quartilhadazinhas	quartilhada+N+DIM+F+PL
quartilhadinha	quartilhada+N+DIM+F+SG
quartilhadinhas	quartilhada+N+DIM+F+PL
quartilhame	quartilhame+N+M+SG
quartilhames	quartilhame+N+M+PL
quartilhamezinho	quartilhame+N+DIM+M+SG
quartilhamezinhos	quartilhame+N+DIM+M+PL
quartilhaminho	quartilhame+N+DIM+M+SG
quartilhaminhos	quartilhame+N+DIM+M+PL
quartilhinho	quartilho+N+DIM+M+SG
quartilhinhos	quartilho+N+DIM+M+PL
quartilho	quartilho+N+M+SG
quartilhos	quartilho+N+M+PL
quartilhozinho	quartilho+N+DIM+M+SG
quartilhozinhos	quartilho+N+DIM+M+PL
quartinha	quartinha+N+F+SG
quartinhas	quartinha+N+F+PL
quartinhazinha	quartinha+N+DIM+F+SG
quartinhazinhas	quartinha+N+DIM+F+PL
quartinhinha	quartinha+N+DIM+F+SG
quartinhinhas	quartinha+N+DIM+F+PL
quartinhinho	quartinho+N+DIM+M+SG
quartinhinhos	quartinho+N+DIM+M+PL
quartinho	quartinho+N+M+SG
quartinhos	quartinho+N+M+PL
quartinhozinho	quartinho+N+DIM+M+SG
quartinhozinhos	quartinho+N+DIM+M+PL
quarta	quarto+N+F+SG
quartas	quarto+N+F+PL
quartazinha	quarto+N+DIM+F+SG
quartazinhas	quarto+N+DIM+F+PL
quartinha	quarto+N+DIM+F+SG
quartinhas	quarto+N+DIM+F+PL
quartinho	quarto+N+DIM+M+SG
quartinhos	quarto+N+DIM+M+PL
quartito	quarto+N+DIM+M+SG
quartitos	quarto+N+DIM+M+PL
quarto	quarto+N+M+SG
quartos	quarto+N+M+PL
quartozinho	quarto+N+DIM+M+SG
quartozinhos	quarto+N+DIM+M+PL
quarto-de-final	quarto-de-final+N+M+SG
quarto-de-finalzinho	quarto-de-final+N+DIM+M+SG
quarto-de-hora	quarto-de-hora+N+M+SG
quarto-de-horazinho	quarto-de-hora+N+DIM+M+SG
quarto-de-horinha	quarto-de-hora+N+DIM+M+SG
quarto-de-horinhas	quarto-de-hora+N+DIM+M+PL
quartos-de-hora	quarto-de-hora+N+M+PL
quartos-de-horazinhos	quarto-de-hora+N+DIM+M+PL
quarto-e-sala	quarto-e-sala+N+M+SG
quarto-e-salas	quarto-e-sala+N+M+PL
quarto-e-salazinho	quarto-e-sala+N+DIM+M+SG
quarto-e-salazinhos	quarto-e-sala+N+DIM+M+PL
quarto-e-salinha	quarto-e-sala+N+DIM+M+SG
quarto-e-salinhas	quarto-e-sala+N+DIM+M+PL
quartos-e-salas	quarto-e-sala+N+M+PL
quartos-e-salazinhos	quarto-e-sala+N+DIM+M+PL
quartola	quartola+N+F+SG
quartolas	quartola+N+F+PL
quartolazinha	quartola+N+DIM+F+SG
quartolazinhas	quartola+N+DIM+F+PL
quartolinha	quartola+N+DIM+F+SG
quartolinhas	quartola+N+DIM+F+PL
quartos-de-final	quartos-de-final+N+M+PL
quartos-de-finalzinhos	quartos-de-final+N+DIM+M+PL
quartzina	quartzina+N+F+SG
quartzinas	quartzina+N+F+PL
quartzinazinha	quartzina+N+DIM+F+SG
quartzinazinhas	quartzina+N+DIM+F+PL
quartzininha	quartzina+N+DIM+F+SG
quartzininhas	quartzina+N+DIM+F+PL
quartzitinho	quartzito+N+DIM+M+SG
quartzitinhos	quartzito+N+DIM+M+PL
quartzito	quartzito+N+M+SG
quartzitos	quartzito+N+M+PL
quartzitozinho	quartzito+N+DIM+M+SG
quartzitozinhos	quartzito+N+DIM+M+PL
quartzinho	quartzo+N+DIM+M+SG
quartzinhos	quartzo+N+DIM+M+PL
quartzo	quartzo+N+M+SG
quartzos	quartzo+N+M+PL
quartzozinho	quartzo+N+DIM+M+SG
quartzozinhos	quartzo+N+DIM+M+PL
quartzosidade	quartzosidade+N+F+SG
quartzosidades	quartzosidade+N+F+PL
quartzosidadezinha	quartzosidade+N+DIM+F+SG
quartzosidadezinhas	quartzosidade+N+DIM+F+PL
quartzosidadinha	quartzosidade+N+DIM+F+SG
quartzosidadinhas	quartzosidade+N+DIM+F+PL
quartã	quartã+N+F+SG
quartãs	quartã+N+F+PL
quartãzinha	quartã+N+DIM+F+SG
quartãzinhas	quartã+N+DIM+F+PL
quartão	quartão+N+M+SG
quartãozinho	quartão+N+DIM+M+SG
quartões	quartão+N+M+PL
quartõezinhos	quartão+N+DIM+M+PL
quarcinho	quarço+N+DIM+M+SG
quarcinhos	quarço+N+DIM+M+PL
quarço	quarço+N+M+SG
quarços	quarço+N+M+PL
quarçozinho	quarço+N+DIM+M+SG
quarçozinhos	quarço+N+DIM+M+PL
quarozinho	quaró+N+DIM+M+SG
quarozinhos	quaró+N+DIM+M+PL
quaró	quaró+N+M+SG
quarós	quaró+N+M+PL
quasar	quasar+N+M+SG
quasares	quasar+N+M+PL
quasarezinhos	quasar+N+DIM+M+PL
quasarzinho	quasar+N+DIM+M+SG
quasarzinhos	quasar+N+DIM+M+PL
quase-monopolinho	quase-monopólio+N+DIM+M+SG
quase-monopolinhos	quase-monopólio+N+DIM+M+PL
quase-monopoliozinho	quase-monopólio+N+DIM+M+SG
quase-monopoliozinhos	quase-monopólio+N+DIM+M+PL
quase-monopólio	quase-monopólio+N+M+SG
quase-monopólios	quase-monopólio+N+M+PL
quassação	quassação+N+F+SG
quassaçãozinha	quassação+N+DIM+F+SG
quassações	quassação+N+F+PL
quassaçõezinhas	quassação+N+DIM+F+PL
quassina	quassina+N+F+SG
quassinas	quassina+N+F+PL
quassinazinha	quassina+N+DIM+F+SG
quassinazinhas	quassina+N+DIM+F+PL
quassininha	quassina+N+DIM+F+SG
quassininhas	quassina+N+DIM+F+PL
quassite	quassite+N+F+SG
quassites	quassite+N+F+PL
quassitezinha	quassite+N+DIM+F+SG
quassitezinhas	quassite+N+DIM+F+PL
quassitinha	quassite+N+DIM+F+SG
quassitinhas	quassite+N+DIM+F+PL
quasimodinho	quasímodo+N+DIM+M+SG
quasimodinhos	quasímodo+N+DIM+M+PL
quasimodozinho	quasímodo+N+DIM+M+SG
quasimodozinhos	quasímodo+N+DIM+M+PL
quasímodo	quasímodo+N+M+SG
quasímodos	quasímodo+N+M+PL
quaternidade	quaternidade+N+F+SG
quaternidades	quaternidade+N+F+PL
quaternidadezinha	quaternidade+N+DIM+F+SG
quaternidadezinhas	quaternidade+N+DIM+F+PL
quaternidadinha	quaternidade+N+DIM+F+SG
quaternidadinhas	quaternidade+N+DIM+F+PL
quaternião	quaternião+N+M+SG
quaterniãozinho	quaternião+N+DIM+M+SG
quaterniões	quaternião+N+M+PL
quaterniõezinhos	quaternião+N+DIM+M+PL
quaternariazinha	quaternário+N+DIM+F+SG
quaternariazinhas	quaternário+N+DIM+F+PL
quaternarinha	quaternário+N+DIM+F+SG
quaternarinhas	quaternário+N+DIM+F+PL
quaternarinho	quaternário+N+DIM+M+SG
quaternarinhos	quaternário+N+DIM+M+PL
quaternariozinho	quaternário+N+DIM+M+SG
quaternariozinhos	quaternário+N+DIM+M+PL
quaternária	quaternário+N+F+SG
quaternárias	quaternário+N+F+PL
quaternário	quaternário+N+M+SG
quaternários	quaternário+N+M+PL
quatetezinho	quatetê+N+DIM+M+SG
quatetezinhos	quatetê+N+DIM+M+PL
quatetê	quatetê+N+M+SG
quatetês	quatetê+N+M+PL
quati	quati+N+M+SG
quatis	quati+N+M+PL
quatizinho	quati+N+DIM+M+SG
quatizinhos	quati+N+DIM+M+PL
quatimirim	quatimirim+N+M+SG
quatimirins	quatimirim+N+M+PL
quatimirinzinho	quatimirim+N+DIM+M+SG
quatimirinzinhos	quatimirim+N+DIM+M+PL
quatipuru	quatipuru+N+M+SG
quatipurus	quatipuru+N+M+PL
quatipuruzinho	quatipuru+N+DIM+M+SG
quatipuruzinhos	quatipuru+N+DIM+M+PL
quatorze	quatorze+N+M+SG
quatorzes	quatorze+N+M+PL
quatorzezinho	quatorze+N+DIM+M+SG
quatorzezinhos	quatorze+N+DIM+M+PL
quatorzinho	quatorze+N+DIM+M+SG
quatorzinhos	quatorze+N+DIM+M+PL
quatrienalidade	quatrienalidade+N+F+SG
quatrienalidades	quatrienalidade+N+F+PL
quatrienalidadezinha	quatrienalidade+N+DIM+F+SG
quatrienalidadezinhas	quatrienalidade+N+DIM+F+PL
quatrienalidadinha	quatrienalidade+N+DIM+F+SG
quatrienalidadinhas	quatrienalidade+N+DIM+F+PL
quatrilhão	quatrilhão+N+M+SG
quatrilhãozinho	quatrilhão+N+DIM+M+SG
quatrilhões	quatrilhão+N+M+PL
quatrilhõezinhos	quatrilhão+N+DIM+M+PL
quatrilião	quatrilião+N+SG
quatriliãozinha	quatrilião+N+DIM+F+SG
quatriliãozinho	quatrilião+N+DIM+M+SG
quatriliões	quatrilião+N+PL
quatriliõezinhas	quatrilião+N+DIM+F+PL
quatriliõezinhos	quatrilião+N+DIM+M+PL
quatrim	quatrim+N+M+SG
quatrins	quatrim+N+M+PL
quatrinzinho	quatrim+N+DIM+M+SG
quatrinzinhos	quatrim+N+DIM+M+PL
quatrinca	quatrinca+N+F+SG
quatrincas	quatrinca+N+F+PL
quatrincazinha	quatrinca+N+DIM+F+SG
quatrincazinhas	quatrinca+N+DIM+F+PL
quatrinquinha	quatrinca+N+DIM+F+SG
quatrinquinhas	quatrinca+N+DIM+F+PL
quatrineta	quatrineta+N+F+SG
quatrinetas	quatrineta+N+F+PL
quatrinetazinha	quatrineta+N+DIM+F+SG
quatrinetazinhas	quatrineta+N+DIM+F+PL
quatrinetinha	quatrineta+N+DIM+F+SG
quatrinetinhas	quatrineta+N+DIM+F+PL
quatrieninho	quatriénio+N+DIM+M+SG
quatrieninhos	quatriénio+N+DIM+M+PL
quatrieniozinho	quatriénio+N+DIM+M+SG
quatrieniozinhos	quatriénio+N+DIM+M+PL
quatriénio	quatriénio+N+M+SG
quatriénios	quatriénio+N+M+PL
quatrieninho	quatriênio+N+DIM+M+SG
quatrieninhos	quatriênio+N+DIM+M+PL
quatrieniozinho	quatriênio+N+DIM+M+SG
quatrieniozinhos	quatriênio+N+DIM+M+PL
quatriênio	quatriênio+N+M+SG
quatriênios	quatriênio+N+M+PL
quatrinho	quatro+N+DIM+M+SG
quatrinhos	quatro+N+DIM+M+PL
quatro	quatro+N+M+SG
quatros	quatro+N+M+PL
quatrozinho	quatro+N+DIM+M+SG
quatrozinhos	quatro+N+DIM+M+PL
quatro-cantos	quatro-cantos+N+M
quatro-cantosinhas	quatro-cantos+N+DIM+F+PL
quatro-cantosinho	quatro-cantos+N+DIM+M+SG
quatro-cantosinhos	quatro-cantos+N+DIM+M+PL
quatro-olhos	quatro-olhos+N
quatro-olhosinha	quatro-olhos+N+DIM+F+SG
quatro-olhosinhas	quatro-olhos+N+DIM+F+PL
quatro-olhosinho	quatro-olhos+N+DIM+M+SG
quatro-olhosinhos	quatro-olhos+N+DIM+M+PL
quatro-quartos	quatro-quartos+N+M
quatro-quartosinhas	quatro-quartos+N+DIM+F+PL
quatro-quartosinho	quatro-quartos+N+DIM+M+SG
quatro-quartosinhos	quatro-quartos+N+DIM+M+PL
quatrocentisminho	quatrocentismo+N+DIM+M+SG
quatrocentisminhos	quatrocentismo+N+DIM+M+PL
quatrocentismo	quatrocentismo+N+M+SG
quatrocentismos	quatrocentismo+N+M+PL
quatrocentismozinho	quatrocentismo+N+DIM+M+SG
quatrocentismozinhos	quatrocentismo+N+DIM+M+PL
quatrocentista	quatrocentista+N+SG
quatrocentistas	quatrocentista+N+PL
quatrocentistazinha	quatrocentista+N+DIM+F+SG
quatrocentistazinhas	quatrocentista+N+DIM+F+PL
quatrocentistazinho	quatrocentista+N+DIM+M+SG
quatrocentistazinhos	quatrocentista+N+DIM+M+PL
quatrocentistinha	quatrocentista+N+DIM+SG
quatrocentistinhas	quatrocentista+N+DIM+PL
quatrocentos	quatrocentos+N+M
quatrocentosinhas	quatrocentos+N+DIM+F+PL
quatrocentosinho	quatrocentos+N+DIM+M+SG
quatrocentosinhos	quatrocentos+N+DIM+M+PL
quatriduinho	quatríduo+N+DIM+M+SG
quatriduinhos	quatríduo+N+DIM+M+PL
quatriduozinho	quatríduo+N+DIM+M+SG
quatriduozinhos	quatríduo+N+DIM+M+PL
quatríduo	quatríduo+N+M+SG
quatríduos	quatríduo+N+M+PL
quatuorviradinho	quatuorvirado+N+DIM+M+SG
quatuorviradinhos	quatuorvirado+N+DIM+M+PL
quatuorvirado	quatuorvirado+N+M+SG
quatuorvirados	quatuorvirado+N+M+PL
quatuorviradozinho	quatuorvirado+N+DIM+M+SG
quatuorviradozinhos	quatuorvirado+N+DIM+M+PL
quatuorviratinho	quatuorvirato+N+DIM+M+SG
quatuorviratinhos	quatuorvirato+N+DIM+M+PL
quatuorvirato	quatuorvirato+N+M+SG
quatuorviratos	quatuorvirato+N+M+PL
quatuorviratozinho	quatuorvirato+N+DIM+M+SG
quatuorviratozinhos	quatuorvirato+N+DIM+M+PL
quatuorvirinho	quatuórviro+N+DIM+M+SG
quatuorvirinhos	quatuórviro+N+DIM+M+PL
quatuorvirozinho	quatuórviro+N+DIM+M+SG
quatuorvirozinhos	quatuórviro+N+DIM+M+PL
quatuórviro	quatuórviro+N+M+SG
quatuórviros	quatuórviro+N+M+PL
quebra	quebra+N+SG
quebras	quebra+N+PL
quebrazinha	quebra+N+DIM+F+SG
quebrazinhas	quebra+N+DIM+F+PL
quebrazinho	quebra+N+DIM+M+SG
quebrazinhos	quebra+N+DIM+M+PL
quebrinha	quebra+N+DIM+SG
quebrinhas	quebra+N+DIM+PL
quebra-cabeças	quebra-cabeças+N
quebra-cabeçasinha	quebra-cabeças+N+DIM+F+SG
quebra-cabeçasinhas	quebra-cabeças+N+DIM+F+PL
quebra-cabeçasinho	quebra-cabeças+N+DIM+M+SG
quebra-cabeçasinhos	quebra-cabeças+N+DIM+M+PL
quebra-corações	quebra-corações+N
quebra-coraçõesinha	quebra-corações+N+DIM+F+SG
quebra-coraçõesinhas	quebra-corações+N+DIM+F+PL
quebra-coraçõesinho	quebra-corações+N+DIM+M+SG
quebra-coraçõesinhos	quebra-corações+N+DIM+M+PL
quebra-galhinho	quebra-galho+N+DIM+M+SG
quebra-galhinhos	quebra-galho+N+DIM+M+PL
quebra-galho	quebra-galho+N+M+SG
quebra-galhos	quebra-galho+N+M+PL
quebra-galhozinho	quebra-galho+N+DIM+M+SG
quebra-galhozinhos	quebra-galho+N+DIM+M+PL
quebra-gelinho	quebra-gelo+N+DIM+M+SG
quebra-gelinhos	quebra-gelo+N+DIM+M+PL
quebra-gelo	quebra-gelo+N+M+SG
quebra-gelozinho	quebra-gelo+N+DIM+M+SG
quebra-gelos	quebra-gelos+N+M+PL
quebra-gelosinhas	quebra-gelos+N+DIM+F+PL
quebra-gelosinhos	quebra-gelos+N+DIM+M+PL
quebra-luz	quebra-luz+N+M+SG
quebra-luzes	quebra-luz+N+M+PL
quebra-luzezinhos	quebra-luz+N+DIM+M+PL
quebra-luzinho	quebra-luz+N+DIM+M+SG
quebra-luzinhos	quebra-luz+N+DIM+M+PL
quebra-mar	quebra-mar+N+M+SG
quebra-mares	quebra-mar+N+M+PL
quebra-marezinhos	quebra-mar+N+DIM+M+PL
quebra-marzinho	quebra-mar+N+DIM+M+SG
quebra-marzinhos	quebra-mar+N+DIM+M+PL
quebra-molas	quebra-molas+N+M
quebra-molasinhas	quebra-molas+N+DIM+F+PL
quebra-molasinho	quebra-molas+N+DIM+M+SG
quebra-molasinhos	quebra-molas+N+DIM+M+PL
quebra-nozes	quebra-nozes+N+M
quebra-nozesinhas	quebra-nozes+N+DIM+F+PL
quebra-nozesinho	quebra-nozes+N+DIM+M+SG
quebra-nozesinhos	quebra-nozes+N+DIM+M+PL
quebra-pau	quebra-pau+N+M+SG
quebra-paus	quebra-pau+N+M+PL
quebra-pauzinho	quebra-pau+N+DIM+M+SG
quebra-pauzinhos	quebra-pau+N+DIM+M+PL
quebra-quebra	quebra-quebra+N+M+SG
quebra-quebras	quebra-quebra+N+M+PL
quebra-quebrazinho	quebra-quebra+N+DIM+M+SG
quebra-quebrazinhos	quebra-quebra+N+DIM+M+PL
quebra-quebrinha	quebra-quebra+N+DIM+M+SG
quebra-quebrinhas	quebra-quebra+N+DIM+M+PL
quebra-ventinho	quebra-vento+N+DIM+M+SG
quebra-ventinhos	quebra-vento+N+DIM+M+PL
quebra-vento	quebra-vento+N+M+SG
quebra-ventos	quebra-vento+N+M+PL
quebra-ventozinho	quebra-vento+N+DIM+M+SG
quebra-ventozinhos	quebra-vento+N+DIM+M+PL
quebrabilidade	quebrabilidade+N+F+SG
quebrabilidades	quebrabilidade+N+F+PL
quebrabilidadezinha	quebrabilidade+N+DIM+F+SG
quebrabilidadezinhas	quebrabilidade+N+DIM+F+PL
quebrabilidadinha	quebrabilidade+N+DIM+F+SG
quebrabilidadinhas	quebrabilidade+N+DIM+F+PL
quebrachinho	quebracho+N+DIM+M+SG
quebrachinhos	quebracho+N+DIM+M+PL
quebracho	quebracho+N+M+SG
quebrachos	quebracho+N+M+PL
quebrachozinho	quebracho+N+DIM+M+SG
quebrachozinhos	quebracho+N+DIM+M+PL
quebrada	quebrada+N+F+SG
quebradas	quebrada+N+F+PL
quebradazinha	quebrada+N+DIM+F+SG
quebradazinhas	quebrada+N+DIM+F+PL
quebradinha	quebrada+N+DIM+F+SG
quebradinhas	quebrada+N+DIM+F+PL
quebradeira	quebradeira+N+F+SG
quebradeiras	quebradeira+N+F+PL
quebradeirazinha	quebradeira+N+DIM+F+SG
quebradeirazinhas	quebradeira+N+DIM+F+PL
quebradeirinha	quebradeira+N+DIM+F+SG
quebradeirinhas	quebradeira+N+DIM+F+PL
quebradela	quebradela+N+F+SG
quebradelas	quebradela+N+F+PL
quebradelazinha	quebradela+N+DIM+F+SG
quebradelazinhas	quebradela+N+DIM+F+PL
quebradelinha	quebradela+N+DIM+F+SG
quebradelinhas	quebradela+N+DIM+F+PL
quebrada	quebrado+N+F+SG
quebradas	quebrado+N+F+PL
quebradazinha	quebrado+N+DIM+F+SG
quebradazinhas	quebrado+N+DIM+F+PL
quebradinha	quebrado+N+DIM+F+SG
quebradinhas	quebrado+N+DIM+F+PL
quebradinho	quebrado+N+DIM+M+SG
quebradinhos	quebrado+N+DIM+M+PL
quebrado	quebrado+N+M+SG
quebrados	quebrado+N+M+PL
quebradozinho	quebrado+N+DIM+M+SG
quebradozinhos	quebrado+N+DIM+M+PL
quebradoirinho	quebradoiro+N+DIM+M+SG
quebradoirinhos	quebradoiro+N+DIM+M+PL
quebradoiro	quebradoiro+N+M+SG
quebradoiros	quebradoiro+N+M+PL
quebradoirozinho	quebradoiro+N+DIM+M+SG
quebradoirozinhos	quebradoiro+N+DIM+M+PL
quebrador	quebrador+N+M+SG
quebradora	quebrador+N+F+SG
quebradoras	quebrador+N+F+PL
quebradorazinha	quebrador+N+DIM+F+SG
quebradorazinhas	quebrador+N+DIM+F+PL
quebradores	quebrador+N+M+PL
quebradorezinhos	quebrador+N+DIM+M+PL
quebradorinha	quebrador+N+DIM+F+SG
quebradorinhas	quebrador+N+DIM+F+PL
quebradorzinho	quebrador+N+DIM+M+SG
quebradorzinhos	quebrador+N+DIM+M+PL
quebradourinho	quebradouro+N+DIM+M+SG
quebradourinhos	quebradouro+N+DIM+M+PL
quebradouro	quebradouro+N+M+SG
quebradouros	quebradouro+N+M+PL
quebradourozinho	quebradouro+N+DIM+M+SG
quebradourozinhos	quebradouro+N+DIM+M+PL
quebradura	quebradura+N+F+SG
quebraduras	quebradura+N+F+PL
quebradurazinha	quebradura+N+DIM+F+SG
quebradurazinhas	quebradura+N+DIM+F+PL
quebradurinha	quebradura+N+DIM+F+SG
quebradurinhas	quebradura+N+DIM+F+PL
quebralhona	quebralhão+N+F+SG
quebralhonas	quebralhão+N+F+PL
quebralhonazinha	quebralhão+N+DIM+F+SG
quebralhonazinhas	quebralhão+N+DIM+F+PL
quebralhoninha	quebralhão+N+DIM+F+SG
quebralhoninhas	quebralhão+N+DIM+F+PL
quebralhão	quebralhão+N+M+SG
quebralhãozinho	quebralhão+N+DIM+M+SG
quebralhões	quebralhão+N+M+PL
quebralhõezinhos	quebralhão+N+DIM+M+PL
quebramentinho	quebramento+N+DIM+M+SG
quebramentinhos	quebramento+N+DIM+M+PL
quebramento	quebramento+N+M+SG
quebramentos	quebramento+N+M+PL
quebramentozinho	quebramento+N+DIM+M+SG
quebramentozinhos	quebramento+N+DIM+M+PL
quebrantador	quebrantador+N+M+SG
quebrantadora	quebrantador+N+F+SG
quebrantadoras	quebrantador+N+F+PL
quebrantadorazinha	quebrantador+N+DIM+F+SG
quebrantadorazinhas	quebrantador+N+DIM+F+PL
quebrantadores	quebrantador+N+M+PL
quebrantadorezinhos	quebrantador+N+DIM+M+PL
quebrantadorinha	quebrantador+N+DIM+F+SG
quebrantadorinhas	quebrantador+N+DIM+F+PL
quebrantadorzinho	quebrantador+N+DIM+M+SG
quebrantadorzinhos	quebrantador+N+DIM+M+PL
quebrantamentinho	quebrantamento+N+DIM+M+SG
quebrantamentinhos	quebrantamento+N+DIM+M+PL
quebrantamento	quebrantamento+N+M+SG
quebrantamentos	quebrantamento+N+M+PL
quebrantamentozinho	quebrantamento+N+DIM+M+SG
quebrantamentozinhos	quebrantamento+N+DIM+M+PL
quebrantinho	quebranto+N+DIM+M+SG
quebrantinhos	quebranto+N+DIM+M+PL
quebranto	quebranto+N+M+SG
quebrantos	quebranto+N+M+PL
quebrantozinho	quebranto+N+DIM+M+SG
quebrantozinhos	quebranto+N+DIM+M+PL
quebrancinha	quebrança+N+DIM+F+SG
quebrancinhas	quebrança+N+DIM+F+PL
quebrança	quebrança+N+F+SG
quebranças	quebrança+N+F+PL
quebrançazinha	quebrança+N+DIM+F+SG
quebrançazinhas	quebrança+N+DIM+F+PL
quebrar	quebrar+N+M+SG
quebrarzinho	quebrar+N+DIM+M+SG
quebratura	quebratura+N+F+SG
quebraturas	quebratura+N+F+PL
quebraturazinha	quebratura+N+DIM+F+SG
quebraturazinhas	quebratura+N+DIM+F+PL
quebraturinha	quebratura+N+DIM+F+SG
quebraturinhas	quebratura+N+DIM+F+PL
quebração	quebração+N+F+SG
quebraçãozinha	quebração+N+DIM+F+SG
quebrações	quebração+N+F+PL
quebraçõezinhas	quebração+N+DIM+F+PL
quebreira	quebreira+N+F+SG
quebreiras	quebreira+N+F+PL
quebreirazinha	quebreira+N+DIM+F+SG
quebreirazinhas	quebreira+N+DIM+F+PL
quebreirinha	quebreira+N+DIM+F+SG
quebreirinhas	quebreira+N+DIM+F+PL
quebrinho	quebro+N+DIM+M+SG
quebrinhos	quebro+N+DIM+M+PL
quebro	quebro+N+M+SG
quebros	quebro+N+M+PL
quebrozinho	quebro+N+DIM+M+SG
quebrozinhos	quebro+N+DIM+M+PL
queda	queda+N+F+SG
quedas	queda+N+F+PL
quedazinha	queda+N+DIM+F+SG
quedazinhas	queda+N+DIM+F+PL
quedinha	queda+N+DIM+F+SG
quedinhas	queda+N+DIM+F+PL
queda-de-bracinho	queda-de-braço+N+DIM+F+SG
queda-de-bracinhos	queda-de-braço+N+DIM+F+PL
queda-de-braço	queda-de-braço+N+F+SG
queda-de-braçozinha	queda-de-braço+N+DIM+F+SG
quedas-de-braço	queda-de-braço+N+F+PL
quedas-de-braçozinhas	queda-de-braço+N+DIM+F+PL
quedisminho	quedismo+N+DIM+M+SG
quedisminhos	quedismo+N+DIM+M+PL
quedismo	quedismo+N+M+SG
quedismos	quedismo+N+M+PL
quedismozinho	quedismo+N+DIM+M+SG
quedismozinhos	quedismo+N+DIM+M+PL
quedista	quedista+N+SG
quedistas	quedista+N+PL
quedistazinha	quedista+N+DIM+F+SG
quedistazinhas	quedista+N+DIM+F+PL
quedistazinho	quedista+N+DIM+M+SG
quedistazinhos	quedista+N+DIM+M+PL
quedistinha	quedista+N+DIM+SG
quedistinhas	quedista+N+DIM+PL
quediva	quediva+N+M+SG
quedivas	quediva+N+M+PL
quedivazinho	quediva+N+DIM+M+SG
quedivazinhos	quediva+N+DIM+M+PL
quedivinha	quediva+N+DIM+M+SG
quedivinhas	quediva+N+DIM+M+PL
quedive	quedive+N+M+SG
quedives	quedive+N+M+PL
quedivezinho	quedive+N+DIM+M+SG
quedivezinhos	quedive+N+DIM+M+PL
quedivinho	quedive+N+DIM+M+SG
quedivinhos	quedive+N+DIM+M+PL
quefazer	quefazer+N+M+SG
quefazeres	quefazer+N+M+PL
quefazerezinhos	quefazer+N+DIM+M+PL
quefazerzinho	quefazer+N+DIM+M+SG
quefazerzinhos	quefazer+N+DIM+M+PL
quefir	quefir+N+M+SG
quefires	quefir+N+M+PL
quefirezinhos	quefir+N+DIM+M+PL
quefirzinho	quefir+N+DIM+M+SG
quefirzinhos	quefir+N+DIM+M+PL
quefirina	quefirina+N+F+SG
quefirinas	quefirina+N+F+PL
quefirinazinha	quefirina+N+DIM+F+SG
quefirinazinhas	quefirina+N+DIM+F+PL
quefirininha	quefirina+N+DIM+F+SG
quefirininhas	quefirina+N+DIM+F+PL
quefiroterapia	quefiroterapia+N+F+SG
quefiroterapias	quefiroterapia+N+F+PL
quefiroterapiazinha	quefiroterapia+N+DIM+F+SG
quefiroterapiazinhas	quefiroterapia+N+DIM+F+PL
quefiroterapinha	quefiroterapia+N+DIM+F+SG
quefiroterapinhas	quefiroterapia+N+DIM+F+PL
queijada	queijada+N+F+SG
queijadas	queijada+N+F+PL
queijadazinha	queijada+N+DIM+F+SG
queijadazinhas	queijada+N+DIM+F+PL
queijadinha	queijada+N+DIM+F+SG
queijadinhas	queijada+N+DIM+F+PL
queijadita	queijada+N+DIM+F+SG
queijaditas	queijada+N+DIM+F+PL
queijadeira	queijadeiro+N+F+SG
queijadeiras	queijadeiro+N+F+PL
queijadeirazinha	queijadeiro+N+DIM+F+SG
queijadeirazinhas	queijadeiro+N+DIM+F+PL
queijadeirinha	queijadeiro+N+DIM+F+SG
queijadeirinhas	queijadeiro+N+DIM+F+PL
queijadeirinho	queijadeiro+N+DIM+M+SG
queijadeirinhos	queijadeiro+N+DIM+M+PL
queijadeiro	queijadeiro+N+M+SG
queijadeiros	queijadeiro+N+M+PL
queijadeirozinho	queijadeiro+N+DIM+M+SG
queijadeirozinhos	queijadeiro+N+DIM+M+PL
queijadilhinho	queijadilho+N+DIM+M+SG
queijadilhinhos	queijadilho+N+DIM+M+PL
queijadilho	queijadilho+N+M+SG
queijadilhos	queijadilho+N+M+PL
queijadilhozinho	queijadilho+N+DIM+M+SG
queijadilhozinhos	queijadilho+N+DIM+M+PL
queijadinha	queijadinha+N+F+SG
queijadinhas	queijadinha+N+F+PL
queijadinhazinha	queijadinha+N+DIM+F+SG
queijadinhazinhas	queijadinha+N+DIM+F+PL
queijadinhinha	queijadinha+N+DIM+F+SG
queijadinhinhas	queijadinha+N+DIM+F+PL
queijaria	queijaria+N+F+SG
queijarias	queijaria+N+F+PL
queijariazinha	queijaria+N+DIM+F+SG
queijariazinhas	queijaria+N+DIM+F+PL
queijarinha	queijaria+N+DIM+F+SG
queijarinhas	queijaria+N+DIM+F+PL
queijeira	queijeira+N+F+SG
queijeiras	queijeira+N+F+PL
queijeirazinha	queijeira+N+DIM+F+SG
queijeirazinhas	queijeira+N+DIM+F+PL
queijeirinha	queijeira+N+DIM+F+SG
queijeirinhas	queijeira+N+DIM+F+PL
queijeira	queijeiro+N+F+SG
queijeiras	queijeiro+N+F+PL
queijeirazinha	queijeiro+N+DIM+F+SG
queijeirazinhas	queijeiro+N+DIM+F+PL
queijeirinha	queijeiro+N+DIM+F+SG
queijeirinhas	queijeiro+N+DIM+F+PL
queijeirinho	queijeiro+N+DIM+M+SG
queijeirinhos	queijeiro+N+DIM+M+PL
queijeiro	queijeiro+N+M+SG
queijeiros	queijeiro+N+M+PL
queijeirozinho	queijeiro+N+DIM+M+SG
queijeirozinhos	queijeiro+N+DIM+M+PL
queijinho	queijo+N+DIM+M+SG
queijinhos	queijo+N+DIM+M+PL
queijito	queijo+N+DIM+M+SG
queijitos	queijo+N+DIM+M+PL
queijo	queijo+N+M+SG
queijos	queijo+N+M+PL
queijozinho	queijo+N+DIM+M+SG
queijozinhos	queijo+N+DIM+M+PL
queijo-de-minas	queijo-de-minas+N+M+SG
queijo-de-minasinho	queijo-de-minas+N+DIM+M+SG
queijos-de-minas	queijo-de-minas+N+M+PL
queijos-de-minazinhos	queijo-de-minas+N+DIM+M+PL
queilodipterideinho	queilodipterídeo+N+DIM+M+SG
queilodipterideinhos	queilodipterídeo+N+DIM+M+PL
queilodipterideozinho	queilodipterídeo+N+DIM+M+SG
queilodipterideozinhos	queilodipterídeo+N+DIM+M+PL
queilodipterídeo	queilodipterídeo+N+M+SG
queilodipterídeos	queilodipterídeo+N+M+PL
queilodipteridazinho	queilodiptérida+N+DIM+M+SG
queilodipteridazinhos	queilodiptérida+N+DIM+M+PL
queilodipteridinha	queilodiptérida+N+DIM+M+SG
queilodipteridinhas	queilodiptérida+N+DIM+M+PL
queilodiptérida	queilodiptérida+N+M+SG
queilodiptéridas	queilodiptérida+N+M+PL
queilose	queilose+N+F+SG
queiloses	queilose+N+F+PL
queilosezinha	queilose+N+DIM+F+SG
queilosezinhas	queilose+N+DIM+F+PL
queilosinha	queilose+N+DIM+F+SG
queilosinhas	queilose+N+DIM+F+PL
queima	queima+N+SG
queimas	queima+N+PL
queimazinha	queima+N+DIM+F+SG
queimazinhas	queima+N+DIM+F+PL
queimazinho	queima+N+DIM+M+SG
queimazinhos	queima+N+DIM+M+PL
queiminha	queima+N+DIM+SG
queiminhas	queima+N+DIM+PL
queima-roupa	queima-roupa+N+F+SG
queima-roupas	queima-roupa+N+F+PL
queima-roupazinha	queima-roupa+N+DIM+F+SG
queima-roupazinhas	queima-roupa+N+DIM+F+PL
queima-roupinha	queima-roupa+N+DIM+F+SG
queima-roupinhas	queima-roupa+N+DIM+F+PL
queimada	queimada+N+F+SG
queimadas	queimada+N+F+PL
queimadazinha	queimada+N+DIM+F+SG
queimadazinhas	queimada+N+DIM+F+PL
queimadinha	queimada+N+DIM+F+SG
queimadinhas	queimada+N+DIM+F+PL
queimadeira	queimadeira+N+F+SG
queimadeiras	queimadeira+N+F+PL
queimadeirazinha	queimadeira+N+DIM+F+SG
queimadeirazinhas	queimadeira+N+DIM+F+PL
queimadeirinha	queimadeira+N+DIM+F+SG
queimadeirinhas	queimadeira+N+DIM+F+PL
queimadela	queimadela+N+F+SG
queimadelas	queimadela+N+F+PL
queimadelazinha	queimadela+N+DIM+F+SG
queimadelazinhas	queimadela+N+DIM+F+PL
queimadelinha	queimadela+N+DIM+F+SG
queimadelinhas	queimadela+N+DIM+F+PL
queimada	queimado+N+F+SG
queimadas	queimado+N+F+PL
queimadazinha	queimado+N+DIM+F+SG
queimadazinhas	queimado+N+DIM+F+PL
queimadinha	queimado+N+DIM+F+SG
queimadinhas	queimado+N+DIM+F+PL
queimadinho	queimado+N+DIM+M+SG
queimadinhos	queimado+N+DIM+M+PL
queimado	queimado+N+M+SG
queimados	queimado+N+M+PL
queimadozinho	queimado+N+DIM+M+SG
queimadozinhos	queimado+N+DIM+M+PL
queimadoirinho	queimadoiro+N+DIM+M+SG
queimadoirinhos	queimadoiro+N+DIM+M+PL
queimadoiro	queimadoiro+N+M+SG
queimadoiros	queimadoiro+N+M+PL
queimadoirozinho	queimadoiro+N+DIM+M+SG
queimadoirozinhos	queimadoiro+N+DIM+M+PL
queimador	queimador+N+M+SG
queimadora	queimador+N+F+SG
queimadoras	queimador+N+F+PL
queimadorazinha	queimador+N+DIM+F+SG
queimadorazinhas	queimador+N+DIM+F+PL
queimadores	queimador+N+M+PL
queimadorezinhos	queimador+N+DIM+M+PL
queimadorinha	queimador+N+DIM+F+SG
queimadorinhas	queimador+N+DIM+F+PL
queimadorzinho	queimador+N+DIM+M+SG
queimadorzinhos	queimador+N+DIM+M+PL
queimadourinho	queimadouro+N+DIM+M+SG
queimadourinhos	queimadouro+N+DIM+M+PL
queimadouro	queimadouro+N+M+SG
queimadouros	queimadouro+N+M+PL
queimadourozinho	queimadouro+N+DIM+M+SG
queimadourozinhos	queimadouro+N+DIM+M+PL
queimadura	queimadura+N+F+SG
queimaduras	queimadura+N+F+PL
queimadurazinha	queimadura+N+DIM+F+SG
queimadurazinhas	queimadura+N+DIM+F+PL
queimadurinha	queimadura+N+DIM+F+SG
queimadurinhas	queimadura+N+DIM+F+PL
queimamentinho	queimamento+N+DIM+M+SG
queimamentinhos	queimamento+N+DIM+M+PL
queimamento	queimamento+N+M+SG
queimamentos	queimamento+N+M+PL
queimamentozinho	queimamento+N+DIM+M+SG
queimamentozinhos	queimamento+N+DIM+M+PL
queimação	queimação+N+F+SG
queimaçãozinha	queimação+N+DIM+F+SG
queimações	queimação+N+F+PL
queimaçõezinhas	queimação+N+DIM+F+PL
queiminho	queimo+N+DIM+M+SG
queiminhos	queimo+N+DIM+M+PL
queimo	queimo+N+M+SG
queimos	queimo+N+M+PL
queimozinho	queimo+N+DIM+M+SG
queimozinhos	queimo+N+DIM+M+PL
queimor	queimor+N+M+SG
queimores	queimor+N+M+PL
queimorezinhos	queimor+N+DIM+M+PL
queimorzinho	queimor+N+DIM+M+SG
queimorzinhos	queimor+N+DIM+M+PL
queimosidade	queimosidade+N+F+SG
queimosidades	queimosidade+N+F+PL
queimosidadezinha	queimosidade+N+DIM+F+SG
queimosidadezinhas	queimosidade+N+DIM+F+PL
queimosidadinha	queimosidade+N+DIM+F+SG
queimosidadinhas	queimosidade+N+DIM+F+PL
queimão	queimão+N+M+SG
queimãozinho	queimão+N+DIM+M+SG
queimões	queimão+N+M+PL
queimõezinhos	queimão+N+DIM+M+PL
queiroga	queiroga+N+F+SG
queirogas	queiroga+N+F+PL
queirogazinha	queiroga+N+DIM+F+SG
queirogazinhas	queiroga+N+DIM+F+PL
queiroguinha	queiroga+N+DIM+F+SG
queiroguinhas	queiroga+N+DIM+F+PL
queirozinha	queiró+N+DIM+F+SG
queirozinhas	queiró+N+DIM+F+PL
queirozinho	queiró+N+DIM+M+SG
queirozinhos	queiró+N+DIM+M+PL
queiró	queiró+N+SG
queirós	queiró+N+PL
queixa	queixa+N+F+SG
queixas	queixa+N+F+PL
queixazinha	queixa+N+DIM+F+SG
queixazinhas	queixa+N+DIM+F+PL
queixazita	queixa+N+DIM+F+SG
queixazitas	queixa+N+DIM+F+PL
queixinha	queixa+N+DIM+F+SG
queixinhas	queixa+N+DIM+F+PL
queixita	queixa+N+DIM+F+SG
queixitas	queixa+N+DIM+F+PL
queixa-crime	queixa-crime+N+F+SG
queixa-crimezinha	queixa-crime+N+DIM+F+SG
queixa-criminha	queixa-crime+N+DIM+F+SG
queixa-criminhas	queixa-crime+N+DIM+F+PL
queixas-crime	queixa-crime+N+F+PL
queixas-crimezinhas	queixa-crime+N+DIM+F+PL
queixada	queixada+N+F+SG
queixadas	queixada+N+F+PL
queixadazinha	queixada+N+DIM+F+SG
queixadazinhas	queixada+N+DIM+F+PL
queixadinha	queixada+N+DIM+F+SG
queixadinhas	queixada+N+DIM+F+PL
queixais	queixal+N+PL
queixaizinhas	queixal+N+DIM+F+PL
queixaizinhos	queixal+N+DIM+M+PL
queixal	queixal+N+SG
queixalzinha	queixal+N+DIM+F+SG
queixalzinho	queixal+N+DIM+M+SG
queixalidade	queixalidade+N+F+SG
queixalidades	queixalidade+N+F+PL
queixalidadezinha	queixalidade+N+DIM+F+SG
queixalidadezinhas	queixalidade+N+DIM+F+PL
queixalidadinha	queixalidade+N+DIM+F+SG
queixalidadinhas	queixalidade+N+DIM+F+PL
queixinhas	queixinhas+N
queixinhasinha	queixinhas+N+DIM+F+SG
queixinhasinhas	queixinhas+N+DIM+F+PL
queixinhasinho	queixinhas+N+DIM+M+SG
queixinhasinhos	queixinhas+N+DIM+M+PL
queixinho	queixo+N+DIM+M+SG
queixinhos	queixo+N+DIM+M+PL
queixo	queixo+N+M+SG
queixos	queixo+N+M+PL
queixozinho	queixo+N+DIM+M+SG
queixozinhos	queixo+N+DIM+M+PL
queixosidade	queixosidade+N+F+SG
queixosidades	queixosidade+N+F+PL
queixosidadezinha	queixosidade+N+DIM+F+SG
queixosidadezinhas	queixosidade+N+DIM+F+PL
queixosidadinha	queixosidade+N+DIM+F+SG
queixosidadinhas	queixosidade+N+DIM+F+PL
queixosa	queixoso+N+F+SG
queixosas	queixoso+N+F+PL
queixosazinha	queixoso+N+DIM+F+SG
queixosazinhas	queixoso+N+DIM+F+PL
queixosinha	queixoso+N+DIM+F+SG
queixosinhas	queixoso+N+DIM+F+PL
queixosinho	queixoso+N+DIM+M+SG
queixosinhos	queixoso+N+DIM+M+PL
queixoso	queixoso+N+M+SG
queixosos	queixoso+N+M+PL
queixosozinho	queixoso+N+DIM+M+SG
queixosozinhos	queixoso+N+DIM+M+PL
queixume	queixume+N+M+SG
queixumes	queixume+N+M+PL
queixumezinho	queixume+N+DIM+M+SG
queixumezinhos	queixume+N+DIM+M+PL
queixuminho	queixume+N+DIM+M+SG
queixuminhos	queixume+N+DIM+M+PL
quejadilhinho	quejadilho+N+DIM+M+SG
quejadilhinhos	quejadilho+N+DIM+M+PL
quejadilho	quejadilho+N+M+SG
quejadilhos	quejadilho+N+M+PL
quejadilhozinho	quejadilho+N+DIM+M+SG
quejadilhozinhos	quejadilho+N+DIM+M+PL
quele	quele+N+M+SG
queles	quele+N+M+PL
quelezinho	quele+N+DIM+M+SG
quelezinhos	quele+N+DIM+M+PL
quelinho	quele+N+DIM+M+SG
quelinhos	quele+N+DIM+M+PL
quelha	quelha+N+F+SG
quelhas	quelha+N+F+PL
quelhazinha	quelha+N+DIM+F+SG
quelhazinhas	quelha+N+DIM+F+PL
quelhinha	quelha+N+DIM+F+SG
quelhinhas	quelha+N+DIM+F+PL
quelhinho	quelho+N+DIM+M+SG
quelhinhos	quelho+N+DIM+M+PL
quelho	quelho+N+M+SG
quelhos	quelho+N+M+PL
quelhozinho	quelho+N+DIM+M+SG
quelhozinhos	quelho+N+DIM+M+PL
quelhorinho	quelhório+N+DIM+M+SG
quelhorinhos	quelhório+N+DIM+M+PL
quelhoriozinho	quelhório+N+DIM+M+SG
quelhoriozinhos	quelhório+N+DIM+M+PL
quelhório	quelhório+N+M+SG
quelhórios	quelhório+N+M+PL
queliceradinho	quelicerado+N+DIM+M+SG
queliceradinhos	quelicerado+N+DIM+M+PL
quelicerado	quelicerado+N+M+SG
quelicerados	quelicerado+N+M+PL
queliceradozinho	quelicerado+N+DIM+M+SG
queliceradozinhos	quelicerado+N+DIM+M+PL
quelidonicidade	quelidonicidade+N+F+SG
quelidonicidades	quelidonicidade+N+F+PL
quelidonicidadezinha	quelidonicidade+N+DIM+F+SG
quelidonicidadezinhas	quelidonicidade+N+DIM+F+PL
quelidonicidadinha	quelidonicidade+N+DIM+F+SG
quelidonicidadinhas	quelidonicidade+N+DIM+F+PL
quelidideinho	quelidídeo+N+DIM+M+SG
quelidideinhos	quelidídeo+N+DIM+M+PL
quelidideozinho	quelidídeo+N+DIM+M+SG
quelidideozinhos	quelidídeo+N+DIM+M+PL
quelidídeo	quelidídeo+N+M+SG
quelidídeos	quelidídeo+N+M+PL
quelidoniazinha	quelidónia+N+DIM+F+SG
quelidoniazinhas	quelidónia+N+DIM+F+PL
quelidoninha	quelidónia+N+DIM+F+SG
quelidoninhas	quelidónia+N+DIM+F+PL
quelidónia	quelidónia+N+F+SG
quelidónias	quelidónia+N+F+PL
quelidoniazinha	quelidônia+N+DIM+F+SG
quelidoniazinhas	quelidônia+N+DIM+F+PL
quelidoninha	quelidônia+N+DIM+F+SG
quelidoninhas	quelidônia+N+DIM+F+PL
quelidônia	quelidônia+N+F+SG
quelidônias	quelidônia+N+F+PL
quelimane	quelimane+N+SG
quelimanes	quelimane+N+PL
quelimanezinha	quelimane+N+DIM+F+SG
quelimanezinhas	quelimane+N+DIM+F+PL
quelimanezinho	quelimane+N+DIM+M+SG
quelimanezinhos	quelimane+N+DIM+M+PL
quelimaninha	quelimane+N+DIM+F+SG
quelimaninhas	quelimane+N+DIM+F+PL
quelimaninho	quelimane+N+DIM+M+SG
quelimaninhos	quelimane+N+DIM+M+PL
quelma	quelma+N+F+SG
quelmas	quelma+N+F+PL
quelmazinha	quelma+N+DIM+F+SG
quelmazinhas	quelma+N+DIM+F+PL
quelminha	quelma+N+DIM+F+SG
quelminhas	quelma+N+DIM+F+PL
quelme	quelme+N+M+SG
quelmes	quelme+N+M+PL
quelmezinho	quelme+N+DIM+M+SG
quelmezinhos	quelme+N+DIM+M+PL
quelminho	quelme+N+DIM+M+SG
quelminhos	quelme+N+DIM+M+PL
queloide	queloide+N+M+SG
queloides	queloide+N+M+PL
queloidezinho	queloide+N+DIM+M+SG
queloidezinhos	queloide+N+DIM+M+PL
queloidinho	queloide+N+DIM+M+SG
queloidinhos	queloide+N+DIM+M+PL
queloniideinho	queloniídeo+N+DIM+M+SG
queloniideinhos	queloniídeo+N+DIM+M+PL
queloniideozinho	queloniídeo+N+DIM+M+SG
queloniideozinhos	queloniídeo+N+DIM+M+PL
queloniídeo	queloniídeo+N+M+SG
queloniídeos	queloniídeo+N+M+PL
quelonografia	quelonografia+N+F+SG
quelonografias	quelonografia+N+F+PL
quelonografiazinha	quelonografia+N+DIM+F+SG
quelonografiazinhas	quelonografia+N+DIM+F+PL
quelonografinha	quelonografia+N+DIM+F+SG
quelonografinhas	quelonografia+N+DIM+F+PL
queloniidazinho	queloníida+N+DIM+M+SG
queloniidazinhos	queloníida+N+DIM+M+PL
queloniidinha	queloníida+N+DIM+M+SG
queloniidinhas	queloníida+N+DIM+M+PL
queloníida	queloníida+N+M+SG
queloníidas	queloníida+N+M+PL
quelonofagazinha	quelonófago+N+DIM+F+SG
quelonofagazinhas	quelonófago+N+DIM+F+PL
quelonofagozinho	quelonófago+N+DIM+M+SG
quelonofagozinhos	quelonófago+N+DIM+M+PL
quelonofaguinha	quelonófago+N+DIM+F+SG
quelonofaguinhas	quelonófago+N+DIM+F+PL
quelonofaguinho	quelonófago+N+DIM+M+SG
quelonofaguinhos	quelonófago+N+DIM+M+PL
quelonófaga	quelonófago+N+F+SG
quelonófagas	quelonófago+N+F+PL
quelonófago	quelonófago+N+M+SG
quelonófagos	quelonófago+N+M+PL
quelonografazinha	quelonógrafo+N+DIM+F+SG
quelonografazinhas	quelonógrafo+N+DIM+F+PL
quelonografinha	quelonógrafo+N+DIM+F+SG
quelonografinhas	quelonógrafo+N+DIM+F+PL
quelonografinho	quelonógrafo+N+DIM+M+SG
quelonografinhos	quelonógrafo+N+DIM+M+PL
quelonografozinho	quelonógrafo+N+DIM+M+SG
quelonografozinhos	quelonógrafo+N+DIM+M+PL
quelonógrafa	quelonógrafo+N+F+SG
quelonógrafas	quelonógrafo+N+F+PL
quelonógrafo	quelonógrafo+N+M+SG
quelonógrafos	quelonógrafo+N+M+PL
quelicerazinha	quelícera+N+DIM+F+SG
quelicerazinhas	quelícera+N+DIM+F+PL
quelicerinha	quelícera+N+DIM+F+SG
quelicerinhas	quelícera+N+DIM+F+PL
quelícera	quelícera+N+F+SG
quelíceras	quelícera+N+F+PL
quelididazinho	quelídida+N+DIM+M+SG
quelididazinhos	quelídida+N+DIM+M+PL
quelididinha	quelídida+N+DIM+M+SG
quelididinhas	quelídida+N+DIM+M+PL
quelídida	quelídida+N+M+SG
quelídidas	quelídida+N+M+PL
quelipodezinho	quelípode+N+DIM+M+SG
quelipodezinhos	quelípode+N+DIM+M+PL
quelipodinho	quelípode+N+DIM+M+SG
quelipodinhos	quelípode+N+DIM+M+PL
quelípode	quelípode+N+M+SG
quelípodes	quelípode+N+M+PL
queloninho	quelónio+N+DIM+M+SG
queloninhos	quelónio+N+DIM+M+PL
queloniozinho	quelónio+N+DIM+M+SG
queloniozinhos	quelónio+N+DIM+M+PL
quelónio	quelónio+N+M+SG
quelónios	quelónio+N+M+PL
queloninho	quelônio+N+DIM+M+SG
queloninhos	quelônio+N+DIM+M+PL
queloniozinho	quelônio+N+DIM+M+SG
queloniozinhos	quelônio+N+DIM+M+PL
quelônio	quelônio+N+M+SG
quelônios	quelônio+N+M+PL
quenga	quengo+N+F+SG
quengas	quengo+N+F+PL
quengazinha	quengo+N+DIM+F+SG
quengazinhas	quengo+N+DIM+F+PL
quengo	quengo+N+M+SG
quengos	quengo+N+M+PL
quengozinho	quengo+N+DIM+M+SG
quengozinhos	quengo+N+DIM+M+PL
quenguinha	quengo+N+DIM+F+SG
quenguinhas	quengo+N+DIM+F+PL
quenguinho	quengo+N+DIM+M+SG
quenguinhos	quengo+N+DIM+M+PL
queniana	queniano+N+F+SG
quenianas	queniano+N+F+PL
quenianazinha	queniano+N+DIM+F+SG
quenianazinhas	queniano+N+DIM+F+PL
quenianinha	queniano+N+DIM+F+SG
quenianinhas	queniano+N+DIM+F+PL
quenianinho	queniano+N+DIM+M+SG
quenianinhos	queniano+N+DIM+M+PL
queniano	queniano+N+M+SG
quenianos	queniano+N+M+PL
quenianozinho	queniano+N+DIM+M+SG
quenianozinhos	queniano+N+DIM+M+PL
quenopodiaceazinho	quenopodiácea+N+DIM+M+SG
quenopodiaceazinhos	quenopodiácea+N+DIM+M+PL
quenopodiaceinha	quenopodiácea+N+DIM+M+SG
quenopodiaceinhas	quenopodiácea+N+DIM+M+PL
quenopodiácea	quenopodiácea+N+M+SG
quenopodiáceas	quenopodiácea+N+M+PL
quenopodiaceazinha	quenopodiáceo+N+DIM+F+SG
quenopodiaceazinhas	quenopodiáceo+N+DIM+F+PL
quenopodiaceinha	quenopodiáceo+N+DIM+F+SG
quenopodiaceinhas	quenopodiáceo+N+DIM+F+PL
quenopodiaceinho	quenopodiáceo+N+DIM+M+SG
quenopodiaceinhos	quenopodiáceo+N+DIM+M+PL
quenopodiaceozinho	quenopodiáceo+N+DIM+M+SG
quenopodiaceozinhos	quenopodiáceo+N+DIM+M+PL
quenopodiácea	quenopodiáceo+N+F+SG
quenopodiáceas	quenopodiáceo+N+F+PL
quenopodiáceo	quenopodiáceo+N+M+SG
quenopodiáceos	quenopodiáceo+N+M+PL
quenopodinho	quenopódio+N+DIM+M+SG
quenopodinhos	quenopódio+N+DIM+M+PL
quenopodiozinho	quenopódio+N+DIM+M+SG
quenopodiozinhos	quenopódio+N+DIM+M+PL
quenopódio	quenopódio+N+M+SG
quenopódios	quenopódio+N+M+PL
quenquenzinha	quenquém+N+DIM+F+SG
quenquenzinhas	quenquém+N+DIM+F+PL
quenquém	quenquém+N+F+SG
quenquéns	quenquém+N+F+PL
quente	quente+N+M+SG
quentes	quente+N+M+PL
quentezinho	quente+N+DIM+M+SG
quentezinhos	quente+N+DIM+M+PL
quentinho	quente+N+DIM+M+SG
quentinhos	quente+N+DIM+M+PL
quentinha	quentinha+N+F+SG
quentinhas	quentinha+N+F+PL
quentinhazinha	quentinha+N+DIM+F+SG
quentinhazinhas	quentinha+N+DIM+F+PL
quentinhinha	quentinha+N+DIM+F+SG
quentinhinhas	quentinha+N+DIM+F+PL
quentura	quentura+N+F+SG
quenturas	quentura+N+F+PL
quenturazinha	quentura+N+DIM+F+SG
quenturazinhas	quentura+N+DIM+F+PL
quenturinha	quentura+N+DIM+F+SG
quenturinhas	quentura+N+DIM+F+PL
quentão	quentão+N+M+SG
quentãozinho	quentão+N+DIM+M+SG
quentões	quentão+N+M+PL
quentõezinhos	quentão+N+DIM+M+PL
quepe	quepe+N+M+SG
quepes	quepe+N+M+PL
quepezinho	quepe+N+DIM+M+SG
quepezinhos	quepe+N+DIM+M+PL
quepinho	quepe+N+DIM+M+SG
quepinhos	quepe+N+DIM+M+PL
queque	queque+N+SG
queques	queque+N+PL
quequezinha	queque+N+DIM+F+SG
quequezinhas	queque+N+DIM+F+PL
quequezinho	queque+N+DIM+M+SG
quequezinhos	queque+N+DIM+M+PL
quequinha	queque+N+DIM+F+SG
quequinhas	queque+N+DIM+F+PL
quequinho	queque+N+DIM+M+SG
quequinhos	queque+N+DIM+M+PL
queratina	queratina+N+F+SG
queratinas	queratina+N+F+PL
queratinazinha	queratina+N+DIM+F+SG
queratinazinhas	queratina+N+DIM+F+PL
queratininha	queratina+N+DIM+F+SG
queratininhas	queratina+N+DIM+F+PL
quercina	quercina+N+F+SG
quercinas	quercina+N+F+PL
quercinazinha	quercina+N+DIM+F+SG
quercinazinhas	quercina+N+DIM+F+PL
quercininha	quercina+N+DIM+F+SG
quercininhas	quercina+N+DIM+F+PL
quercisminho	quercismo+N+DIM+M+SG
quercisminhos	quercismo+N+DIM+M+PL
quercismo	quercismo+N+M+SG
quercismos	quercismo+N+M+PL
quercismozinho	quercismo+N+DIM+M+SG
quercismozinhos	quercismo+N+DIM+M+PL
quercite	quercite+N+F+SG
quercites	quercite+N+F+PL
quercitezinha	quercite+N+DIM+F+SG
quercitezinhas	quercite+N+DIM+F+PL
quercitinha	quercite+N+DIM+F+SG
quercitinhas	quercite+N+DIM+F+PL
quercitrina	quercitrina+N+F+SG
quercitrinas	quercitrina+N+F+PL
quercitrinazinha	quercitrina+N+DIM+F+SG
quercitrinazinhas	quercitrina+N+DIM+F+PL
quercitrininha	quercitrina+N+DIM+F+SG
quercitrininhas	quercitrina+N+DIM+F+PL
querco	querco+N+M+SG
quercos	querco+N+M+PL
quercozinho	querco+N+DIM+M+SG
quercozinhos	querco+N+DIM+M+PL
querquinho	querco+N+DIM+M+SG
querquinhos	querco+N+DIM+M+PL
querela	querela+N+F+SG
querelas	querela+N+F+PL
querelazinha	querela+N+DIM+F+SG
querelazinhas	querela+N+DIM+F+PL
querelinha	querela+N+DIM+F+SG
querelinhas	querela+N+DIM+F+PL
querelada	querelado+N+F+SG
quereladas	querelado+N+F+PL
quereladazinha	querelado+N+DIM+F+SG
quereladazinhas	querelado+N+DIM+F+PL
quereladinha	querelado+N+DIM+F+SG
quereladinhas	querelado+N+DIM+F+PL
quereladinho	querelado+N+DIM+M+SG
quereladinhos	querelado+N+DIM+M+PL
querelado	querelado+N+M+SG
querelados	querelado+N+M+PL
quereladozinho	querelado+N+DIM+M+SG
quereladozinhos	querelado+N+DIM+M+PL
querelador	querelador+N+M+SG
quereladora	querelador+N+F+SG
quereladoras	querelador+N+F+PL
quereladorazinha	querelador+N+DIM+F+SG
quereladorazinhas	querelador+N+DIM+F+PL
quereladores	querelador+N+M+PL
quereladorezinhos	querelador+N+DIM+M+PL
quereladorinha	querelador+N+DIM+F+SG
quereladorinhas	querelador+N+DIM+F+PL
quereladorzinho	querelador+N+DIM+M+SG
quereladorzinhos	querelador+N+DIM+M+PL
querelante	querelante+N+SG
querelantes	querelante+N+PL
querelantezinha	querelante+N+DIM+F+SG
querelantezinhas	querelante+N+DIM+F+PL
querelantezinho	querelante+N+DIM+M+SG
querelantezinhos	querelante+N+DIM+M+PL
querelantinha	querelante+N+DIM+F+SG
querelantinhas	querelante+N+DIM+F+PL
querelantinho	querelante+N+DIM+M+SG
querelantinhos	querelante+N+DIM+M+PL
querelosidade	querelosidade+N+F+SG
querelosidades	querelosidade+N+F+PL
querelosidadezinha	querelosidade+N+DIM+F+SG
querelosidadezinhas	querelosidade+N+DIM+F+PL
querelosidadinha	querelosidade+N+DIM+F+SG
querelosidadinhas	querelosidade+N+DIM+F+PL
queremisminho	queremismo+N+DIM+M+SG
queremisminhos	queremismo+N+DIM+M+PL
queremismo	queremismo+N+M+SG
queremismos	queremismo+N+M+PL
queremismozinho	queremismo+N+DIM+M+SG
queremismozinhos	queremismo+N+DIM+M+PL
querena	querena+N+F+SG
querenas	querena+N+F+PL
querenazinha	querena+N+DIM+F+SG
querenazinhas	querena+N+DIM+F+PL
quereninha	querena+N+DIM+F+SG
quereninhas	querena+N+DIM+F+PL
querencinha	querença+N+DIM+F+SG
querencinhas	querença+N+DIM+F+PL
querença	querença+N+F+SG
querenças	querença+N+F+PL
querençazinha	querença+N+DIM+F+SG
querençazinhas	querença+N+DIM+F+PL
querençosidade	querençosidade+N+F+SG
querençosidades	querençosidade+N+F+PL
querençosidadezinha	querençosidade+N+DIM+F+SG
querençosidadezinhas	querençosidade+N+DIM+F+PL
querençosidadinha	querençosidade+N+DIM+F+SG
querençosidadinhas	querençosidade+N+DIM+F+PL
querer	querer+N+M+SG
quereres	querer+N+M+PL
quererezinhos	querer+N+DIM+M+PL
quererzinho	querer+N+DIM+M+SG
quererzinhos	querer+N+DIM+M+PL
querida	querido+N+F+SG
queridas	querido+N+F+PL
queridazinha	querido+N+DIM+F+SG
queridazinhas	querido+N+DIM+F+PL
queridinha	querido+N+DIM+F+SG
queridinhas	querido+N+DIM+F+PL
queridinho	querido+N+DIM+M+SG
queridinhos	querido+N+DIM+M+PL
queridita	querido+N+DIM+F+SG
queriditas	querido+N+DIM+F+PL
queridito	querido+N+DIM+M+SG
queriditos	querido+N+DIM+M+PL
querido	querido+N+M+SG
queridona	querido+N+AUG+F+SG
queridonas	querido+N+AUG+F+PL
queridonazinha	querido+N+AUG+DIM+F+SG
queridonazinhas	querido+N+AUG+DIM+F+PL
queridoninha	querido+N+AUG+DIM+F+SG
queridoninhas	querido+N+AUG+DIM+F+PL
queridos	querido+N+M+PL
queridozinho	querido+N+DIM+M+SG
queridozinhos	querido+N+DIM+M+PL
queridão	querido+N+AUG+M+SG
queridãozinho	querido+N+AUG+DIM+M+SG
queridões	querido+N+AUG+M+PL
queridõezinhos	querido+N+AUG+DIM+M+PL
queridão	queridão+N+M+SG
queridãozinho	queridão+N+DIM+M+SG
queridões	queridão+N+M+PL
queridõezinhos	queridão+N+DIM+M+PL
querimoniazinha	querimónia+N+DIM+F+SG
querimoniazinhas	querimónia+N+DIM+F+PL
querimoninha	querimónia+N+DIM+F+SG
querimoninhas	querimónia+N+DIM+F+PL
querimónia	querimónia+N+F+SG
querimónias	querimónia+N+F+PL
querimoniazinha	querimônia+N+DIM+F+SG
querimoniazinhas	querimônia+N+DIM+F+PL
querimoninha	querimônia+N+DIM+F+SG
querimoninhas	querimônia+N+DIM+F+PL
querimônia	querimônia+N+F+SG
querimônias	querimônia+N+F+PL
quermes	quermes+N+M
quermesinhas	quermes+N+DIM+F+PL
quermesinho	quermes+N+DIM+M+SG
quermesinhos	quermes+N+DIM+M+PL
quermesite	quermesite+N+F+SG
quermesites	quermesite+N+F+PL
quermesitezinha	quermesite+N+DIM+F+SG
quermesitezinhas	quermesite+N+DIM+F+PL
quermesitinha	quermesite+N+DIM+F+SG
quermesitinhas	quermesite+N+DIM+F+PL
quermesse	quermesse+N+F+SG
quermesses	quermesse+N+F+PL
quermessezinha	quermesse+N+DIM+F+SG
quermessezinhas	quermesse+N+DIM+F+PL
quermessinha	quermesse+N+DIM+F+SG
quermessinhas	quermesse+N+DIM+F+PL
quermesideinho	quermesídeo+N+DIM+M+SG
quermesideinhos	quermesídeo+N+DIM+M+PL
quermesideozinho	quermesídeo+N+DIM+M+SG
quermesideozinhos	quermesídeo+N+DIM+M+PL
quermesídeo	quermesídeo+N+M+SG
quermesídeos	quermesídeo+N+M+PL
quermesidazinho	quermésida+N+DIM+M+SG
quermesidazinhos	quermésida+N+DIM+M+PL
quermesidinha	quermésida+N+DIM+M+SG
quermesidinhas	quermésida+N+DIM+M+PL
quermésida	quermésida+N+M+SG
quermésidas	quermésida+N+M+PL
quernite	quernite+N+F+SG
quernites	quernite+N+F+PL
quernitezinha	quernite+N+DIM+F+SG
quernitezinhas	quernite+N+DIM+F+PL
quernitinha	quernite+N+DIM+F+SG
quernitinhas	quernite+N+DIM+F+PL
quero-querinho	quero-quero+N+DIM+M+SG
quero-querinhos	quero-quero+N+DIM+M+PL
quero-quero	quero-quero+N+M+SG
quero-queros	quero-quero+N+M+PL
quero-querozinho	quero-quero+N+DIM+M+SG
quero-querozinhos	quero-quero+N+DIM+M+PL
querosene	querosene+N+M+SG
querosenes	querosene+N+M+PL
querosenezinho	querosene+N+DIM+M+SG
querosenezinhos	querosene+N+DIM+M+PL
queroseninho	querosene+N+DIM+M+SG
queroseninhos	querosene+N+DIM+M+PL
querquerninho	querquerno+N+DIM+M+SG
querquerninhos	querquerno+N+DIM+M+PL
querquerno	querquerno+N+M+SG
querquernos	querquerno+N+M+PL
querquernozinho	querquerno+N+DIM+M+SG
querquernozinhos	querquerno+N+DIM+M+PL
querquetulaninho	querquetulano+N+DIM+M+SG
querquetulaninhos	querquetulano+N+DIM+M+PL
querquetulano	querquetulano+N+M+SG
querquetulanos	querquetulano+N+M+PL
querquetulanozinho	querquetulano+N+DIM+M+SG
querquetulanozinhos	querquetulano+N+DIM+M+PL
querubim	querubim+N+M+SG
querubins	querubim+N+M+PL
querubinzinho	querubim+N+DIM+M+SG
querubinzinhos	querubim+N+DIM+M+PL
querubinicidade	querubinicidade+N+F+SG
querubinicidades	querubinicidade+N+F+PL
querubinicidadezinha	querubinicidade+N+DIM+F+SG
querubinicidadezinhas	querubinicidade+N+DIM+F+PL
querubinicidadinha	querubinicidade+N+DIM+F+SG
querubinicidadinhas	querubinicidade+N+DIM+F+PL
querenciazinha	querência+N+DIM+F+SG
querenciazinhas	querência+N+DIM+F+PL
querencinha	querência+N+DIM+F+SG
querencinhas	querência+N+DIM+F+PL
querência	querência+N+F+SG
querências	querência+N+F+PL
quesitinho	quesito+N+DIM+M+SG
quesitinhos	quesito+N+DIM+M+PL
quesito	quesito+N+M+SG
quesitos	quesito+N+M+PL
quesitozinho	quesito+N+DIM+M+SG
quesitozinhos	quesito+N+DIM+M+PL
questionabilidade	questionabilidade+N+F+SG
questionabilidades	questionabilidade+N+F+PL
questionabilidadezinha	questionabilidade+N+DIM+F+SG
questionabilidadezinhas	questionabilidade+N+DIM+F+PL
questionabilidadinha	questionabilidade+N+DIM+F+SG
questionabilidadinhas	questionabilidade+N+DIM+F+PL
questionador	questionador+N+M+SG
questionadora	questionador+N+F+SG
questionadoras	questionador+N+F+PL
questionadorazinha	questionador+N+DIM+F+SG
questionadorazinhas	questionador+N+DIM+F+PL
questionadores	questionador+N+M+PL
questionadorezinhos	questionador+N+DIM+M+PL
questionadorinha	questionador+N+DIM+F+SG
questionadorinhas	questionador+N+DIM+F+PL
questionadorzinho	questionador+N+DIM+M+SG
questionadorzinhos	questionador+N+DIM+M+PL
questionamentinho	questionamento+N+DIM+M+SG
questionamentinhos	questionamento+N+DIM+M+PL
questionamento	questionamento+N+M+SG
questionamentos	questionamento+N+M+PL
questionamentozinho	questionamento+N+DIM+M+SG
questionamentozinhos	questionamento+N+DIM+M+PL
questionarinho	questionário+N+DIM+M+SG
questionarinhos	questionário+N+DIM+M+PL
questionariozinho	questionário+N+DIM+M+SG
questionariozinhos	questionário+N+DIM+M+PL
questionário	questionário+N+M+SG
questionários	questionário+N+M+PL
questiunculazinha	questiúncula+N+DIM+F+SG
questiunculazinhas	questiúncula+N+DIM+F+PL
questiunculinha	questiúncula+N+DIM+F+SG
questiunculinhas	questiúncula+N+DIM+F+PL
questiúncula	questiúncula+N+F+SG
questiúnculas	questiúncula+N+F+PL
questor	questor+N+M+SG
questores	questor+N+M+PL
questorezinhos	questor+N+DIM+M+PL
questorzinho	questor+N+DIM+M+SG
questorzinhos	questor+N+DIM+M+PL
questorada	questorado+N+F+SG
questoradas	questorado+N+F+PL
questoradazinha	questorado+N+DIM+F+SG
questoradazinhas	questorado+N+DIM+F+PL
questoradinha	questorado+N+DIM+F+SG
questoradinhas	questorado+N+DIM+F+PL
questoradinho	questorado+N+DIM+M+SG
questoradinhos	questorado+N+DIM+M+PL
questorado	questorado+N+M+SG
questorados	questorado+N+M+PL
questoradozinho	questorado+N+DIM+M+SG
questoradozinhos	questorado+N+DIM+M+PL
questuosidade	questuosidade+N+F+SG
questuosidades	questuosidade+N+F+PL
questuosidadezinha	questuosidade+N+DIM+F+SG
questuosidadezinhas	questuosidade+N+DIM+F+PL
questuosidadinha	questuosidade+N+DIM+F+SG
questuosidadinhas	questuosidade+N+DIM+F+PL
questura	questura+N+F+SG
questuras	questura+N+F+PL
questurazinha	questura+N+DIM+F+SG
questurazinhas	questura+N+DIM+F+PL
questurinha	questura+N+DIM+F+SG
questurinhas	questura+N+DIM+F+PL
questuariazinha	questuário+N+DIM+F+SG
questuariazinhas	questuário+N+DIM+F+PL
questuarinha	questuário+N+DIM+F+SG
questuarinhas	questuário+N+DIM+F+PL
questuarinho	questuário+N+DIM+M+SG
questuarinhos	questuário+N+DIM+M+PL
questuariozinho	questuário+N+DIM+M+SG
questuariozinhos	questuário+N+DIM+M+PL
questuária	questuário+N+F+SG
questuárias	questuário+N+F+PL
questuário	questuário+N+M+SG
questuários	questuário+N+M+PL
questão	questão+N+F+SG
questãozinha	questão+N+DIM+F+SG
questões	questão+N+F+PL
questõezinhas	questão+N+DIM+F+PL
questão-chave	questão-chave+N+F+SG
questão-chavezinha	questão-chave+N+DIM+F+SG
questão-chavinha	questão-chave+N+DIM+F+SG
questão-chavinhas	questão-chave+N+DIM+F+PL
questões-chave	questão-chave+N+F+PL
questões-chavezinhas	questão-chave+N+DIM+F+PL
quetzais	quetzal+N+M+PL
quetzaizinhos	quetzal+N+DIM+M+PL
quetzal	quetzal+N+M+SG
quetzalzinho	quetzal+N+DIM+M+SG
quetçais	quetçal+N+M+PL
quetçaizinhos	quetçal+N+DIM+M+PL
quetçal	quetçal+N+M+SG
quetçalzinho	quetçal+N+DIM+M+SG
quetopodezinho	quetópode+N+DIM+M+SG
quetopodezinhos	quetópode+N+DIM+M+PL
quetopodinho	quetópode+N+DIM+M+SG
quetopodinhos	quetópode+N+DIM+M+PL
quetópode	quetópode+N+M+SG
quetópodes	quetópode+N+M+PL
queveis	quevel+N+M+PL
queveizinhos	quevel+N+DIM+M+PL
quevel	quevel+N+M+SG
quevelzinho	quevel+N+DIM+M+SG
queza	queza+N+F+SG
quezas	queza+N+F+PL
quezazinha	queza+N+DIM+F+SG
quezazinhas	queza+N+DIM+F+PL
quezinha	queza+N+DIM+F+SG
quezinhas	queza+N+DIM+F+PL
quezila	quezila+N+F+SG
quezilas	quezila+N+F+PL
quezilazinha	quezila+N+DIM+F+SG
quezilazinhas	quezila+N+DIM+F+PL
quezilinha	quezila+N+DIM+F+SG
quezilinhas	quezila+N+DIM+F+PL
queziliazinha	quezília+N+DIM+F+SG
queziliazinhas	quezília+N+DIM+F+PL
quezilinha	quezília+N+DIM+F+SG
quezilinhas	quezília+N+DIM+F+PL
quezília	quezília+N+F+SG
quezílias	quezília+N+F+PL
quiabeirinho	quiabeiro+N+DIM+M+SG
quiabeirinhos	quiabeiro+N+DIM+M+PL
quiabeiro	quiabeiro+N+M+SG
quiabeiros	quiabeiro+N+M+PL
quiabeirozinho	quiabeiro+N+DIM+M+SG
quiabeirozinhos	quiabeiro+N+DIM+M+PL
quiabinho	quiabo+N+DIM+M+SG
quiabinhos	quiabo+N+DIM+M+PL
quiabo	quiabo+N+M+SG
quiabos	quiabo+N+M+PL
quiabozinho	quiabo+N+DIM+M+SG
quiabozinhos	quiabo+N+DIM+M+PL
quiasma	quiasma+N+M+SG
quiasmas	quiasma+N+M+PL
quiasmazinho	quiasma+N+DIM+M+SG
quiasmazinhos	quiasma+N+DIM+M+PL
quiasminha	quiasma+N+DIM+M+SG
quiasminhas	quiasma+N+DIM+M+PL
quiasminho	quiasmo+N+DIM+M+SG
quiasminhos	quiasmo+N+DIM+M+PL
quiasmo	quiasmo+N+M+SG
quiasmos	quiasmo+N+M+PL
quiasmozinho	quiasmo+N+DIM+M+SG
quiasmozinhos	quiasmo+N+DIM+M+PL
quiastrinho	quiastro+N+DIM+M+SG
quiastrinhos	quiastro+N+DIM+M+PL
quiastro	quiastro+N+M+SG
quiastros	quiastro+N+M+PL
quiastrozinho	quiastro+N+DIM+M+SG
quiastrozinhos	quiastro+N+DIM+M+PL
quiastolitinho	quiastólito+N+DIM+M+SG
quiastolitinhos	quiastólito+N+DIM+M+PL
quiastolitozinho	quiastólito+N+DIM+M+SG
quiastolitozinhos	quiastólito+N+DIM+M+PL
quiastólito	quiastólito+N+M+SG
quiastólitos	quiastólito+N+M+PL
quiatolite	quiatolite+N+F+SG
quiatolites	quiatolite+N+F+PL
quiatolitezinha	quiatolite+N+DIM+F+SG
quiatolitezinhas	quiatolite+N+DIM+F+PL
quiatolitinha	quiatolite+N+DIM+F+SG
quiatolitinhas	quiatolite+N+DIM+F+PL
quibanda	quibanda+N+F+SG
quibandas	quibanda+N+F+PL
quibandazinha	quibanda+N+DIM+F+SG
quibandazinhas	quibanda+N+DIM+F+PL
quibandinha	quibanda+N+DIM+F+SG
quibandinhas	quibanda+N+DIM+F+PL
quibandinho	quibando+N+DIM+M+SG
quibandinhos	quibando+N+DIM+M+PL
quibando	quibando+N+M+SG
quibandos	quibando+N+M+PL
quibandozinho	quibando+N+DIM+M+SG
quibandozinhos	quibando+N+DIM+M+PL
quibe	quibe+N+M+SG
quibes	quibe+N+M+PL
quibezinho	quibe+N+DIM+M+SG
quibezinhos	quibe+N+DIM+M+PL
quibinho	quibe+N+DIM+M+SG
quibinhos	quibe+N+DIM+M+PL
quibebe	quibebe+N+SG
quibebes	quibebe+N+PL
quibebezinha	quibebe+N+DIM+F+SG
quibebezinhas	quibebe+N+DIM+F+PL
quibebezinho	quibebe+N+DIM+M+SG
quibebezinhos	quibebe+N+DIM+M+PL
quibebinha	quibebe+N+DIM+F+SG
quibebinhas	quibebe+N+DIM+F+PL
quibebinho	quibebe+N+DIM+M+SG
quibebinhos	quibebe+N+DIM+M+PL
quibuca	quibuca+N+F+SG
quibucas	quibuca+N+F+PL
quibucazinha	quibuca+N+DIM+F+SG
quibucazinhas	quibuca+N+DIM+F+PL
quibuquinha	quibuca+N+DIM+F+SG
quibuquinhas	quibuca+N+DIM+F+PL
quibumbinho	quibumbo+N+DIM+M+SG
quibumbinhos	quibumbo+N+DIM+M+PL
quibumbo	quibumbo+N+M+SG
quibumbos	quibumbo+N+M+PL
quibumbozinho	quibumbo+N+DIM+M+SG
quibumbozinhos	quibumbo+N+DIM+M+PL
quicamba	quicamba+N+F+SG
quicambas	quicamba+N+F+PL
quicambazinha	quicamba+N+DIM+F+SG
quicambazinhas	quicamba+N+DIM+F+PL
quicambinha	quicamba+N+DIM+F+SG
quicambinhas	quicamba+N+DIM+F+PL
quiche	quiche+N+SG
quiches	quiche+N+PL
quichezinha	quiche+N+DIM+F+SG
quichezinhas	quiche+N+DIM+F+PL
quichezinho	quiche+N+DIM+M+SG
quichezinhos	quiche+N+DIM+M+PL
quichinha	quiche+N+DIM+F+SG
quichinhas	quiche+N+DIM+F+PL
quichinho	quiche+N+DIM+M+SG
quichinhos	quiche+N+DIM+M+PL
quico	quico+N+M+SG
quicos	quico+N+M+PL
quicozinho	quico+N+DIM+M+SG
quicozinhos	quico+N+DIM+M+PL
quiquinho	quico+N+DIM+M+SG
quiquinhos	quico+N+DIM+M+PL
quicezinha	quicé+N+DIM+F+SG
quicezinhas	quicé+N+DIM+F+PL
quicé	quicé+N+F+SG
quicés	quicé+N+F+PL
quididade	quididade+N+F+SG
quididades	quididade+N+F+PL
quididadezinha	quididade+N+DIM+F+SG
quididadezinhas	quididade+N+DIM+F+PL
quididadinha	quididade+N+DIM+F+SG
quididadinhas	quididade+N+DIM+F+PL
quididatividade	quididatividade+N+F+SG
quididatividades	quididatividade+N+F+PL
quididatividadezinha	quididatividade+N+DIM+F+SG
quididatividadezinhas	quididatividade+N+DIM+F+PL
quididatividadinha	quididatividade+N+DIM+F+SG
quididatividadinhas	quididatividade+N+DIM+F+PL
quietação	quietação+N+F+SG
quietaçãozinha	quietação+N+DIM+F+SG
quietações	quietação+N+F+PL
quietaçõezinhas	quietação+N+DIM+F+PL
quiete	quiete+N+M+SG
quietes	quiete+N+M+PL
quietezinho	quiete+N+DIM+M+SG
quietezinhos	quiete+N+DIM+M+PL
quietinho	quiete+N+DIM+M+SG
quietinhos	quiete+N+DIM+M+PL
quietisminho	quietismo+N+DIM+M+SG
quietisminhos	quietismo+N+DIM+M+PL
quietismo	quietismo+N+M+SG
quietismos	quietismo+N+M+PL
quietismozinho	quietismo+N+DIM+M+SG
quietismozinhos	quietismo+N+DIM+M+PL
quietista	quietista+N+SG
quietistas	quietista+N+PL
quietistazinha	quietista+N+DIM+F+SG
quietistazinhas	quietista+N+DIM+F+PL
quietistazinho	quietista+N+DIM+M+SG
quietistazinhos	quietista+N+DIM+M+PL
quietistinha	quietista+N+DIM+SG
quietistinhas	quietista+N+DIM+PL
quietude	quietude+N+F+SG
quietudes	quietude+N+F+PL
quietudezinha	quietude+N+DIM+F+SG
quietudezinhas	quietude+N+DIM+F+PL
quietudinha	quietude+N+DIM+F+SG
quietudinhas	quietude+N+DIM+F+PL
quigombozinho	quigombó+N+DIM+M+SG
quigombozinhos	quigombó+N+DIM+M+PL
quigombó	quigombó+N+M+SG
quigombós	quigombó+N+M+PL
quilatador	quilatador+N+M+SG
quilatadora	quilatador+N+F+SG
quilatadoras	quilatador+N+F+PL
quilatadorazinha	quilatador+N+DIM+F+SG
quilatadorazinhas	quilatador+N+DIM+F+PL
quilatadores	quilatador+N+M+PL
quilatadorezinhos	quilatador+N+DIM+M+PL
quilatadorinha	quilatador+N+DIM+F+SG
quilatadorinhas	quilatador+N+DIM+F+PL
quilatadorzinho	quilatador+N+DIM+M+SG
quilatadorzinhos	quilatador+N+DIM+M+PL
quilatação	quilatação+N+F+SG
quilataçãozinha	quilatação+N+DIM+F+SG
quilatações	quilatação+N+F+PL
quilataçõezinhas	quilatação+N+DIM+F+PL
quilate	quilate+N+M+SG
quilates	quilate+N+M+PL
quilatezinho	quilate+N+DIM+M+SG
quilatezinhos	quilate+N+DIM+M+PL
quilatinho	quilate+N+DIM+M+SG
quilatinhos	quilate+N+DIM+M+PL
quilateira	quilateira+N+F+SG
quilateiras	quilateira+N+F+PL
quilateirazinha	quilateira+N+DIM+F+SG
quilateirazinhas	quilateira+N+DIM+F+PL
quilateirinha	quilateira+N+DIM+F+SG
quilateirinhas	quilateira+N+DIM+F+PL
quilha	quilha+N+F+SG
quilhas	quilha+N+F+PL
quilhazinha	quilha+N+DIM+F+SG
quilhazinhas	quilha+N+DIM+F+PL
quilhinha	quilha+N+DIM+F+SG
quilhinhas	quilha+N+DIM+F+PL
quilha-bulbinho	quilha-bulbo+N+DIM+F+SG
quilha-bulbinhos	quilha-bulbo+N+DIM+F+PL
quilha-bulbo	quilha-bulbo+N+F+SG
quilha-bulbozinha	quilha-bulbo+N+DIM+F+SG
quilhas-bulbo	quilha-bulbo+N+F+PL
quilhas-bulbozinhas	quilha-bulbo+N+DIM+F+PL
quiliare	quiliare+N+M+SG
quiliares	quiliare+N+M+PL
quiliarezinho	quiliare+N+DIM+M+SG
quiliarezinhos	quiliare+N+DIM+M+PL
quiliarinho	quiliare+N+DIM+M+SG
quiliarinhos	quiliare+N+DIM+M+PL
quiliarzinhos	quiliare+N+DIM+M+PL
quiliarquia	quiliarquia+N+F+SG
quiliarquias	quiliarquia+N+F+PL
quiliarquiazinha	quiliarquia+N+DIM+F+SG
quiliarquiazinhas	quiliarquia+N+DIM+F+PL
quiliarquinha	quiliarquia+N+DIM+F+SG
quiliarquinhas	quiliarquia+N+DIM+F+PL
quilificatividade	quilificatividade+N+F+SG
quilificatividades	quilificatividade+N+F+PL
quilificatividadezinha	quilificatividade+N+DIM+F+SG
quilificatividadezinhas	quilificatividade+N+DIM+F+PL
quilificatividadinha	quilificatividade+N+DIM+F+SG
quilificatividadinhas	quilificatividade+N+DIM+F+PL
quilificação	quilificação+N+F+SG
quilificaçãozinha	quilificação+N+DIM+F+SG
quilificações	quilificação+N+F+PL
quilificaçõezinhas	quilificação+N+DIM+F+PL
quilite	quilite+N+F+SG
quilites	quilite+N+F+PL
quilitezinha	quilite+N+DIM+F+SG
quilitezinhas	quilite+N+DIM+F+PL
quilitinha	quilite+N+DIM+F+SG
quilitinhas	quilite+N+DIM+F+PL
quilinho	quilo+N+DIM+M+SG
quilinhos	quilo+N+DIM+M+PL
quilito	quilo+N+DIM+M+SG
quilitos	quilo+N+DIM+M+PL
quilo	quilo+N+M+SG
quilos	quilo+N+M+PL
quilozinho	quilo+N+DIM+M+SG
quilozinhos	quilo+N+DIM+M+PL
quilozito	quilo+N+DIM+M+SG
quilozitos	quilo+N+DIM+M+PL
quilocaloria	quilocaloria+N+F+SG
quilocalorias	quilocaloria+N+F+PL
quilocaloriazinha	quilocaloria+N+DIM+F+SG
quilocaloriazinhas	quilocaloria+N+DIM+F+PL
quilocalorinha	quilocaloria+N+DIM+F+SG
quilocalorinhas	quilocaloria+N+DIM+F+PL
quilociclinho	quilociclo+N+DIM+M+SG
quilociclinhos	quilociclo+N+DIM+M+PL
quilociclo	quilociclo+N+M+SG
quilociclos	quilociclo+N+M+PL
quilociclozinho	quilociclo+N+DIM+M+SG
quilociclozinhos	quilociclo+N+DIM+M+PL
quilodieresia	quilodieresia+N+F+SG
quilodieresias	quilodieresia+N+F+PL
quilodieresiazinha	quilodieresia+N+DIM+F+SG
quilodieresiazinhas	quilodieresia+N+DIM+F+PL
quilodieresinha	quilodieresia+N+DIM+F+SG
quilodieresinhas	quilodieresia+N+DIM+F+PL
quilofagia	quilofagia+N+F+SG
quilofagias	quilofagia+N+F+PL
quilofagiazinha	quilofagia+N+DIM+F+SG
quilofagiazinhas	quilofagia+N+DIM+F+PL
quilofaginha	quilofagia+N+DIM+F+SG
quilofaginhas	quilofagia+N+DIM+F+PL
quilograma	quilograma+N+SG
quilogramas	quilograma+N+PL
quilogramazinha	quilograma+N+DIM+F+SG
quilogramazinhas	quilograma+N+DIM+F+PL
quilogramazinho	quilograma+N+DIM+M+SG
quilogramazinhos	quilograma+N+DIM+M+PL
quilograminha	quilograma+N+DIM+SG
quilograminhas	quilograma+N+DIM+PL
quilogrametrinho	quilogrâmetro+N+DIM+M+SG
quilogrametrinhos	quilogrâmetro+N+DIM+M+PL
quilogrametrozinho	quilogrâmetro+N+DIM+M+SG
quilogrametrozinhos	quilogrâmetro+N+DIM+M+PL
quilogrâmetro	quilogrâmetro+N+M+SG
quilogrâmetros	quilogrâmetro+N+M+PL
quilohertz	quilohertz+N+M
quilohertzes	quilohertz+N+M+PL
quilohertzezinhos	quilohertz+N+DIM+M+PL
quilohertzinho	quilohertz+N+DIM+M+SG
quilohertzinhos	quilohertz+N+DIM+M+PL
quilojoule	quilojoule+N+M+SG
quilojoules	quilojoule+N+M+PL
quilojoulezinho	quilojoule+N+DIM+M+SG
quilojoulezinhos	quilojoule+N+DIM+M+PL
quilojoulinho	quilojoule+N+DIM+M+SG
quilojoulinhos	quilojoule+N+DIM+M+PL
quilolitrinho	quilolitro+N+DIM+M+SG
quilolitrinhos	quilolitro+N+DIM+M+PL
quilolitro	quilolitro+N+M+SG
quilolitros	quilolitro+N+M+PL
quilolitrozinho	quilolitro+N+DIM+M+SG
quilolitrozinhos	quilolitro+N+DIM+M+PL
quilombinho	quilombo+N+DIM+M+SG
quilombinhos	quilombo+N+DIM+M+PL
quilombo	quilombo+N+M+SG
quilombos	quilombo+N+M+PL
quilombozinho	quilombo+N+DIM+M+SG
quilombozinhos	quilombo+N+DIM+M+PL
quilombola	quilombola+N+M+SG
quilombolas	quilombola+N+M+PL
quilombolazinho	quilombola+N+DIM+M+SG
quilombolazinhos	quilombola+N+DIM+M+PL
quilombolinha	quilombola+N+DIM+M+SG
quilombolinhas	quilombola+N+DIM+M+PL
quilometrabilidade	quilometrabilidade+N+F+SG
quilometrabilidades	quilometrabilidade+N+F+PL
quilometrabilidadezinha	quilometrabilidade+N+DIM+F+SG
quilometrabilidadezinhas	quilometrabilidade+N+DIM+F+PL
quilometrabilidadinha	quilometrabilidade+N+DIM+F+SG
quilometrabilidadinhas	quilometrabilidade+N+DIM+F+PL
quilometragem	quilometragem+N+F+SG
quilometragens	quilometragem+N+F+PL
quilometragenzinha	quilometragem+N+DIM+F+SG
quilometragenzinhas	quilometragem+N+DIM+F+PL
quilometricidade	quilometricidade+N+F+SG
quilometricidades	quilometricidade+N+F+PL
quilometricidadezinha	quilometricidade+N+DIM+F+SG
quilometricidadezinhas	quilometricidade+N+DIM+F+PL
quilometricidadinha	quilometricidade+N+DIM+F+SG
quilometricidadinhas	quilometricidade+N+DIM+F+PL
quilomoizinhos	quilomol+N+DIM+M+PL
quilomol	quilomol+N+M+SG
quilomolzinho	quilomol+N+DIM+M+SG
quilomóis	quilomol+N+M+PL
quiloplastia	quiloplastia+N+F+SG
quiloplastias	quiloplastia+N+F+PL
quiloplastiazinha	quiloplastia+N+DIM+F+SG
quiloplastiazinhas	quiloplastia+N+DIM+F+PL
quiloplastinha	quiloplastia+N+DIM+F+SG
quiloplastinhas	quiloplastia+N+DIM+F+PL
quiloplasticidade	quiloplasticidade+N+F+SG
quiloplasticidades	quiloplasticidade+N+F+PL
quiloplasticidadezinha	quiloplasticidade+N+DIM+F+SG
quiloplasticidadezinhas	quiloplasticidade+N+DIM+F+PL
quiloplasticidadinha	quiloplasticidade+N+DIM+F+SG
quiloplasticidadinhas	quiloplasticidade+N+DIM+F+PL
quilose	quilose+N+F+SG
quiloses	quilose+N+F+PL
quilosezinha	quilose+N+DIM+F+SG
quilosezinhas	quilose+N+DIM+F+PL
quilosinha	quilose+N+DIM+F+SG
quilosinhas	quilose+N+DIM+F+PL
quilotonelada	quilotonelada+N+F+SG
quilotoneladas	quilotonelada+N+F+PL
quilotoneladazinha	quilotonelada+N+DIM+F+SG
quilotoneladazinhas	quilotonelada+N+DIM+F+PL
quilotoneladinha	quilotonelada+N+DIM+F+SG
quilotoneladinhas	quilotonelada+N+DIM+F+PL
quilovolt	quilovolt+N+M+SG
quilovoltes	quilovolt+N+M+PL
quilovoltezinhos	quilovolt+N+DIM+M+PL
quilovoltzinho	quilovolt+N+DIM+M+SG
quilovatinho	quilovátio+N+DIM+M+SG
quilovatinhos	quilovátio+N+DIM+M+PL
quilovatiozinho	quilovátio+N+DIM+M+SG
quilovatiozinhos	quilovátio+N+DIM+M+PL
quilovátio	quilovátio+N+M+SG
quilovátios	quilovátio+N+M+PL
quilowatt	quilowatt+N+M+SG
quilowatts	quilowatt+N+M+PL
quilowattzinho	quilowatt+N+DIM+M+SG
quilowattzinhos	quilowatt+N+DIM+M+PL
quilowatt-hora	quilowatt-hora+N+M+SG
quilowatt-horazinho	quilowatt-hora+N+DIM+M+SG
quilowatt-horinha	quilowatt-hora+N+DIM+M+SG
quilowatt-horinhas	quilowatt-hora+N+DIM+M+PL
quiluanza	quiluanza+N+F+SG
quiluanzas	quiluanza+N+F+PL
quiluanzazinha	quiluanza+N+DIM+F+SG
quiluanzazinhas	quiluanza+N+DIM+F+PL
quiluanzinha	quiluanza+N+DIM+F+SG
quiluanzinhas	quiluanza+N+DIM+F+PL
quiliadazinha	quilíada+N+DIM+F+SG
quiliadazinhas	quilíada+N+DIM+F+PL
quiliadinha	quilíada+N+DIM+F+SG
quiliadinhas	quilíada+N+DIM+F+PL
quilíada	quilíada+N+F+SG
quilíadas	quilíada+N+F+PL
quiliadezinha	quilíade+N+DIM+F+SG
quiliadezinhas	quilíade+N+DIM+F+PL
quiliadinha	quilíade+N+DIM+F+SG
quiliadinhas	quilíade+N+DIM+F+PL
quilíade	quilíade+N+F+SG
quilíades	quilíade+N+F+PL
quilognatinho	quilógnato+N+DIM+M+SG
quilognatinhos	quilógnato+N+DIM+M+PL
quilognatozinho	quilógnato+N+DIM+M+SG
quilognatozinhos	quilógnato+N+DIM+M+PL
quilógnato	quilógnato+N+M+SG
quilógnatos	quilógnato+N+M+PL
quilometrinho	quilómetro+N+DIM+M+SG
quilometrinhos	quilómetro+N+DIM+M+PL
quilometrozinho	quilómetro+N+DIM+M+SG
quilometrozinhos	quilómetro+N+DIM+M+PL
quilómetro	quilómetro+N+M+SG
quilómetros	quilómetro+N+M+PL
quilopodezinha	quilópode+N+DIM+F+SG
quilopodezinho	quilópode+N+DIM+M+SG
quilopodezinhos	quilópode+N+DIM+M+PL
quilopodinha	quilópode+N+DIM+F+SG
quilopodinhas	quilópode+N+DIM+F+PL
quilopodinho	quilópode+N+DIM+M+SG
quilopodinhos	quilópode+N+DIM+M+PL
quilópode	quilópode+N+SG
quilópodes	quilópode+N+M+PL
quilometrinho	quilômetro+N+DIM+M+SG
quilometrinhos	quilômetro+N+DIM+M+PL
quilometrozinho	quilômetro+N+DIM+M+SG
quilometrozinhos	quilômetro+N+DIM+M+PL
quilômetro	quilômetro+N+M+SG
quilômetros	quilômetro+N+M+PL
quilubinho	quilúbio+N+DIM+M+SG
quilubinhos	quilúbio+N+DIM+M+PL
quilubiozinho	quilúbio+N+DIM+M+SG
quilubiozinhos	quilúbio+N+DIM+M+PL
quilúbio	quilúbio+N+M+SG
quilúbios	quilúbio+N+M+PL
quiluriazinha	quilúria+N+DIM+F+SG
quiluriazinhas	quilúria+N+DIM+F+PL
quilurinha	quilúria+N+DIM+F+SG
quilurinhas	quilúria+N+DIM+F+PL
quilúria	quilúria+N+F+SG
quilúrias	quilúria+N+F+PL
quimalanca	quimalanca+N+F+SG
quimalancas	quimalanca+N+F+PL
quimalancazinha	quimalanca+N+DIM+F+SG
quimalancazinhas	quimalanca+N+DIM+F+PL
quimalanquinha	quimalanca+N+DIM+F+SG
quimalanquinhas	quimalanca+N+DIM+F+PL
quimana	quimana+N+F+SG
quimanas	quimana+N+F+PL
quimanazinha	quimana+N+DIM+F+SG
quimanazinhas	quimana+N+DIM+F+PL
quimaninha	quimana+N+DIM+F+SG
quimaninhas	quimana+N+DIM+F+PL
quimanga	quimanga+N+F+SG
quimangas	quimanga+N+F+PL
quimangazinha	quimanga+N+DIM+F+SG
quimangazinhas	quimanga+N+DIM+F+PL
quimanguinha	quimanga+N+DIM+F+SG
quimanguinhas	quimanga+N+DIM+F+PL
quimangata	quimangata+N+F+SG
quimangatas	quimangata+N+F+PL
quimangatazinha	quimangata+N+DIM+F+SG
quimangatazinhas	quimangata+N+DIM+F+PL
quimangatinha	quimangata+N+DIM+F+SG
quimangatinhas	quimangata+N+DIM+F+PL
quimaninho	quimano+N+DIM+M+SG
quimaninhos	quimano+N+DIM+M+PL
quimano	quimano+N+M+SG
quimanos	quimano+N+M+PL
quimanozinho	quimano+N+DIM+M+SG
quimanozinhos	quimano+N+DIM+M+PL
quimanticidade	quimanticidade+N+F+SG
quimanticidades	quimanticidade+N+F+PL
quimanticidadezinha	quimanticidade+N+DIM+F+SG
quimanticidadezinhas	quimanticidade+N+DIM+F+PL
quimanticidadinha	quimanticidade+N+DIM+F+SG
quimanticidadinhas	quimanticidade+N+DIM+F+PL
quimbanda	quimbanda+N+SG
quimbandas	quimbanda+N+M+PL
quimbandazinha	quimbanda+N+DIM+F+SG
quimbandazinho	quimbanda+N+DIM+M+SG
quimbandazinhos	quimbanda+N+DIM+M+PL
quimbandinha	quimbanda+N+DIM+SG
quimbandinhas	quimbanda+N+DIM+PL
quimbembe	quimbembe+N+M+SG
quimbembes	quimbembe+N+M+PL
quimbembezinho	quimbembe+N+DIM+M+SG
quimbembezinhos	quimbembe+N+DIM+M+PL
quimbembinho	quimbembe+N+DIM+M+SG
quimbembinhos	quimbembe+N+DIM+M+PL
quimbembeque	quimbembeque+N+M+SG
quimbembeques	quimbembeque+N+M+PL
quimbembequezinho	quimbembeque+N+DIM+M+SG
quimbembequezinhos	quimbembeque+N+DIM+M+PL
quimbembequinho	quimbembeque+N+DIM+M+SG
quimbembequinhos	quimbembeque+N+DIM+M+PL
quimbembezinho	quimbembé+N+DIM+M+SG
quimbembezinhos	quimbembé+N+DIM+M+PL
quimbembé	quimbembé+N+M+SG
quimbembés	quimbembé+N+M+PL
quimbete	quimbete+N+SG
quimbetes	quimbete+N+PL
quimbetezinha	quimbete+N+DIM+F+SG
quimbetezinhas	quimbete+N+DIM+F+PL
quimbetezinho	quimbete+N+DIM+M+SG
quimbetezinhos	quimbete+N+DIM+M+PL
quimbetinha	quimbete+N+DIM+F+SG
quimbetinhas	quimbete+N+DIM+F+PL
quimbetinho	quimbete+N+DIM+M+SG
quimbetinhos	quimbete+N+DIM+M+PL
quimbimbe	quimbimbe+N+M+SG
quimbimbes	quimbimbe+N+M+PL
quimbimbezinho	quimbimbe+N+DIM+M+SG
quimbimbezinhos	quimbimbe+N+DIM+M+PL
quimbimbinho	quimbimbe+N+DIM+M+SG
quimbimbinhos	quimbimbe+N+DIM+M+PL
quimbombinho	quimbombo+N+DIM+M+SG
quimbombinhos	quimbombo+N+DIM+M+PL
quimbombo	quimbombo+N+M+SG
quimbombos	quimbombo+N+M+PL
quimbombozinho	quimbombo+N+DIM+M+SG
quimbombozinhos	quimbombo+N+DIM+M+PL
quimbundinho	quimbundo+N+DIM+M+SG
quimbundinhos	quimbundo+N+DIM+M+PL
quimbundo	quimbundo+N+M+SG
quimbundos	quimbundo+N+M+PL
quimbundozinho	quimbundo+N+DIM+M+SG
quimbundozinhos	quimbundo+N+DIM+M+PL
quimera	quimera+N+F+SG
quimeras	quimera+N+F+PL
quimerazinha	quimera+N+DIM+F+SG
quimerazinhas	quimera+N+DIM+F+PL
quimerinha	quimera+N+DIM+F+SG
quimerinhas	quimera+N+DIM+F+PL
quimericidade	quimericidade+N+F+SG
quimericidades	quimericidade+N+F+PL
quimericidadezinha	quimericidade+N+DIM+F+SG
quimericidadezinhas	quimericidade+N+DIM+F+PL
quimericidadinha	quimericidade+N+DIM+F+SG
quimericidadinhas	quimericidade+N+DIM+F+PL
quimerista	quimerista+N+SG
quimeristas	quimerista+N+PL
quimeristazinha	quimerista+N+DIM+F+SG
quimeristazinhas	quimerista+N+DIM+F+PL
quimeristazinho	quimerista+N+DIM+M+SG
quimeristazinhos	quimerista+N+DIM+M+PL
quimeristinha	quimerista+N+DIM+SG
quimeristinhas	quimerista+N+DIM+PL
quimerideinho	quimerídeo+N+DIM+M+SG
quimerideinhos	quimerídeo+N+DIM+M+PL
quimerideozinho	quimerídeo+N+DIM+M+SG
quimerideozinhos	quimerídeo+N+DIM+M+PL
quimerídeo	quimerídeo+N+M+SG
quimerídeos	quimerídeo+N+M+PL
quimiatria	quimiatria+N+F+SG
quimiatrias	quimiatria+N+F+PL
quimiatriazinha	quimiatria+N+DIM+F+SG
quimiatriazinhas	quimiatria+N+DIM+F+PL
quimiatrinha	quimiatria+N+DIM+F+SG
quimiatrinhas	quimiatria+N+DIM+F+PL
quimicidade	quimicidade+N+F+SG
quimicidades	quimicidade+N+F+PL
quimicidadezinha	quimicidade+N+DIM+F+SG
quimicidadezinhas	quimicidade+N+DIM+F+PL
quimicidadinha	quimicidade+N+DIM+F+SG
quimicidadinhas	quimicidade+N+DIM+F+PL
quimificação	quimificação+N+F+SG
quimificaçãozinha	quimificação+N+DIM+F+SG
quimificações	quimificação+N+F+PL
quimificaçõezinhas	quimificação+N+DIM+F+PL
quimiluminescenciazinha	quimiluminescência+N+DIM+F+SG
quimiluminescenciazinhas	quimiluminescência+N+DIM+F+PL
quimiluminescencinha	quimiluminescência+N+DIM+F+SG
quimiluminescencinhas	quimiluminescência+N+DIM+F+PL
quimiluminescência	quimiluminescência+N+F+SG
quimiluminescências	quimiluminescência+N+F+PL
quimiorreceptividade	quimiorreceptividade+N+F+SG
quimiorreceptividades	quimiorreceptividade+N+F+PL
quimiorreceptividadezinha	quimiorreceptividade+N+DIM+F+SG
quimiorreceptividadezinhas	quimiorreceptividade+N+DIM+F+PL
quimiorreceptividadinha	quimiorreceptividade+N+DIM+F+SG
quimiorreceptividadinhas	quimiorreceptividade+N+DIM+F+PL
quimiorreceptor	quimiorreceptor+N+M+SG
quimiorreceptores	quimiorreceptor+N+M+PL
quimiorreceptorezinhos	quimiorreceptor+N+DIM+M+PL
quimiorreceptorzinho	quimiorreceptor+N+DIM+M+SG
quimiorreceptorzinhos	quimiorreceptor+N+DIM+M+PL
quimiorrecepção	quimiorrecepção+N+F+SG
quimiorrecepçãozinha	quimiorrecepção+N+DIM+F+SG
quimiorrecepções	quimiorrecepção+N+F+PL
quimiorrecepçõezinhas	quimiorrecepção+N+DIM+F+PL
quimiorrecetividade	quimiorrecetividade+N+F+SG
quimiorrecetividades	quimiorrecetividade+N+F+PL
quimiorrecetividadezinha	quimiorrecetividade+N+DIM+F+SG
quimiorrecetividadezinhas	quimiorrecetividade+N+DIM+F+PL
quimiorrecetividadinha	quimiorrecetividade+N+DIM+F+SG
quimiorrecetividadinhas	quimiorrecetividade+N+DIM+F+PL
quimiorrecetor	quimiorrecetor+N+M+SG
quimiorrecetores	quimiorrecetor+N+M+PL
quimiorrecetorezinhos	quimiorrecetor+N+DIM+M+PL
quimiorrecetorzinho	quimiorrecetor+N+DIM+M+SG
quimiorrecetorzinhos	quimiorrecetor+N+DIM+M+PL
quimiorreceção	quimiorreceção+N+F+SG
quimiorreceçãozinha	quimiorreceção+N+DIM+F+SG
quimiorreceções	quimiorreceção+N+F+PL
quimiorreceçõezinhas	quimiorreceção+N+DIM+F+PL
quimiossintesezinha	quimiossíntese+N+DIM+F+SG
quimiossintesezinhas	quimiossíntese+N+DIM+F+PL
quimiossintesinha	quimiossíntese+N+DIM+F+SG
quimiossintesinhas	quimiossíntese+N+DIM+F+PL
quimiossíntese	quimiossíntese+N+F+SG
quimiossínteses	quimiossíntese+N+F+PL
quimiotacticidade	quimiotacticidade+N+F+SG
quimiotacticidades	quimiotacticidade+N+F+PL
quimiotacticidadezinha	quimiotacticidade+N+DIM+F+SG
quimiotacticidadezinhas	quimiotacticidade+N+DIM+F+PL
quimiotacticidadinha	quimiotacticidade+N+DIM+F+SG
quimiotacticidadinhas	quimiotacticidade+N+DIM+F+PL
quimiotactisminho	quimiotactismo+N+DIM+M+SG
quimiotactisminhos	quimiotactismo+N+DIM+M+PL
quimiotactismo	quimiotactismo+N+M+SG
quimiotactismos	quimiotactismo+N+M+PL
quimiotactismozinho	quimiotactismo+N+DIM+M+SG
quimiotactismozinhos	quimiotactismo+N+DIM+M+PL
quimiotaticidade	quimiotaticidade+N+F+SG
quimiotaticidades	quimiotaticidade+N+F+PL
quimiotaticidadezinha	quimiotaticidade+N+DIM+F+SG
quimiotaticidadezinhas	quimiotaticidade+N+DIM+F+PL
quimiotaticidadinha	quimiotaticidade+N+DIM+F+SG
quimiotaticidadinhas	quimiotaticidade+N+DIM+F+PL
quimiotatisminho	quimiotatismo+N+DIM+M+SG
quimiotatisminhos	quimiotatismo+N+DIM+M+PL
quimiotatismo	quimiotatismo+N+M+SG
quimiotatismos	quimiotatismo+N+M+PL
quimiotatismozinho	quimiotatismo+N+DIM+M+SG
quimiotatismozinhos	quimiotatismo+N+DIM+M+PL
quimiotaxia	quimiotaxia+N+F+SG
quimiotaxias	quimiotaxia+N+F+PL
quimiotaxiazinha	quimiotaxia+N+DIM+F+SG
quimiotaxiazinhas	quimiotaxia+N+DIM+F+PL
quimiotaxinha	quimiotaxia+N+DIM+F+SG
quimiotaxinhas	quimiotaxia+N+DIM+F+PL
quimiotaxicidade	quimiotaxicidade+N+F+SG
quimiotaxicidades	quimiotaxicidade+N+F+PL
quimiotaxicidadezinha	quimiotaxicidade+N+DIM+F+SG
quimiotaxicidadezinhas	quimiotaxicidade+N+DIM+F+PL
quimiotaxicidadinha	quimiotaxicidade+N+DIM+F+SG
quimiotaxicidadinhas	quimiotaxicidade+N+DIM+F+PL
quimioterapia	quimioterapia+N+F+SG
quimioterapias	quimioterapia+N+F+PL
quimioterapiazinha	quimioterapia+N+DIM+F+SG
quimioterapiazinhas	quimioterapia+N+DIM+F+PL
quimioterapinha	quimioterapia+N+DIM+F+SG
quimioterapinhas	quimioterapia+N+DIM+F+PL
quimioterapicidade	quimioterapicidade+N+F+SG
quimioterapicidades	quimioterapicidade+N+F+PL
quimioterapicidadezinha	quimioterapicidade+N+DIM+F+SG
quimioterapicidadezinhas	quimioterapicidade+N+DIM+F+PL
quimioterapicidadinha	quimioterapicidade+N+DIM+F+SG
quimioterapicidadinhas	quimioterapicidade+N+DIM+F+PL
quimiotropisminho	quimiotropismo+N+DIM+M+SG
quimiotropisminhos	quimiotropismo+N+DIM+M+PL
quimiotropismo	quimiotropismo+N+M+SG
quimiotropismos	quimiotropismo+N+M+PL
quimiotropismozinho	quimiotropismo+N+DIM+M+SG
quimiotropismozinhos	quimiotropismo+N+DIM+M+PL
quimisminho	quimismo+N+DIM+M+SG
quimisminhos	quimismo+N+DIM+M+PL
quimismo	quimismo+N+M+SG
quimismos	quimismo+N+M+PL
quimismozinho	quimismo+N+DIM+M+SG
quimismozinhos	quimismo+N+DIM+M+PL
quimitipia	quimitipia+N+F+SG
quimitipias	quimitipia+N+F+PL
quimitipiazinha	quimitipia+N+DIM+F+SG
quimitipiazinhas	quimitipia+N+DIM+F+PL
quimitipinha	quimitipia+N+DIM+F+SG
quimitipinhas	quimitipia+N+DIM+F+PL
quiminho	quimo+N+DIM+M+SG
quiminhos	quimo+N+DIM+M+PL
quimo	quimo+N+M+SG
quimos	quimo+N+M+PL
quimozinho	quimo+N+DIM+M+SG
quimozinhos	quimo+N+DIM+M+PL
quimoninho	quimono+N+DIM+M+SG
quimoninhos	quimono+N+DIM+M+PL
quimono	quimono+N+M+SG
quimonos	quimono+N+M+PL
quimonozinho	quimono+N+DIM+M+SG
quimonozinhos	quimono+N+DIM+M+PL
quimosina	quimosina+N+F+SG
quimosinas	quimosina+N+F+PL
quimosinazinha	quimosina+N+DIM+F+SG
quimosinazinhas	quimosina+N+DIM+F+PL
quimosininha	quimosina+N+DIM+F+SG
quimosininhas	quimosina+N+DIM+F+PL
quimão	quimão+N+M+SG
quimãozinho	quimão+N+DIM+M+SG
quimões	quimão+N+M+PL
quimõezinhos	quimão+N+DIM+M+PL
quimezinho	quimé+N+DIM+M+SG
quimezinhos	quimé+N+DIM+M+PL
quimé	quimé+N+M+SG
quimés	quimé+N+M+PL
quimeridazinho	quimérida+N+DIM+M+SG
quimeridazinhos	quimérida+N+DIM+M+PL
quimeridinha	quimérida+N+DIM+M+SG
quimeridinhas	quimérida+N+DIM+M+PL
quimérida	quimérida+N+M+SG
quiméridas	quimérida+N+M+PL
quina	quina+N+F+SG
quinas	quina+N+F+PL
quinazinha	quina+N+DIM+F+SG
quinazinhas	quina+N+DIM+F+PL
quininha	quina+N+DIM+F+SG
quininhas	quina+N+DIM+F+PL
quinada	quinado+N+F+SG
quinadas	quinado+N+F+PL
quinadazinha	quinado+N+DIM+F+SG
quinadazinhas	quinado+N+DIM+F+PL
quinadinha	quinado+N+DIM+F+SG
quinadinhas	quinado+N+DIM+F+PL
quinadinho	quinado+N+DIM+M+SG
quinadinhos	quinado+N+DIM+M+PL
quinado	quinado+N+M+SG
quinados	quinado+N+M+PL
quinadozinho	quinado+N+DIM+M+SG
quinadozinhos	quinado+N+DIM+M+PL
quinaquina	quinaquina+N+F+SG
quinaquinas	quinaquina+N+F+PL
quinaquinazinha	quinaquina+N+DIM+F+SG
quinaquinazinhas	quinaquina+N+DIM+F+PL
quinaquininha	quinaquina+N+DIM+F+SG
quinaquininhas	quinaquina+N+DIM+F+PL
quinau	quinau+N+M+SG
quinaus	quinau+N+M+PL
quinauzinho	quinau+N+DIM+M+SG
quinauzinhos	quinau+N+DIM+M+PL
quincha	quincha+N+F+SG
quinchas	quincha+N+F+PL
quinchazinha	quincha+N+DIM+F+SG
quinchazinhas	quincha+N+DIM+F+PL
quinchinha	quincha+N+DIM+F+SG
quinchinhas	quincha+N+DIM+F+PL
quinchorrinho	quinchorro+N+DIM+M+SG
quinchorrinhos	quinchorro+N+DIM+M+PL
quinchorro	quinchorro+N+M+SG
quinchorros	quinchorro+N+M+PL
quinchorrozinho	quinchorro+N+DIM+M+SG
quinchorrozinhos	quinchorro+N+DIM+M+PL
quinchosinho	quinchoso+N+DIM+M+SG
quinchosinhos	quinchoso+N+DIM+M+PL
quinchoso	quinchoso+N+M+SG
quinchosos	quinchoso+N+M+PL
quinchosozinho	quinchoso+N+DIM+M+SG
quinchosozinhos	quinchoso+N+DIM+M+PL
quincunce	quincunce+N+M+SG
quincunces	quincunce+N+M+PL
quincuncezinho	quincunce+N+DIM+M+SG
quincuncezinhos	quincunce+N+DIM+M+PL
quincuncinho	quincunce+N+DIM+M+SG
quincuncinhos	quincunce+N+DIM+M+PL
quincuncialidade	quincuncialidade+N+F+SG
quincuncialidades	quincuncialidade+N+F+PL
quincuncialidadezinha	quincuncialidade+N+DIM+F+SG
quincuncialidadezinhas	quincuncialidade+N+DIM+F+PL
quincuncialidadinha	quincuncialidade+N+DIM+F+SG
quincuncialidadinhas	quincuncialidade+N+DIM+F+PL
quincalogozinho	quincálogo+N+DIM+M+SG
quincalogozinhos	quincálogo+N+DIM+M+PL
quincaloguinho	quincálogo+N+DIM+M+SG
quincaloguinhos	quincálogo+N+DIM+M+PL
quincálogo	quincálogo+N+M+SG
quincálogos	quincálogo+N+M+PL
quinconcinho	quincôncio+N+DIM+M+SG
quinconcinhos	quincôncio+N+DIM+M+PL
quinconciozinho	quincôncio+N+DIM+M+SG
quinconciozinhos	quincôncio+N+DIM+M+PL
quincôncio	quincôncio+N+M+SG
quincôncios	quincôncio+N+M+PL
quindecenviradinho	quindecenvirado+N+DIM+M+SG
quindecenviradinhos	quindecenvirado+N+DIM+M+PL
quindecenvirado	quindecenvirado+N+M+SG
quindecenvirados	quindecenvirado+N+M+PL
quindecenviradozinho	quindecenvirado+N+DIM+M+SG
quindecenviradozinhos	quindecenvirado+N+DIM+M+PL
quindecenviralidade	quindecenviralidade+N+F+SG
quindecenviralidades	quindecenviralidade+N+F+PL
quindecenviralidadezinha	quindecenviralidade+N+DIM+F+SG
quindecenviralidadezinhas	quindecenviralidade+N+DIM+F+PL
quindecenviralidadinha	quindecenviralidade+N+DIM+F+SG
quindecenviralidadinhas	quindecenviralidade+N+DIM+F+PL
quindecenviratinho	quindecenvirato+N+DIM+M+SG
quindecenviratinhos	quindecenvirato+N+DIM+M+PL
quindecenvirato	quindecenvirato+N+M+SG
quindecenviratos	quindecenvirato+N+M+PL
quindecenviratozinho	quindecenvirato+N+DIM+M+SG
quindecenviratozinhos	quindecenvirato+N+DIM+M+PL
quindecagoninho	quindecágono+N+DIM+M+SG
quindecagoninhos	quindecágono+N+DIM+M+PL
quindecagonozinho	quindecágono+N+DIM+M+SG
quindecagonozinhos	quindecágono+N+DIM+M+PL
quindecágono	quindecágono+N+M+SG
quindecágonos	quindecágono+N+M+PL
quindecenvirinho	quindecênviro+N+DIM+M+SG
quindecenvirinhos	quindecênviro+N+DIM+M+PL
quindecenvirozinho	quindecênviro+N+DIM+M+SG
quindecenvirozinhos	quindecênviro+N+DIM+M+PL
quindecênviro	quindecênviro+N+M+SG
quindecênviros	quindecênviro+N+M+PL
quindim	quindim+N+M+SG
quindins	quindim+N+M+PL
quindinzinho	quindim+N+DIM+M+SG
quindinzinhos	quindim+N+DIM+M+PL
quindunde	quindunde+N+M+SG
quindundes	quindunde+N+M+PL
quindundezinho	quindunde+N+DIM+M+SG
quindundezinhos	quindunde+N+DIM+M+PL
quindundinho	quindunde+N+DIM+M+SG
quindundinhos	quindunde+N+DIM+M+PL
quindeninho	quindénio+N+DIM+M+SG
quindeninhos	quindénio+N+DIM+M+PL
quindeniozinho	quindénio+N+DIM+M+SG
quindeniozinhos	quindénio+N+DIM+M+PL
quindénio	quindénio+N+M+SG
quindénios	quindénio+N+M+PL
quindeninho	quindênio+N+DIM+M+SG
quindeninhos	quindênio+N+DIM+M+PL
quindeniozinho	quindênio+N+DIM+M+SG
quindeniozinhos	quindênio+N+DIM+M+PL
quindênio	quindênio+N+M+SG
quindênios	quindênio+N+M+PL
quineira	quineira+N+F+SG
quineiras	quineira+N+F+PL
quineirazinha	quineira+N+DIM+F+SG
quineirazinhas	quineira+N+DIM+F+PL
quineirinha	quineira+N+DIM+F+SG
quineirinhas	quineira+N+DIM+F+PL
quinestesicidade	quinestesicidade+N+F+SG
quinestesicidades	quinestesicidade+N+F+PL
quinestesicidadezinha	quinestesicidade+N+DIM+F+SG
quinestesicidadezinhas	quinestesicidade+N+DIM+F+PL
quinestesicidadinha	quinestesicidade+N+DIM+F+SG
quinestesicidadinhas	quinestesicidade+N+DIM+F+PL
quingentaria	quingentaria+N+F+SG
quingentarias	quingentaria+N+F+PL
quingentariazinha	quingentaria+N+DIM+F+SG
quingentariazinhas	quingentaria+N+DIM+F+PL
quingentarinha	quingentaria+N+DIM+F+SG
quingentarinhas	quingentaria+N+DIM+F+PL
quingentarinho	quingentário+N+DIM+M+SG
quingentarinhos	quingentário+N+DIM+M+PL
quingentariozinho	quingentário+N+DIM+M+SG
quingentariozinhos	quingentário+N+DIM+M+PL
quingentário	quingentário+N+M+SG
quingentários	quingentário+N+M+PL
quingentesimazinha	quingentésimo+N+DIM+F+SG
quingentesimazinhas	quingentésimo+N+DIM+F+PL
quingentesiminha	quingentésimo+N+DIM+F+SG
quingentesiminhas	quingentésimo+N+DIM+F+PL
quingentesiminho	quingentésimo+N+DIM+M+SG
quingentesiminhos	quingentésimo+N+DIM+M+PL
quingentesimozinho	quingentésimo+N+DIM+M+SG
quingentesimozinhos	quingentésimo+N+DIM+M+PL
quingentésima	quingentésimo+N+F+SG
quingentésimas	quingentésimo+N+F+PL
quingentésimo	quingentésimo+N+M+SG
quingentésimos	quingentésimo+N+M+PL
quingosta	quingosta+N+F+SG
quingostas	quingosta+N+F+PL
quingostazinha	quingosta+N+DIM+F+SG
quingostazinhas	quingosta+N+DIM+F+PL
quingostinha	quingosta+N+DIM+F+SG
quingostinhas	quingosta+N+DIM+F+PL
quinhentisminho	quinhentismo+N+DIM+M+SG
quinhentisminhos	quinhentismo+N+DIM+M+PL
quinhentismo	quinhentismo+N+M+SG
quinhentismos	quinhentismo+N+M+PL
quinhentismozinho	quinhentismo+N+DIM+M+SG
quinhentismozinhos	quinhentismo+N+DIM+M+PL
quinhentista	quinhentista+N+SG
quinhentistas	quinhentista+N+PL
quinhentistazinha	quinhentista+N+DIM+F+SG
quinhentistazinhas	quinhentista+N+DIM+F+PL
quinhentistazinho	quinhentista+N+DIM+M+SG
quinhentistazinhos	quinhentista+N+DIM+M+PL
quinhentistinha	quinhentista+N+DIM+SG
quinhentistinhas	quinhentista+N+DIM+PL
quinhentas	quinhentos+N+F+PL
quinhentazinhas	quinhentos+N+DIM+F+PL
quinhentos	quinhentos+N+M
quinhentosinhas	quinhentos+N+DIM+F+PL
quinhentosinho	quinhentos+N+DIM+M+SG
quinhentosinhos	quinhentos+N+DIM+M+PL
quinhentão	quinhentão+N+M+SG
quinhentãozinho	quinhentão+N+DIM+M+SG
quinhentões	quinhentão+N+M+PL
quinhentõezinhos	quinhentão+N+DIM+M+PL
quinhoeira	quinhoeiro+N+F+SG
quinhoeiras	quinhoeiro+N+F+PL
quinhoeirazinha	quinhoeiro+N+DIM+F+SG
quinhoeirazinhas	quinhoeiro+N+DIM+F+PL
quinhoeirinha	quinhoeiro+N+DIM+F+SG
quinhoeirinhas	quinhoeiro+N+DIM+F+PL
quinhoeirinho	quinhoeiro+N+DIM+M+SG
quinhoeirinhos	quinhoeiro+N+DIM+M+PL
quinhoeiro	quinhoeiro+N+M+SG
quinhoeiros	quinhoeiro+N+M+PL
quinhoeirozinho	quinhoeiro+N+DIM+M+SG
quinhoeirozinhos	quinhoeiro+N+DIM+M+PL
quinhão	quinhão+N+M+SG
quinhãozinho	quinhão+N+DIM+M+SG
quinhões	quinhão+N+M+PL
quinhõezinhos	quinhão+N+DIM+M+PL
quinidina	quinidina+N+F+SG
quinidinas	quinidina+N+F+PL
quinidinazinha	quinidina+N+DIM+F+SG
quinidinazinhas	quinidina+N+DIM+F+PL
quinidininha	quinidina+N+DIM+F+SG
quinidininhas	quinidina+N+DIM+F+PL
quinina	quinina+N+SG
quininas	quinina+N+PL
quininazinha	quinina+N+DIM+F+SG
quininazinhas	quinina+N+DIM+F+PL
quininazinho	quinina+N+DIM+M+SG
quininazinhos	quinina+N+DIM+M+PL
quinininha	quinina+N+DIM+SG
quinininhas	quinina+N+DIM+PL
quinininho	quinino+N+DIM+M+SG
quinininhos	quinino+N+DIM+M+PL
quinino	quinino+N+M+SG
quininos	quinino+N+M+PL
quininozinho	quinino+N+DIM+M+SG
quininozinhos	quinino+N+DIM+M+PL
quinisminho	quinismo+N+DIM+M+SG
quinisminhos	quinismo+N+DIM+M+PL
quinismo	quinismo+N+M+SG
quinismos	quinismo+N+M+PL
quinismozinho	quinismo+N+DIM+M+SG
quinismozinhos	quinismo+N+DIM+M+PL
quininho	quino+N+DIM+M+SG
quininhos	quino+N+DIM+M+PL
quino	quino+N+M+SG
quinos	quino+N+M+PL
quinozinho	quino+N+DIM+M+SG
quinozinhos	quino+N+DIM+M+PL
quinoleinazinha	quinoleína+N+DIM+F+SG
quinoleinazinhas	quinoleína+N+DIM+F+PL
quinoleininha	quinoleína+N+DIM+F+SG
quinoleininhas	quinoleína+N+DIM+F+PL
quinoleína	quinoleína+N+F+SG
quinoleínas	quinoleína+N+F+PL
quinona	quinona+N+F+SG
quinonas	quinona+N+F+PL
quinonazinha	quinona+N+DIM+F+SG
quinonazinhas	quinona+N+DIM+F+PL
quinoninha	quinona+N+DIM+F+SG
quinoninhas	quinona+N+DIM+F+PL
quinor	quinor+N+M+SG
quinores	quinor+N+M+PL
quinorezinhos	quinor+N+DIM+M+PL
quinorzinho	quinor+N+DIM+M+SG
quinorzinhos	quinor+N+DIM+M+PL
quinquagenariazinha	quinquagenário+N+DIM+F+SG
quinquagenariazinhas	quinquagenário+N+DIM+F+PL
quinquagenarinha	quinquagenário+N+DIM+F+SG
quinquagenarinhas	quinquagenário+N+DIM+F+PL
quinquagenarinho	quinquagenário+N+DIM+M+SG
quinquagenarinhos	quinquagenário+N+DIM+M+PL
quinquagenariozinho	quinquagenário+N+DIM+M+SG
quinquagenariozinhos	quinquagenário+N+DIM+M+PL
quinquagenária	quinquagenário+N+F+SG
quinquagenárias	quinquagenário+N+F+PL
quinquagenário	quinquagenário+N+M+SG
quinquagenários	quinquagenário+N+M+PL
quinquagesimalidade	quinquagesimalidade+N+F+SG
quinquagesimalidades	quinquagesimalidade+N+F+PL
quinquagesimalidadezinha	quinquagesimalidade+N+DIM+F+SG
quinquagesimalidadezinhas	quinquagesimalidade+N+DIM+F+PL
quinquagesimalidadinha	quinquagesimalidade+N+DIM+F+SG
quinquagesimalidadinhas	quinquagesimalidade+N+DIM+F+PL
quinquagesimazinha	quinquagésima+N+DIM+F+SG
quinquagesimazinhas	quinquagésima+N+DIM+F+PL
quinquagesiminha	quinquagésima+N+DIM+F+SG
quinquagesiminhas	quinquagésima+N+DIM+F+PL
quinquagésima	quinquagésima+N+F+SG
quinquagésimas	quinquagésima+N+F+PL
quinquagesimazinha	quinquagésimo+N+DIM+F+SG
quinquagesimazinhas	quinquagésimo+N+DIM+F+PL
quinquagesiminha	quinquagésimo+N+DIM+F+SG
quinquagesiminhas	quinquagésimo+N+DIM+F+PL
quinquagesiminho	quinquagésimo+N+DIM+M+SG
quinquagesiminhos	quinquagésimo+N+DIM+M+PL
quinquagesimozinho	quinquagésimo+N+DIM+M+SG
quinquagesimozinhos	quinquagésimo+N+DIM+M+PL
quinquagésima	quinquagésimo+N+F+SG
quinquagésimas	quinquagésimo+N+F+PL
quinquagésimo	quinquagésimo+N+M+SG
quinquagésimos	quinquagésimo+N+M+PL
quinqueangularidade	quinqueangularidade+N+F+SG
quinqueangularidades	quinqueangularidade+N+F+PL
quinqueangularidadezinha	quinqueangularidade+N+DIM+F+SG
quinqueangularidadezinhas	quinqueangularidade+N+DIM+F+PL
quinqueangularidadinha	quinqueangularidade+N+DIM+F+SG
quinqueangularidadinhas	quinqueangularidade+N+DIM+F+PL
quinquecapsularidade	quinquecapsularidade+N+F+SG
quinquecapsularidades	quinquecapsularidade+N+F+PL
quinquecapsularidadezinha	quinquecapsularidade+N+DIM+F+SG
quinquecapsularidadezinhas	quinquecapsularidade+N+DIM+F+PL
quinquecapsularidadinha	quinquecapsularidade+N+DIM+F+SG
quinquecapsularidadinhas	quinquecapsularidade+N+DIM+F+PL
quinquecelularidade	quinquecelularidade+N+F+SG
quinquecelularidades	quinquecelularidade+N+F+PL
quinquecelularidadezinha	quinquecelularidade+N+DIM+F+SG
quinquecelularidadezinhas	quinquecelularidade+N+DIM+F+PL
quinquecelularidadinha	quinquecelularidade+N+DIM+F+SG
quinquecelularidadinhas	quinquecelularidade+N+DIM+F+PL
quinquegencianinho	quinquegenciano+N+DIM+M+SG
quinquegencianinhos	quinquegenciano+N+DIM+M+PL
quinquegenciano	quinquegenciano+N+M+SG
quinquegencianos	quinquegenciano+N+M+PL
quinquegencianozinho	quinquegenciano+N+DIM+M+SG
quinquegencianozinhos	quinquegenciano+N+DIM+M+PL
quinquelocularidade	quinquelocularidade+N+F+SG
quinquelocularidades	quinquelocularidade+N+F+PL
quinquelocularidadezinha	quinquelocularidade+N+DIM+F+SG
quinquelocularidadezinhas	quinquelocularidade+N+DIM+F+PL
quinquelocularidadinha	quinquelocularidade+N+DIM+F+SG
quinquelocularidadinhas	quinquelocularidade+N+DIM+F+PL
quinquenais	quinquenal+N+F+PL
quinquenaizinhas	quinquenal+N+DIM+F+PL
quinquenal	quinquenal+N+F+SG
quinquenalzinha	quinquenal+N+DIM+F+SG
quinquenalidade	quinquenalidade+N+F+SG
quinquenalidades	quinquenalidade+N+F+PL
quinquenalidadezinha	quinquenalidade+N+DIM+F+SG
quinquenalidadezinhas	quinquenalidade+N+DIM+F+PL
quinquenalidadinha	quinquenalidade+N+DIM+F+SG
quinquenalidadinhas	quinquenalidade+N+DIM+F+PL
quinquerreme	quinquerreme+N+F+SG
quinquerremes	quinquerreme+N+F+PL
quinquerremezinha	quinquerreme+N+DIM+F+SG
quinquerremezinhas	quinquerreme+N+DIM+F+PL
quinquerreminha	quinquerreme+N+DIM+F+SG
quinquerreminhas	quinquerreme+N+DIM+F+PL
quinquevalvaridade	quinquevalvaridade+N+F+SG
quinquevalvaridades	quinquevalvaridade+N+F+PL
quinquevalvaridadezinha	quinquevalvaridade+N+DIM+F+SG
quinquevalvaridadezinhas	quinquevalvaridade+N+DIM+F+PL
quinquevalvaridadinha	quinquevalvaridade+N+DIM+F+SG
quinquevalvaridadinhas	quinquevalvaridade+N+DIM+F+PL
quinquevalvularidade	quinquevalvularidade+N+F+SG
quinquevalvularidades	quinquevalvularidade+N+F+PL
quinquevalvularidadezinha	quinquevalvularidade+N+DIM+F+SG
quinquevalvularidadezinhas	quinquevalvularidade+N+DIM+F+PL
quinquevalvularidadinha	quinquevalvularidade+N+DIM+F+SG
quinquevalvularidadinhas	quinquevalvularidade+N+DIM+F+PL
quinquevirada	quinquevirado+N+F+SG
quinqueviradas	quinquevirado+N+F+PL
quinqueviradazinha	quinquevirado+N+DIM+F+SG
quinqueviradazinhas	quinquevirado+N+DIM+F+PL
quinqueviradinha	quinquevirado+N+DIM+F+SG
quinqueviradinhas	quinquevirado+N+DIM+F+PL
quinqueviradinho	quinquevirado+N+DIM+M+SG
quinqueviradinhos	quinquevirado+N+DIM+M+PL
quinquevirado	quinquevirado+N+M+SG
quinquevirados	quinquevirado+N+M+PL
quinqueviradozinho	quinquevirado+N+DIM+M+SG
quinqueviradozinhos	quinquevirado+N+DIM+M+PL
quinqueviralidade	quinqueviralidade+N+F+SG
quinqueviralidades	quinqueviralidade+N+F+PL
quinqueviralidadezinha	quinqueviralidade+N+DIM+F+SG
quinqueviralidadezinhas	quinqueviralidade+N+DIM+F+PL
quinqueviralidadinha	quinqueviralidade+N+DIM+F+SG
quinqueviralidadinhas	quinqueviralidade+N+DIM+F+PL
quinqueviratinho	quinquevirato+N+DIM+M+SG
quinqueviratinhos	quinquevirato+N+DIM+M+PL
quinquevirato	quinquevirato+N+M+SG
quinqueviratos	quinquevirato+N+M+PL
quinqueviratozinho	quinquevirato+N+DIM+M+SG
quinqueviratozinhos	quinquevirato+N+DIM+M+PL
quinquilharia	quinquilharia+N+F+SG
quinquilharias	quinquilharia+N+F+PL
quinquilhariazinha	quinquilharia+N+DIM+F+SG
quinquilhariazinhas	quinquilharia+N+DIM+F+PL
quinquilharinha	quinquilharia+N+DIM+F+SG
quinquilharinhas	quinquilharia+N+DIM+F+PL
quinquilharias	quinquilharias+N+F+SG
quinquilhariasinha	quinquilharias+N+DIM+F+SG
quinquilheira	quinquilheiro+N+F+SG
quinquilheiras	quinquilheiro+N+F+PL
quinquilheirazinha	quinquilheiro+N+DIM+F+SG
quinquilheirazinhas	quinquilheiro+N+DIM+F+PL
quinquilheirinha	quinquilheiro+N+DIM+F+SG
quinquilheirinhas	quinquilheiro+N+DIM+F+PL
quinquilheirinho	quinquilheiro+N+DIM+M+SG
quinquilheirinhos	quinquilheiro+N+DIM+M+PL
quinquilheiro	quinquilheiro+N+M+SG
quinquilheiros	quinquilheiro+N+M+PL
quinquilheirozinho	quinquilheiro+N+DIM+M+SG
quinquilheirozinhos	quinquilheiro+N+DIM+M+PL
quinquilaterinho	quinquilátero+N+DIM+M+SG
quinquilaterinhos	quinquilátero+N+DIM+M+PL
quinquilaterozinho	quinquilátero+N+DIM+M+SG
quinquilaterozinhos	quinquilátero+N+DIM+M+PL
quinquilátero	quinquilátero+N+M+SG
quinquiláteros	quinquilátero+N+M+PL
quinquina	quinquina+N+F+SG
quinquinas	quinquina+N+F+PL
quinquinazinha	quinquina+N+DIM+F+SG
quinquinazinhas	quinquina+N+DIM+F+PL
quinquininha	quinquina+N+DIM+F+SG
quinquininhas	quinquina+N+DIM+F+PL
quinquiozinho	quinquió+N+DIM+M+SG
quinquiozinhos	quinquió+N+DIM+M+PL
quinquió	quinquió+N+M+SG
quinquiós	quinquió+N+M+PL
quinqueninho	quinquénio+N+DIM+M+SG
quinqueninhos	quinquénio+N+DIM+M+PL
quinqueniozinho	quinquénio+N+DIM+M+SG
quinqueniozinhos	quinquénio+N+DIM+M+PL
quinquénio	quinquénio+N+M+SG
quinquénios	quinquénio+N+M+PL
quinquevirinho	quinquéviro+N+DIM+M+SG
quinquevirinhos	quinquéviro+N+DIM+M+PL
quinquevirozinho	quinquéviro+N+DIM+M+SG
quinquevirozinhos	quinquéviro+N+DIM+M+PL
quinquéviro	quinquéviro+N+M+SG
quinquéviros	quinquéviro+N+M+PL
quinqueninho	quinquênio+N+DIM+M+SG
quinqueninhos	quinquênio+N+DIM+M+PL
quinqueniozinho	quinquênio+N+DIM+M+SG
quinqueniozinhos	quinquênio+N+DIM+M+PL
quinquênio	quinquênio+N+M+SG
quinquênios	quinquênio+N+M+PL
quinquidinho	quinquídio+N+DIM+M+SG
quinquidinhos	quinquídio+N+DIM+M+PL
quinquidiozinho	quinquídio+N+DIM+M+SG
quinquidiozinhos	quinquídio+N+DIM+M+PL
quinquídio	quinquídio+N+M+SG
quinquídios	quinquídio+N+M+PL
quinquiduinho	quinquíduo+N+DIM+M+SG
quinquiduinhos	quinquíduo+N+DIM+M+PL
quinquiduozinho	quinquíduo+N+DIM+M+SG
quinquiduozinhos	quinquíduo+N+DIM+M+PL
quinquíduo	quinquíduo+N+M+SG
quinquíduos	quinquíduo+N+M+PL
quinta	quinta+N+F+SG
quintas	quinta+N+F+PL
quintazinha	quinta+N+DIM+F+SG
quintazinhas	quinta+N+DIM+F+PL
quintinha	quinta+N+DIM+F+SG
quintinhas	quinta+N+DIM+F+PL
quintita	quinta+N+DIM+F+SG
quintitas	quinta+N+DIM+F+PL
quinta-coluna	quinta-coluna+N+SG
quinta-colunazinha	quinta-coluna+N+DIM+F+SG
quinta-colunazinho	quinta-coluna+N+DIM+M+SG
quinta-coluninha	quinta-coluna+N+DIM+SG
quinta-coluninhas	quinta-coluna+N+DIM+PL
quintas-colunas	quinta-coluna+N+PL
quintas-colunazinhas	quinta-coluna+N+DIM+F+PL
quintas-colunazinhos	quinta-coluna+N+DIM+M+PL
quinta-essenciazinha	quinta-essência+N+DIM+F+SG
quinta-essenciazinhas	quinta-essência+N+DIM+F+PL
quinta-essenciazinho	quinta-essência+N+DIM+M+SG
quinta-essenciazinhos	quinta-essência+N+DIM+M+PL
quinta-essencinha	quinta-essência+N+DIM+SG
quinta-essencinhas	quinta-essência+N+DIM+PL
quinta-essência	quinta-essência+N+SG
quinta-essências	quinta-essência+N+PL
quinta-feira	quinta-feira+N+F+SG
quinta-feirazinha	quinta-feira+N+DIM+F+SG
quinta-feirinha	quinta-feira+N+DIM+F+SG
quinta-feirinhas	quinta-feira+N+DIM+F+PL
quintas-feiras	quinta-feira+N+F+PL
quintas-feirazinhas	quinta-feira+N+DIM+F+PL
quintador	quintador+N+M+SG
quintadora	quintador+N+F+SG
quintadoras	quintador+N+F+PL
quintadorazinha	quintador+N+DIM+F+SG
quintadorazinhas	quintador+N+DIM+F+PL
quintadores	quintador+N+M+PL
quintadorezinhos	quintador+N+DIM+M+PL
quintadorinha	quintador+N+DIM+F+SG
quintadorinhas	quintador+N+DIM+F+PL
quintadorzinho	quintador+N+DIM+M+SG
quintadorzinhos	quintador+N+DIM+M+PL
quintais	quintal+N+M+PL
quintaizinhos	quintal+N+DIM+M+PL
quintaizitos	quintal+N+DIM+M+PL
quintal	quintal+N+M+SG
quintalinho	quintal+N+DIM+M+SG
quintalinhos	quintal+N+DIM+M+PL
quintalito	quintal+N+DIM+M+SG
quintalitos	quintal+N+DIM+M+PL
quintalzinho	quintal+N+DIM+M+SG
quintalzito	quintal+N+DIM+M+SG
quintalada	quintalada+N+F+SG
quintaladas	quintalada+N+F+PL
quintaladazinha	quintalada+N+DIM+F+SG
quintaladazinhas	quintalada+N+DIM+F+PL
quintaladinha	quintalada+N+DIM+F+SG
quintaladinhas	quintalada+N+DIM+F+PL
quintaleira	quintaleiro+N+F+SG
quintaleiras	quintaleiro+N+F+PL
quintaleirazinha	quintaleiro+N+DIM+F+SG
quintaleirazinhas	quintaleiro+N+DIM+F+PL
quintaleirinha	quintaleiro+N+DIM+F+SG
quintaleirinhas	quintaleiro+N+DIM+F+PL
quintaleirinho	quintaleiro+N+DIM+M+SG
quintaleirinhos	quintaleiro+N+DIM+M+PL
quintaleiro	quintaleiro+N+M+SG
quintaleiros	quintaleiro+N+M+PL
quintaleirozinho	quintaleiro+N+DIM+M+SG
quintaleirozinhos	quintaleiro+N+DIM+M+PL
quintalejinho	quintalejo+N+DIM+M+SG
quintalejinhos	quintalejo+N+DIM+M+PL
quintalejo	quintalejo+N+M+SG
quintalejos	quintalejo+N+M+PL
quintalejozinho	quintalejo+N+DIM+M+SG
quintalejozinhos	quintalejo+N+DIM+M+PL
quintalão	quintalão+N+F+SG
quintalãozinha	quintalão+N+DIM+F+SG
quintalões	quintalão+N+F+PL
quintalõezinhas	quintalão+N+DIM+F+PL
quintalorinho	quintalório+N+DIM+M+SG
quintalorinhos	quintalório+N+DIM+M+PL
quintaloriozinho	quintalório+N+DIM+M+SG
quintaloriozinhos	quintalório+N+DIM+M+PL
quintalório	quintalório+N+M+SG
quintalórios	quintalório+N+M+PL
quintanista	quintanista+N+SG
quintanistas	quintanista+N+PL
quintanistazinha	quintanista+N+DIM+F+SG
quintanistazinhas	quintanista+N+DIM+F+PL
quintanistazinho	quintanista+N+DIM+M+SG
quintanistazinhos	quintanista+N+DIM+M+PL
quintanistinha	quintanista+N+DIM+SG
quintanistinhas	quintanista+N+DIM+PL
quintaninho	quintano+N+DIM+M+SG
quintaninhos	quintano+N+DIM+M+PL
quintano	quintano+N+M+SG
quintanos	quintano+N+M+PL
quintanozinho	quintano+N+DIM+M+SG
quintanozinhos	quintano+N+DIM+M+PL
quintanos	quintanos+N+M+PL
quintanosinhas	quintanos+N+DIM+F+PL
quintanosinhos	quintanos+N+DIM+M+PL
quintarola	quintarola+N+F+SG
quintarolas	quintarola+N+F+PL
quintarolazinha	quintarola+N+DIM+F+SG
quintarolazinhas	quintarola+N+DIM+F+PL
quintarolinha	quintarola+N+DIM+F+SG
quintarolinhas	quintarola+N+DIM+F+PL
quinteira	quinteiro+N+F+SG
quinteiras	quinteiro+N+F+PL
quinteirazinha	quinteiro+N+DIM+F+SG
quinteirazinhas	quinteiro+N+DIM+F+PL
quinteirinha	quinteiro+N+DIM+F+SG
quinteirinhas	quinteiro+N+DIM+F+PL
quinteirinho	quinteiro+N+DIM+M+SG
quinteirinhos	quinteiro+N+DIM+M+PL
quinteiro	quinteiro+N+M+SG
quinteiros	quinteiro+N+M+PL
quinteirozinho	quinteiro+N+DIM+M+SG
quinteirozinhos	quinteiro+N+DIM+M+PL
quintessenciazinha	quintessência+N+DIM+F+SG
quintessenciazinhas	quintessência+N+DIM+F+PL
quintessencinha	quintessência+N+DIM+F+SG
quintessencinhas	quintessência+N+DIM+F+PL
quintessência	quintessência+N+F+SG
quintessências	quintessência+N+F+PL
quintetinho	quinteto+N+DIM+M+SG
quintetinhos	quinteto+N+DIM+M+PL
quinteto	quinteto+N+M+SG
quintetos	quinteto+N+M+PL
quintetozinho	quinteto+N+DIM+M+SG
quintetozinhos	quinteto+N+DIM+M+PL
quintifalange	quintifalange+N+F+SG
quintifalanges	quintifalange+N+F+PL
quintifalangezinha	quintifalange+N+DIM+F+SG
quintifalangezinhas	quintifalange+N+DIM+F+PL
quintifalanginha	quintifalange+N+DIM+F+SG
quintifalanginhas	quintifalange+N+DIM+F+PL
quintifalangeta	quintifalangeta+N+F+SG
quintifalangetas	quintifalangeta+N+F+PL
quintifalangetazinha	quintifalangeta+N+DIM+F+SG
quintifalangetazinhas	quintifalangeta+N+DIM+F+PL
quintifalangetinha	quintifalangeta+N+DIM+F+SG
quintifalangetinhas	quintifalangeta+N+DIM+F+PL
quintifalanginha	quintifalanginha+N+F+SG
quintifalanginhas	quintifalanginha+N+F+PL
quintifalanginhazinha	quintifalanginha+N+DIM+F+SG
quintifalanginhazinhas	quintifalanginha+N+DIM+F+PL
quintifalanginhinha	quintifalanginha+N+DIM+F+SG
quintifalanginhinhas	quintifalanginha+N+DIM+F+PL
quintil	quintil+N+M+SG
quintilzinho	quintil+N+DIM+M+SG
quintis	quintil+N+M+PL
quintizinhos	quintil+N+DIM+M+PL
quintilha	quintilha+N+F+SG
quintilhas	quintilha+N+F+PL
quintilhazinha	quintilha+N+DIM+F+SG
quintilhazinhas	quintilha+N+DIM+F+PL
quintilhinha	quintilha+N+DIM+F+SG
quintilhinhas	quintilha+N+DIM+F+PL
quintilião	quintilião+N+SG
quintiliãozinha	quintilião+N+DIM+F+SG
quintiliãozinho	quintilião+N+DIM+M+SG
quintiliões	quintilião+N+PL
quintiliõezinhas	quintilião+N+DIM+F+PL
quintiliõezinhos	quintilião+N+DIM+M+PL
quintimetatarsicidade	quintimetatarsicidade+N+F+SG
quintimetatarsicidades	quintimetatarsicidade+N+F+PL
quintimetatarsicidadezinha	quintimetatarsicidade+N+DIM+F+SG
quintimetatarsicidadezinhas	quintimetatarsicidade+N+DIM+F+PL
quintimetatarsicidadinha	quintimetatarsicidade+N+DIM+F+SG
quintimetatarsicidadinhas	quintimetatarsicidade+N+DIM+F+PL
quintissecularidade	quintissecularidade+N+F+SG
quintissecularidades	quintissecularidade+N+F+PL
quintissecularidadezinha	quintissecularidade+N+DIM+F+SG
quintissecularidadezinhas	quintissecularidade+N+DIM+F+PL
quintissecularidadinha	quintissecularidade+N+DIM+F+SG
quintissecularidadinhas	quintissecularidade+N+DIM+F+PL
quinta	quinto+N+F+SG
quintas	quinto+N+F+PL
quintazinha	quinto+N+DIM+F+SG
quintazinhas	quinto+N+DIM+F+PL
quintinha	quinto+N+DIM+F+SG
quintinhas	quinto+N+DIM+F+PL
quintinho	quinto+N+DIM+M+SG
quintinhos	quinto+N+DIM+M+PL
quinto	quinto+N+M+SG
quintos	quinto+N+M+PL
quintozinho	quinto+N+DIM+M+SG
quintozinhos	quinto+N+DIM+M+PL
quintos	quintos+N+M+PL
quintosinhas	quintos+N+DIM+F+PL
quintosinhos	quintos+N+DIM+M+PL
quintupleta	quintupleta+N+F+SG
quintupletas	quintupleta+N+F+PL
quintupletazinha	quintupleta+N+DIM+F+SG
quintupletazinhas	quintupleta+N+DIM+F+PL
quintupletinha	quintupleta+N+DIM+F+SG
quintupletinhas	quintupleta+N+DIM+F+PL
quintuplicabilidade	quintuplicabilidade+N+F+SG
quintuplicabilidades	quintuplicabilidade+N+F+PL
quintuplicabilidadezinha	quintuplicabilidade+N+DIM+F+SG
quintuplicabilidadezinhas	quintuplicabilidade+N+DIM+F+PL
quintuplicabilidadinha	quintuplicabilidade+N+DIM+F+SG
quintuplicabilidadinhas	quintuplicabilidade+N+DIM+F+PL
quintuplicador	quintuplicador+N+M+SG
quintuplicadora	quintuplicador+N+F+SG
quintuplicadoras	quintuplicador+N+F+PL
quintuplicadorazinha	quintuplicador+N+DIM+F+SG
quintuplicadorazinhas	quintuplicador+N+DIM+F+PL
quintuplicadores	quintuplicador+N+M+PL
quintuplicadorezinhos	quintuplicador+N+DIM+M+PL
quintuplicadorinha	quintuplicador+N+DIM+F+SG
quintuplicadorinhas	quintuplicador+N+DIM+F+PL
quintuplicadorzinho	quintuplicador+N+DIM+M+SG
quintuplicadorzinhos	quintuplicador+N+DIM+M+PL
quintuplicação	quintuplicação+N+F+SG
quintuplicaçãozinha	quintuplicação+N+DIM+F+SG
quintuplicações	quintuplicação+N+F+PL
quintuplicaçõezinhas	quintuplicação+N+DIM+F+PL
quintã	quintã+N+F+SG
quintãs	quintã+N+F+PL
quintãzinha	quintã+N+DIM+F+SG
quintãzinhas	quintã+N+DIM+F+PL
quintão	quintão+N+M+SG
quintãozinho	quintão+N+DIM+M+SG
quintões	quintão+N+M+PL
quintõezinhos	quintão+N+DIM+M+PL
quinze	quinze+N+M+SG
quinzes	quinze+N+M+PL
quinzezinho	quinze+N+DIM+M+SG
quinzezinhos	quinze+N+DIM+M+PL
quinzinho	quinze+N+DIM+M+SG
quinzinhos	quinze+N+DIM+M+PL
quinzena	quinzena+N+F+SG
quinzenas	quinzena+N+F+PL
quinzenazinha	quinzena+N+DIM+F+SG
quinzenazinhas	quinzena+N+DIM+F+PL
quinzeninha	quinzena+N+DIM+F+SG
quinzeninhas	quinzena+N+DIM+F+PL
quinzenalidade	quinzenalidade+N+F+SG
quinzenalidades	quinzenalidade+N+F+PL
quinzenalidadezinha	quinzenalidade+N+DIM+F+SG
quinzenalidadezinhas	quinzenalidade+N+DIM+F+PL
quinzenalidadinha	quinzenalidade+N+DIM+F+SG
quinzenalidadinhas	quinzenalidade+N+DIM+F+PL
quinzenarinho	quinzenário+N+DIM+M+SG
quinzenarinhos	quinzenário+N+DIM+M+PL
quinzenariozinho	quinzenário+N+DIM+M+SG
quinzenariozinhos	quinzenário+N+DIM+M+PL
quinzenário	quinzenário+N+M+SG
quinzenários	quinzenário+N+M+PL
quinologazinha	quinólogo+N+DIM+F+SG
quinologazinhas	quinólogo+N+DIM+F+PL
quinologozinho	quinólogo+N+DIM+M+SG
quinologozinhos	quinólogo+N+DIM+M+PL
quinologuinha	quinólogo+N+DIM+F+SG
quinologuinhas	quinólogo+N+DIM+F+PL
quinologuinho	quinólogo+N+DIM+M+SG
quinologuinhos	quinólogo+N+DIM+M+PL
quinóloga	quinólogo+N+F+SG
quinólogas	quinólogo+N+F+PL
quinólogo	quinólogo+N+M+SG
quinólogos	quinólogo+N+M+PL
quiosque	quiosque+N+M+SG
quiosques	quiosque+N+M+PL
quiosquezinho	quiosque+N+DIM+M+SG
quiosquezinhos	quiosque+N+DIM+M+PL
quiosquinho	quiosque+N+DIM+M+SG
quiosquinhos	quiosque+N+DIM+M+PL
quiosqueira	quiosqueiro+N+F+SG
quiosqueiras	quiosqueiro+N+F+PL
quiosqueirazinha	quiosqueiro+N+DIM+F+SG
quiosqueirazinhas	quiosqueiro+N+DIM+F+PL
quiosqueirinha	quiosqueiro+N+DIM+F+SG
quiosqueirinhas	quiosqueiro+N+DIM+F+PL
quiosqueirinho	quiosqueiro+N+DIM+M+SG
quiosqueirinhos	quiosqueiro+N+DIM+M+PL
quiosqueiro	quiosqueiro+N+M+SG
quiosqueiros	quiosqueiro+N+M+PL
quiosqueirozinho	quiosqueiro+N+DIM+M+SG
quiosqueirozinhos	quiosqueiro+N+DIM+M+PL
quipoquezinho	quipoqué+N+DIM+M+SG
quipoquezinhos	quipoqué+N+DIM+M+PL
quipoqué	quipoqué+N+M+SG
quipoqués	quipoqué+N+M+PL
quiproquozinho	quiproquó+N+DIM+M+SG
quiproquozinhos	quiproquó+N+DIM+M+PL
quiproquó	quiproquó+N+M+SG
quiproquós	quiproquó+N+M+PL
quiquiriqui	quiquiriqui+N+SG
quiquiriquis	quiquiriqui+N+PL
quiquiriquizinha	quiquiriqui+N+DIM+F+SG
quiquiriquizinhas	quiquiriqui+N+DIM+F+PL
quiquiriquizinho	quiquiriqui+N+DIM+M+SG
quiquiriquizinhos	quiquiriqui+N+DIM+M+PL
quiragra	quiragra+N+F+SG
quiragras	quiragra+N+F+PL
quiragrazinha	quiragra+N+DIM+F+SG
quiragrazinhas	quiragra+N+DIM+F+PL
quiragrinha	quiragra+N+DIM+F+SG
quiragrinhas	quiragra+N+DIM+F+PL
quirais	quiral+N+M+PL
quiraizinhos	quiral+N+DIM+M+PL
quiral	quiral+N+M+SG
quiralzinho	quiral+N+DIM+M+SG
quiralgia	quiralgia+N+F+SG
quiralgias	quiralgia+N+F+PL
quiralgiazinha	quiralgia+N+DIM+F+SG
quiralgiazinhas	quiralgia+N+DIM+F+PL
quiralginha	quiralgia+N+DIM+F+SG
quiralginhas	quiralgia+N+DIM+F+PL
quiralgicidade	quiralgicidade+N+F+SG
quiralgicidades	quiralgicidade+N+F+PL
quiralgicidadezinha	quiralgicidade+N+DIM+F+SG
quiralgicidadezinhas	quiralgicidade+N+DIM+F+PL
quiralgicidadinha	quiralgicidade+N+DIM+F+SG
quiralgicidadinhas	quiralgicidade+N+DIM+F+PL
quiralidade	quiralidade+N+F+SG
quiralidades	quiralidade+N+F+PL
quiralidadezinha	quiralidade+N+DIM+F+SG
quiralidadezinhas	quiralidade+N+DIM+F+PL
quiralidadinha	quiralidade+N+DIM+F+SG
quiralidadinhas	quiralidade+N+DIM+F+PL
quirana	quirana+N+F+SG
quiranas	quirana+N+F+PL
quiranazinha	quirana+N+DIM+F+SG
quiranazinhas	quirana+N+DIM+F+PL
quiraninha	quirana+N+DIM+F+SG
quiraninhas	quirana+N+DIM+F+PL
quiratinho	quirato+N+DIM+M+SG
quiratinhos	quirato+N+DIM+M+PL
quirato	quirato+N+M+SG
quiratos	quirato+N+M+PL
quiratozinho	quirato+N+DIM+M+SG
quiratozinhos	quirato+N+DIM+M+PL
quirela	quirela+N+F+SG
quirelas	quirela+N+F+PL
quirelazinha	quirela+N+DIM+F+SG
quirelazinhas	quirela+N+DIM+F+PL
quirelinha	quirela+N+DIM+F+SG
quirelinhas	quirela+N+DIM+F+PL
quirera	quirera+N+F+SG
quireras	quirera+N+F+PL
quirerazinha	quirera+N+DIM+F+SG
quirerazinhas	quirera+N+DIM+F+PL
quirerinha	quirera+N+DIM+F+SG
quirerinhas	quirera+N+DIM+F+PL
quirguiz	quirguiz+N+SG
quirguizes	quirguiz+N+PL
quirguizezinhas	quirguiz+N+DIM+F+PL
quirguizezinhos	quirguiz+N+DIM+M+PL
quirguizinha	quirguiz+N+DIM+F+SG
quirguizinhas	quirguiz+N+DIM+F+PL
quirguizinho	quirguiz+N+DIM+M+SG
quirguizinhos	quirguiz+N+DIM+M+PL
quirieleison	quirieleison+N+M+SG
quirieleisones	quirieleison+N+M+PL
quirieleisonezinhos	quirieleison+N+DIM+M+PL
quirieleisons	quirieleison+N+M+PL
quirieleisonzinho	quirieleison+N+DIM+M+SG
quirieleisonzinhos	quirieleison+N+DIM+M+PL
quirieleisão	quirieleisão+N+M+SG
quirieleisãozinho	quirieleisão+N+DIM+M+SG
quirieleisões	quirieleisão+N+M+PL
quirieleisõezinhos	quirieleisão+N+DIM+M+PL
quirim	quirim+N+M+SG
quirins	quirim+N+M+PL
quirinzinho	quirim+N+DIM+M+SG
quirinzinhos	quirim+N+DIM+M+PL
quiriru	quiriru+N+M+SG
quirirus	quiriru+N+M+PL
quiriruzinho	quiriru+N+DIM+M+SG
quiriruzinhos	quiriru+N+DIM+M+PL
quirite	quirite+N+SG
quirites	quirite+N+PL
quiritezinha	quirite+N+DIM+F+SG
quiritezinhas	quirite+N+DIM+F+PL
quiritezinho	quirite+N+DIM+M+SG
quiritezinhos	quirite+N+DIM+M+PL
quiritinha	quirite+N+DIM+F+SG
quiritinhas	quirite+N+DIM+F+PL
quiritinho	quirite+N+DIM+M+SG
quiritinhos	quirite+N+DIM+M+PL
quirodactilinho	quirodáctilo+N+DIM+M+SG
quirodactilinhos	quirodáctilo+N+DIM+M+PL
quirodactilozinho	quirodáctilo+N+DIM+M+SG
quirodactilozinhos	quirodáctilo+N+DIM+M+PL
quirodáctilo	quirodáctilo+N+M+SG
quirodáctilos	quirodáctilo+N+M+PL
quiroga	quiroga+N+F+SG
quirogas	quiroga+N+F+PL
quirogazinha	quiroga+N+DIM+F+SG
quirogazinhas	quiroga+N+DIM+F+PL
quiroguinha	quiroga+N+DIM+F+SG
quiroguinhas	quiroga+N+DIM+F+PL
quirograficidade	quirograficidade+N+F+SG
quirograficidades	quirograficidade+N+F+PL
quirograficidadezinha	quirograficidade+N+DIM+F+SG
quirograficidadezinhas	quirograficidade+N+DIM+F+PL
quirograficidadinha	quirograficidade+N+DIM+F+SG
quirograficidadinhas	quirograficidade+N+DIM+F+PL
quirologia	quirologia+N+F+SG
quirologias	quirologia+N+F+PL
quirologiazinha	quirologia+N+DIM+F+SG
quirologiazinhas	quirologia+N+DIM+F+PL
quirologinha	quirologia+N+DIM+F+SG
quirologinhas	quirologia+N+DIM+F+PL
quirologicidade	quirologicidade+N+F+SG
quirologicidades	quirologicidade+N+F+PL
quirologicidadezinha	quirologicidade+N+DIM+F+SG
quirologicidadezinhas	quirologicidade+N+DIM+F+PL
quirologicidadinha	quirologicidade+N+DIM+F+SG
quirologicidadinhas	quirologicidade+N+DIM+F+PL
quiromancia	quiromancia+N+F+SG
quiromancias	quiromancia+N+F+PL
quiromanciazinha	quiromancia+N+DIM+F+SG
quiromanciazinhas	quiromancia+N+DIM+F+PL
quiromancinha	quiromancia+N+DIM+F+SG
quiromancinhas	quiromancia+N+DIM+F+PL
quiromante	quiromante+N+SG
quiromantes	quiromante+N+PL
quiromantezinha	quiromante+N+DIM+F+SG
quiromantezinhas	quiromante+N+DIM+F+PL
quiromantezinho	quiromante+N+DIM+M+SG
quiromantezinhos	quiromante+N+DIM+M+PL
quiromantinha	quiromante+N+DIM+F+SG
quiromantinhas	quiromante+N+DIM+F+PL
quiromantinho	quiromante+N+DIM+M+SG
quiromantinhos	quiromante+N+DIM+M+PL
quironomia	quironomia+N+F+SG
quironomias	quironomia+N+F+PL
quironomiazinha	quironomia+N+DIM+F+SG
quironomiazinhas	quironomia+N+DIM+F+PL
quironominha	quironomia+N+DIM+F+SG
quironominhas	quironomia+N+DIM+F+PL
quironomicidade	quironomicidade+N+F+SG
quironomicidades	quironomicidade+N+F+PL
quironomicidadezinha	quironomicidade+N+DIM+F+SG
quironomicidadezinhas	quironomicidade+N+DIM+F+PL
quironomicidadinha	quironomicidade+N+DIM+F+SG
quironomicidadinhas	quironomicidade+N+DIM+F+PL
quironomideinho	quironomídeo+N+DIM+M+SG
quironomideinhos	quironomídeo+N+DIM+M+PL
quironomideozinho	quironomídeo+N+DIM+M+SG
quironomideozinhos	quironomídeo+N+DIM+M+PL
quironomídeo	quironomídeo+N+M+SG
quironomídeos	quironomídeo+N+M+PL
quironomidazinho	quironómida+N+DIM+M+SG
quironomidazinhos	quironómida+N+DIM+M+PL
quironomidinha	quironómida+N+DIM+M+SG
quironomidinhas	quironómida+N+DIM+M+PL
quironómida	quironómida+N+M+SG
quironómidas	quironómida+N+M+PL
quiroplastinho	quiroplasto+N+DIM+M+SG
quiroplastinhos	quiroplasto+N+DIM+M+PL
quiroplasto	quiroplasto+N+M+SG
quiroplastos	quiroplasto+N+M+PL
quiroplastozinho	quiroplasto+N+DIM+M+SG
quiroplastozinhos	quiroplasto+N+DIM+M+PL
quiropodia	quiropodia+N+F+SG
quiropodias	quiropodia+N+F+PL
quiropodiazinha	quiropodia+N+DIM+F+SG
quiropodiazinhas	quiropodia+N+DIM+F+PL
quiropodinha	quiropodia+N+DIM+F+SG
quiropodinhas	quiropodia+N+DIM+F+PL
quiropodista	quiropodista+N+SG
quiropodistas	quiropodista+N+PL
quiropodistazinha	quiropodista+N+DIM+F+SG
quiropodistazinhas	quiropodista+N+DIM+F+PL
quiropodistazinho	quiropodista+N+DIM+M+SG
quiropodistazinhos	quiropodista+N+DIM+M+PL
quiropodistinha	quiropodista+N+DIM+SG
quiropodistinhas	quiropodista+N+DIM+PL
quiropterofilia	quiropterofilia+N+F+SG
quiropterofilias	quiropterofilia+N+F+PL
quiropterofiliazinha	quiropterofilia+N+DIM+F+SG
quiropterofiliazinhas	quiropterofilia+N+DIM+F+PL
quiropterofilinha	quiropterofilia+N+DIM+F+SG
quiropterofilinhas	quiropterofilia+N+DIM+F+PL
quiroscopia	quiroscopia+N+F+SG
quiroscopias	quiroscopia+N+F+PL
quiroscopiazinha	quiroscopia+N+DIM+F+SG
quiroscopiazinhas	quiroscopia+N+DIM+F+PL
quiroscopinha	quiroscopia+N+DIM+F+SG
quiroscopinhas	quiroscopia+N+DIM+F+PL
quirotonia	quirotonia+N+F+SG
quirotonias	quirotonia+N+F+PL
quirotoniazinha	quirotonia+N+DIM+F+SG
quirotoniazinhas	quirotonia+N+DIM+F+PL
quirotoninha	quirotonia+N+DIM+F+SG
quirotoninhas	quirotonia+N+DIM+F+PL
quirotonicidade	quirotonicidade+N+F+SG
quirotonicidades	quirotonicidade+N+F+PL
quirotonicidadezinha	quirotonicidade+N+DIM+F+SG
quirotonicidadezinhas	quirotonicidade+N+DIM+F+PL
quirotonicidadinha	quirotonicidade+N+DIM+F+SG
quirotonicidadinhas	quirotonicidade+N+DIM+F+PL
quirotribia	quirotribia+N+F+SG
quirotribias	quirotribia+N+F+PL
quirotribiazinha	quirotribia+N+DIM+F+SG
quirotribiazinhas	quirotribia+N+DIM+F+PL
quirotribinha	quirotribia+N+DIM+F+SG
quirotribinhas	quirotribia+N+DIM+F+PL
quirografinho	quirógrafo+N+DIM+M+SG
quirografinhos	quirógrafo+N+DIM+M+PL
quirografozinho	quirógrafo+N+DIM+M+SG
quirografozinhos	quirógrafo+N+DIM+M+PL
quirógrafo	quirógrafo+N+M+SG
quirógrafos	quirógrafo+N+M+PL
quirologazinha	quirólogo+N+DIM+F+SG
quirologazinhas	quirólogo+N+DIM+F+PL
quirologozinho	quirólogo+N+DIM+M+SG
quirologozinhos	quirólogo+N+DIM+M+PL
quirologuinha	quirólogo+N+DIM+F+SG
quirologuinhas	quirólogo+N+DIM+F+PL
quirologuinho	quirólogo+N+DIM+M+SG
quirologuinhos	quirólogo+N+DIM+M+PL
quiróloga	quirólogo+N+F+SG
quirólogas	quirólogo+N+F+PL
quirólogo	quirólogo+N+M+SG
quirólogos	quirólogo+N+M+PL
quirometrinho	quirómetro+N+DIM+M+SG
quirometrinhos	quirómetro+N+DIM+M+PL
quirometrozinho	quirómetro+N+DIM+M+SG
quirometrozinhos	quirómetro+N+DIM+M+PL
quirómetro	quirómetro+N+M+SG
quirómetros	quirómetro+N+M+PL
quironominho	quirónomo+N+DIM+M+SG
quironominhos	quirónomo+N+DIM+M+PL
quironomozinho	quirónomo+N+DIM+M+SG
quironomozinhos	quirónomo+N+DIM+M+PL
quirónomo	quirónomo+N+M+SG
quirónomos	quirónomo+N+M+PL
quiropterinho	quiróptero+N+DIM+M+SG
quiropterinhos	quiróptero+N+DIM+M+PL
quiropterozinho	quiróptero+N+DIM+M+SG
quiropterozinhos	quiróptero+N+DIM+M+PL
quiróptero	quiróptero+N+M+SG
quirópteros	quiróptero+N+M+PL
quirometrinho	quirômetro+N+DIM+M+SG
quirometrinhos	quirômetro+N+DIM+M+PL
quirometrozinho	quirômetro+N+DIM+M+SG
quirometrozinhos	quirômetro+N+DIM+M+PL
quirômetro	quirômetro+N+M+SG
quirômetros	quirômetro+N+M+PL
quironominho	quirônomo+N+DIM+M+SG
quironominhos	quirônomo+N+DIM+M+PL
quironomozinho	quirônomo+N+DIM+M+SG
quironomozinhos	quirônomo+N+DIM+M+PL
quirônomo	quirônomo+N+M+SG
quirônomos	quirônomo+N+M+PL
quisling	quisling+N+M+SG
quislingzinho	quisling+N+DIM+M+SG
quissarrinho	quissarro+N+DIM+M+SG
quissarrinhos	quissarro+N+DIM+M+PL
quissarro	quissarro+N+M+SG
quissarros	quissarro+N+M+PL
quissarrozinho	quissarro+N+DIM+M+SG
quissarrozinhos	quissarro+N+DIM+M+PL
quisticidade	quisticidade+N+F+SG
quisticidades	quisticidade+N+F+PL
quisticidadezinha	quisticidade+N+DIM+F+SG
quisticidadezinhas	quisticidade+N+DIM+F+PL
quisticidadinha	quisticidade+N+DIM+F+SG
quisticidadinhas	quisticidade+N+DIM+F+PL
quista	quisto+N+F+SG
quistas	quisto+N+F+PL
quistazinha	quisto+N+DIM+F+SG
quistazinhas	quisto+N+DIM+F+PL
quistinha	quisto+N+DIM+F+SG
quistinhas	quisto+N+DIM+F+PL
quistinho	quisto+N+DIM+M+SG
quistinhos	quisto+N+DIM+M+PL
quisto	quisto+N+M+SG
quistos	quisto+N+M+PL
quistozinho	quisto+N+DIM+M+SG
quistozinhos	quisto+N+DIM+M+PL
quistosidade	quistosidade+N+F+SG
quistosidades	quistosidade+N+F+PL
quistosidadezinha	quistosidade+N+DIM+F+SG
quistosidadezinhas	quistosidade+N+DIM+F+PL
quistosidadinha	quistosidade+N+DIM+F+SG
quistosidadinhas	quistosidade+N+DIM+F+PL
quita	quita+N+F+SG
quitas	quita+N+F+PL
quitazinha	quita+N+DIM+F+SG
quitazinhas	quita+N+DIM+F+PL
quitinha	quita+N+DIM+F+SG
quitinhas	quita+N+DIM+F+PL
quitador	quitador+N+M+SG
quitadora	quitador+N+F+SG
quitadoras	quitador+N+F+PL
quitadorazinha	quitador+N+DIM+F+SG
quitadorazinhas	quitador+N+DIM+F+PL
quitadores	quitador+N+M+PL
quitadorezinhos	quitador+N+DIM+M+PL
quitadorinha	quitador+N+DIM+F+SG
quitadorinhas	quitador+N+DIM+F+PL
quitadorzinho	quitador+N+DIM+M+SG
quitadorzinhos	quitador+N+DIM+M+PL
quitamentinho	quitamento+N+DIM+M+SG
quitamentinhos	quitamento+N+DIM+M+PL
quitamento	quitamento+N+M+SG
quitamentos	quitamento+N+M+PL
quitamentozinho	quitamento+N+DIM+M+SG
quitamentozinhos	quitamento+N+DIM+M+PL
quitanda	quitanda+N+F+SG
quitandas	quitanda+N+F+PL
quitandazinha	quitanda+N+DIM+F+SG
quitandazinhas	quitanda+N+DIM+F+PL
quitandinha	quitanda+N+DIM+F+SG
quitandinhas	quitanda+N+DIM+F+PL
quitandeira	quitandeiro+N+F+SG
quitandeiras	quitandeiro+N+F+PL
quitandeirazinha	quitandeiro+N+DIM+F+SG
quitandeirazinhas	quitandeiro+N+DIM+F+PL
quitandeirinha	quitandeiro+N+DIM+F+SG
quitandeirinhas	quitandeiro+N+DIM+F+PL
quitandeirinho	quitandeiro+N+DIM+M+SG
quitandeirinhos	quitandeiro+N+DIM+M+PL
quitandeiro	quitandeiro+N+M+SG
quitandeiros	quitandeiro+N+M+PL
quitandeirozinho	quitandeiro+N+DIM+M+SG
quitandeirozinhos	quitandeiro+N+DIM+M+PL
quitanga	quitanga+N+F+SG
quitangas	quitanga+N+F+PL
quitangazinha	quitanga+N+DIM+F+SG
quitangazinhas	quitanga+N+DIM+F+PL
quitanguinha	quitanga+N+DIM+F+SG
quitanguinhas	quitanga+N+DIM+F+PL
quitação	quitação+N+F+SG
quitaçãozinha	quitação+N+DIM+F+SG
quitações	quitação+N+F+PL
quitaçõezinhas	quitação+N+DIM+F+PL
quite	quite+N+SG
quites	quite+N+PL
quitezinha	quite+N+DIM+F+SG
quitezinhas	quite+N+DIM+F+PL
quitezinho	quite+N+DIM+M+SG
quitezinhos	quite+N+DIM+M+PL
quitinha	quite+N+DIM+F+SG
quitinhas	quite+N+DIM+F+PL
quitinho	quite+N+DIM+M+SG
quitinhos	quite+N+DIM+M+PL
quitina	quitina+N+F+SG
quitinas	quitina+N+F+PL
quitinazinha	quitina+N+DIM+F+SG
quitinazinhas	quitina+N+DIM+F+PL
quitininha	quitina+N+DIM+F+SG
quitininhas	quitina+N+DIM+F+PL
quitinete	quitinete+N+F+SG
quitinetes	quitinete+N+F+PL
quitinetezinha	quitinete+N+DIM+F+SG
quitinetezinhas	quitinete+N+DIM+F+PL
quitinetinha	quitinete+N+DIM+F+SG
quitinetinhas	quitinete+N+DIM+F+PL
quitinosidade	quitinosidade+N+F+SG
quitinosidades	quitinosidade+N+F+PL
quitinosidadezinha	quitinosidade+N+DIM+F+SG
quitinosidadezinhas	quitinosidade+N+DIM+F+PL
quitinosidadinha	quitinosidade+N+DIM+F+SG
quitinosidadinhas	quitinosidade+N+DIM+F+PL
quitinoforinho	quitinóforo+N+DIM+M+SG
quitinoforinhos	quitinóforo+N+DIM+M+PL
quitinoforozinho	quitinóforo+N+DIM+M+SG
quitinoforozinhos	quitinóforo+N+DIM+M+PL
quitinóforo	quitinóforo+N+M+SG
quitinóforos	quitinóforo+N+M+PL
quitura	quitura+N+F+SG
quituras	quitura+N+F+PL
quiturazinha	quitura+N+DIM+F+SG
quiturazinhas	quitura+N+DIM+F+PL
quiturinha	quitura+N+DIM+F+SG
quiturinhas	quitura+N+DIM+F+PL
quitute	quitute+N+M+SG
quitutes	quitute+N+M+PL
quitutezinho	quitute+N+DIM+M+SG
quitutezinhos	quitute+N+DIM+M+PL
quitutinho	quitute+N+DIM+M+SG
quitutinhos	quitute+N+DIM+M+PL
quitão	quitão+N+M+SG
quitãozinho	quitão+N+DIM+M+SG
quitões	quitão+N+M+PL
quitõezinhos	quitão+N+DIM+M+PL
quitozinho	quitó+N+DIM+M+SG
quitozinhos	quitó+N+DIM+M+PL
quitó	quitó+N+M+SG
quitós	quitó+N+M+PL
quitonizinho	quitóni+N+DIM+M+SG
quitonizinhos	quitóni+N+DIM+M+PL
quitóni	quitóni+N+M+SG
quitónis	quitóni+N+M+PL
quitonizinho	quitôni+N+DIM+M+SG
quitonizinhos	quitôni+N+DIM+M+PL
quitôni	quitôni+N+M+SG
quitônis	quitôni+N+M+PL
quivi	quivi+N+M+SG
quivis	quivi+N+M+PL
quivizinho	quivi+N+DIM+M+SG
quivizinhos	quivi+N+DIM+M+PL
quixaba	quixaba+N+F+SG
quixabas	quixaba+N+F+PL
quixabazinha	quixaba+N+DIM+F+SG
quixabazinhas	quixaba+N+DIM+F+PL
quixabinha	quixaba+N+DIM+F+SG
quixabinhas	quixaba+N+DIM+F+PL
quixabeira	quixabeira+N+F+SG
quixabeiras	quixabeira+N+F+PL
quixabeirazinha	quixabeira+N+DIM+F+SG
quixabeirazinhas	quixabeira+N+DIM+F+PL
quixabeirinha	quixabeira+N+DIM+F+SG
quixabeirinhas	quixabeira+N+DIM+F+PL
quixotada	quixotada+N+F+SG
quixotadas	quixotada+N+F+PL
quixotadazinha	quixotada+N+DIM+F+SG
quixotadazinhas	quixotada+N+DIM+F+PL
quixotadinha	quixotada+N+DIM+F+SG
quixotadinhas	quixotada+N+DIM+F+PL
quixotice	quixotice+N+F+SG
quixotices	quixotice+N+F+PL
quixoticezinha	quixotice+N+DIM+F+SG
quixoticezinhas	quixotice+N+DIM+F+PL
quixoticinha	quixotice+N+DIM+F+SG
quixoticinhas	quixotice+N+DIM+F+PL
quixotisminho	quixotismo+N+DIM+M+SG
quixotisminhos	quixotismo+N+DIM+M+PL
quixotismo	quixotismo+N+M+SG
quixotismos	quixotismo+N+M+PL
quixotismozinho	quixotismo+N+DIM+M+SG
quixotismozinhos	quixotismo+N+DIM+M+PL
quizila	quizila+N+F+SG
quizilas	quizila+N+F+PL
quizilazinha	quizila+N+DIM+F+SG
quizilazinhas	quizila+N+DIM+F+PL
quizilinha	quizila+N+DIM+F+SG
quizilinhas	quizila+N+DIM+F+PL
quiziliazinha	quizília+N+DIM+F+SG
quiziliazinhas	quizília+N+DIM+F+PL
quizilinha	quizília+N+DIM+F+SG
quizilinhas	quizília+N+DIM+F+PL
quizília	quizília+N+F+SG
quizílias	quizília+N+F+PL
quialterazinha	quiáltera+N+DIM+F+SG
quialterazinhas	quiáltera+N+DIM+F+PL
quialterinha	quiáltera+N+DIM+F+SG
quialterinhas	quiáltera+N+DIM+F+PL
quiáltera	quiáltera+N+F+SG
quiálteras	quiáltera+N+F+PL
quiçaba	quiçaba+N+F+SG
quiçabas	quiçaba+N+F+PL
quiçabazinha	quiçaba+N+DIM+F+SG
quiçabazinhas	quiçaba+N+DIM+F+PL
quiçabinha	quiçaba+N+DIM+F+SG
quiçabinhas	quiçaba+N+DIM+F+PL
quiçamba	quiçamba+N+F+SG
quiçambas	quiçamba+N+F+PL
quiçambazinha	quiçamba+N+DIM+F+SG
quiçambazinhas	quiçamba+N+DIM+F+PL
quiçambinha	quiçamba+N+DIM+F+SG
quiçambinhas	quiçamba+N+DIM+F+PL
quiçamã	quiçamã+N+SG
quiçamãs	quiçamã+N+PL
quiçamãzinha	quiçamã+N+DIM+F+SG
quiçamãzinhas	quiçamã+N+DIM+F+PL
quiçamãzinho	quiçamã+N+DIM+M+SG
quiçamãzinhos	quiçamã+N+DIM+M+PL
quiçacinha	quiçaça+N+DIM+F+SG
quiçacinhas	quiçaça+N+DIM+F+PL
quiçaça	quiçaça+N+F+SG
quiçaças	quiçaça+N+F+PL
quiçaçazinha	quiçaça+N+DIM+F+SG
quiçaçazinhas	quiçaça+N+DIM+F+PL
quicinho	quiço+N+DIM+M+SG
quicinhos	quiço+N+DIM+M+PL
quiço	quiço+N+M+SG
quiços	quiço+N+M+PL
quiçozinho	quiço+N+DIM+M+SG
quiçozinhos	quiço+N+DIM+M+PL
quociente	quociente+N+M+SG
quocientes	quociente+N+M+PL
quocientezinho	quociente+N+DIM+M+SG
quocientezinhos	quociente+N+DIM+M+PL
quocientinho	quociente+N+DIM+M+SG
quocientinhos	quociente+N+DIM+M+PL
quodore	quodore+N+M+SG
quodores	quodore+N+M+PL
quodorezinho	quodore+N+DIM+M+SG
quodorezinhos	quodore+N+DIM+M+PL
quodorinho	quodore+N+DIM+M+SG
quodorinhos	quodore+N+DIM+M+PL
quodorzinhos	quodore+N+DIM+M+PL
quodorinho	quodório+N+DIM+M+SG
quodorinhos	quodório+N+DIM+M+PL
quodoriozinho	quodório+N+DIM+M+SG
quodoriozinhos	quodório+N+DIM+M+PL
quodório	quodório+N+M+SG
quodórios	quodório+N+M+PL
quorum	quorum+N+M+SG
quoruns	quorum+N+M+PL
quorunzinho	quorum+N+DIM+M+SG
quorunzinhos	quorum+N+DIM+M+PL
quota	quota+N+F+SG
quotas	quota+N+F+PL
quotazinha	quota+N+DIM+F+SG
quotazinhas	quota+N+DIM+F+PL
quotinha	quota+N+DIM+F+SG
quotinhas	quota+N+DIM+F+PL
quota-parte	quota-parte+N+F+SG
quota-partezinha	quota-parte+N+DIM+F+SG
quota-partinha	quota-parte+N+DIM+F+SG
quota-partinhas	quota-parte+N+DIM+F+PL
quotas-partes	quota-parte+N+F+PL
quotas-partezinhas	quota-parte+N+DIM+F+PL
quotidiana	quotidiano+N+F+SG
quotidianas	quotidiano+N+F+PL
quotidianazinha	quotidiano+N+DIM+F+SG
quotidianazinhas	quotidiano+N+DIM+F+PL
quotidianinha	quotidiano+N+DIM+F+SG
quotidianinhas	quotidiano+N+DIM+F+PL
quotidianinho	quotidiano+N+DIM+M+SG
quotidianinhos	quotidiano+N+DIM+M+PL
quotidiano	quotidiano+N+M+SG
quotidianos	quotidiano+N+M+PL
quotidianozinho	quotidiano+N+DIM+M+SG
quotidianozinhos	quotidiano+N+DIM+M+PL
quotiliquezinha	quotiliquê+N+DIM+F+SG
quotiliquezinhas	quotiliquê+N+DIM+F+PL
quotiliquezinho	quotiliquê+N+DIM+M+SG
quotiliquezinhos	quotiliquê+N+DIM+M+PL
quotiliquê	quotiliquê+N+SG
quotiliquês	quotiliquê+N+PL
quotizabilidade	quotizabilidade+N+F+SG
quotizabilidades	quotizabilidade+N+F+PL
quotizabilidadezinha	quotizabilidade+N+DIM+F+SG
quotizabilidadezinhas	quotizabilidade+N+DIM+F+PL
quotizabilidadinha	quotizabilidade+N+DIM+F+SG
quotizabilidadinhas	quotizabilidade+N+DIM+F+PL
quotização	quotização+N+F+SG
quotizaçãozinha	quotização+N+DIM+F+SG
quotizações	quotização+N+F+PL
quotizaçõezinhas	quotização+N+DIM+F+PL
quadricazinha	quádrica+N+DIM+F+SG
quadricazinhas	quádrica+N+DIM+F+PL
quadriquinha	quádrica+N+DIM+F+SG
quadriquinhas	quádrica+N+DIM+F+PL
quádrica	quádrica+N+F+SG
quádricas	quádrica+N+F+PL
quadrobrinho	quádrobro+N+DIM+M+SG
quadrobrinhos	quádrobro+N+DIM+M+PL
quadrobrozinho	quádrobro+N+DIM+M+SG
quadrobrozinhos	quádrobro+N+DIM+M+PL
quádrobro	quádrobro+N+M+SG
quádrobros	quádrobro+N+M+PL
quadruplinho	quádruplo+N+DIM+M+SG
quadruplinhos	quádruplo+N+DIM+M+PL
quadruplozinho	quádruplo+N+DIM+M+SG
quadruplozinhos	quádruplo+N+DIM+M+PL
quádruplo	quádruplo+N+M+SG
quádruplos	quádruplo+N+M+PL
quarticazinha	quártica+N+DIM+F+SG
quarticazinhas	quártica+N+DIM+F+PL
quartiquinha	quártica+N+DIM+F+SG
quartiquinhas	quártica+N+DIM+F+PL
quártica	quártica+N+F+SG
quárticas	quártica+N+F+PL
quassiazinha	quássia+N+DIM+F+SG
quassiazinhas	quássia+N+DIM+F+PL
quassinha	quássia+N+DIM+F+SG
quassinhas	quássia+N+DIM+F+PL
quássia	quássia+N+F+SG
quássias	quássia+N+F+PL
quepizinho	quépi+N+DIM+M+SG
quepizinhos	quépi+N+DIM+M+PL
quépi	quépi+N+M+SG
quépis	quépi+N+M+PL
quezinho	quê+N+DIM+M+SG
quezinhos	quê+N+DIM+M+PL
quê	quê+N+M+SG
quês	quê+N+M+PL
quichazinha	quícha+N+DIM+F+SG
quichazinhas	quícha+N+DIM+F+PL
quichazinho	quícha+N+DIM+M+SG
quichazinhos	quícha+N+DIM+M+PL
quichinha	quícha+N+DIM+SG
quichinhas	quícha+N+DIM+PL
quícha	quícha+N+SG
quíchas	quícha+N+PL
quichuazinha	quíchua+N+DIM+F+SG
quichuazinhas	quíchua+N+DIM+F+PL
quichuazinho	quíchua+N+DIM+M+SG
quichuazinhos	quíchua+N+DIM+M+PL
quichuinha	quíchua+N+DIM+SG
quichuinhas	quíchua+N+DIM+PL
quíchua	quíchua+N+SG
quíchuas	quíchua+N+PL
quicinho	quício+N+DIM+M+SG
quicinhos	quício+N+DIM+M+PL
quiciozinho	quício+N+DIM+M+SG
quiciozinhos	quício+N+DIM+M+PL
quício	quício+N+M+SG
quícios	quício+N+M+PL
quimicazinha	química+N+DIM+F+SG
quimicazinhas	química+N+DIM+F+PL
quimiquinha	química+N+DIM+F+SG
quimiquinhas	química+N+DIM+F+PL
química	química+N+F+SG
químicas	química+N+F+PL
quimicazinha	químico+N+DIM+F+SG
quimicazinhas	químico+N+DIM+F+PL
quimicozinho	químico+N+DIM+M+SG
quimicozinhos	químico+N+DIM+M+PL
quimiquinha	químico+N+DIM+F+SG
quimiquinhas	químico+N+DIM+F+PL
quimiquinho	químico+N+DIM+M+SG
quimiquinhos	químico+N+DIM+M+PL
química	químico+N+F+SG
químicas	químico+N+F+PL
químico	químico+N+M+SG
químicos	químico+N+M+PL
quininho	quínio+N+DIM+M+SG
quininhos	quínio+N+DIM+M+PL
quiniozinho	quínio+N+DIM+M+SG
quiniozinhos	quínio+N+DIM+M+PL
quínio	quínio+N+M+SG
quínios	quínio+N+M+PL
quintuplinho	quíntuplo+N+DIM+M+SG
quintuplinhos	quíntuplo+N+DIM+M+PL
quintuplozinho	quíntuplo+N+DIM+M+SG
quintuplozinhos	quíntuplo+N+DIM+M+PL
quíntuplo	quíntuplo+N+M+SG
quíntuplos	quíntuplo+N+M+PL
quiperezinhos	quíper+N+DIM+M+PL
quiperzinho	quíper+N+DIM+M+SG
quiperzinhos	quíper+N+DIM+M+PL
quíper	quíper+N+M+SG
quíperes	quíper+N+M+PL
quiscalinho	quíscalo+N+DIM+M+SG
quiscalinhos	quíscalo+N+DIM+M+PL
quiscalozinho	quíscalo+N+DIM+M+SG
quiscalozinhos	quíscalo+N+DIM+M+PL
quíscalo	quíscalo+N+M+SG
quíscalos	quíscalo+N+M+PL
quorunzinho	quórum+N+DIM+M+SG
quorunzinhos	quórum+N+DIM+M+PL
quórum	quórum+N+M+SG
quóruns	quórum+N+M+PL
qüingentesimazinha	qüingentésimo+N+DIM+F+SG
qüingentesimazinhas	qüingentésimo+N+DIM+F+PL
qüingentesiminha	qüingentésimo+N+DIM+F+SG
qüingentesiminhas	qüingentésimo+N+DIM+F+PL
qüingentesiminho	qüingentésimo+N+DIM+M+SG
qüingentesiminhos	qüingentésimo+N+DIM+M+PL
qüingentesimozinho	qüingentésimo+N+DIM+M+SG
qüingentesimozinhos	qüingentésimo+N+DIM+M+PL
qüingentésima	qüingentésimo+N+F+SG
qüingentésimas	qüingentésimo+N+F+PL
qüingentésimo	qüingentésimo+N+M+SG
qüingentésimos	qüingentésimo+N+M+PL
qüinquagesimazinha	qüinquagésimo+N+DIM+F+SG
qüinquagesimazinhas	qüinquagésimo+N+DIM+F+PL
qüinquagesiminha	qüinquagésimo+N+DIM+F+SG
qüinquagesiminhas	qüinquagésimo+N+DIM+F+PL
qüinquagesiminho	qüinquagésimo+N+DIM+M+SG
qüinquagesiminhos	qüinquagésimo+N+DIM+M+PL
qüinquagesimozinho	qüinquagésimo+N+DIM+M+SG
qüinquagesimozinhos	qüinquagésimo+N+DIM+M+PL
qüinquagésima	qüinquagésimo+N+F+SG
qüinquagésimas	qüinquagésimo+N+F+PL
qüinquagésimo	qüinquagésimo+N+M+SG
qüinquagésimos	qüinquagésimo+N+M+PL
qüinqüeangularidade	qüinqüeangularidade+N+F+SG
qüinqüeangularidades	qüinqüeangularidade+N+F+PL
qüinqüeangularidadezinha	qüinqüeangularidade+N+DIM+F+SG
qüinqüeangularidadezinhas	qüinqüeangularidade+N+DIM+F+PL
qüinqüeangularidadinha	qüinqüeangularidade+N+DIM+F+SG
qüinqüeangularidadinhas	qüinqüeangularidade+N+DIM+F+PL
qüinqüecapsularidade	qüinqüecapsularidade+N+F+SG
qüinqüecapsularidades	qüinqüecapsularidade+N+F+PL
qüinqüecapsularidadezinha	qüinqüecapsularidade+N+DIM+F+SG
qüinqüecapsularidadezinhas	qüinqüecapsularidade+N+DIM+F+PL
qüinqüecapsularidadinha	qüinqüecapsularidade+N+DIM+F+SG
qüinqüecapsularidadinhas	qüinqüecapsularidade+N+DIM+F+PL
qüinqüelocularidade	qüinqüelocularidade+N+F+SG
qüinqüelocularidades	qüinqüelocularidade+N+F+PL
qüinqüelocularidadezinha	qüinqüelocularidade+N+DIM+F+SG
qüinqüelocularidadezinhas	qüinqüelocularidade+N+DIM+F+PL
qüinqüelocularidadinha	qüinqüelocularidade+N+DIM+F+SG
qüinqüelocularidadinhas	qüinqüelocularidade+N+DIM+F+PL
qüinqüenalidade	qüinqüenalidade+N+F+SG
qüinqüenalidades	qüinqüenalidade+N+F+PL
qüinqüenalidadezinha	qüinqüenalidade+N+DIM+F+SG
qüinqüenalidadezinhas	qüinqüenalidade+N+DIM+F+PL
qüinqüenalidadinha	qüinqüenalidade+N+DIM+F+SG
qüinqüenalidadinhas	qüinqüenalidade+N+DIM+F+PL
qüinqüevalvularidade	qüinqüevalvularidade+N+F+SG
qüinqüevalvularidades	qüinqüevalvularidade+N+F+PL
qüinqüevalvularidadezinha	qüinqüevalvularidade+N+DIM+F+SG
qüinqüevalvularidadezinhas	qüinqüevalvularidade+N+DIM+F+PL
qüinqüevalvularidadinha	qüinqüevalvularidade+N+DIM+F+SG
qüinqüevalvularidadinhas	qüinqüevalvularidade+N+DIM+F+PL
qüinqüeviradinho	qüinqüevirado+N+DIM+M+SG
qüinqüeviradinhos	qüinqüevirado+N+DIM+M+PL
qüinqüevirado	qüinqüevirado+N+M+SG
qüinqüevirados	qüinqüevirado+N+M+PL
qüinqüeviradozinho	qüinqüevirado+N+DIM+M+SG
qüinqüeviradozinhos	qüinqüevirado+N+DIM+M+PL
qüinqüeviratinho	qüinqüevirato+N+DIM+M+SG
qüinqüeviratinhos	qüinqüevirato+N+DIM+M+PL
qüinqüevirato	qüinqüevirato+N+M+SG
qüinqüeviratos	qüinqüevirato+N+M+PL
qüinqüeviratozinho	qüinqüevirato+N+DIM+M+SG
qüinqüeviratozinhos	qüinqüevirato+N+DIM+M+PL
qüinqüeninho	qüinqüênio+N+DIM+M+SG
qüinqüeninhos	qüinqüênio+N+DIM+M+PL
qüinqüeniozinho	qüinqüênio+N+DIM+M+SG
qüinqüeniozinhos	qüinqüênio+N+DIM+M+PL
qüinqüênio	qüinqüênio+N+M+SG
qüinqüênios	qüinqüênio+N+M+PL
qüinqüidinho	qüinqüídio+N+DIM+M+SG
qüinqüidinhos	qüinqüídio+N+DIM+M+PL
qüinqüidiozinho	qüinqüídio+N+DIM+M+SG
qüinqüidiozinhos	qüinqüídio+N+DIM+M+PL
qüinqüídio	qüinqüídio+N+M+SG
qüinqüídios	qüinqüídio+N+M+PL
qüiproquozinho	qüiproquó+N+DIM+M+SG
qüiproquozinhos	qüiproquó+N+DIM+M+PL
qüiproquó	qüiproquó+N+M+SG
qüiproquós	qüiproquó+N+M+PL
