x	x+N+M+SG
xx	x+N+M+PL
xabandaria	xabandaria+N+F+SG
xabandarias	xabandaria+N+F+PL
xabandariazinha	xabandaria+N+DIM+F+SG
xabandariazinhas	xabandaria+N+DIM+F+PL
xabandarinha	xabandaria+N+DIM+F+SG
xabandarinhas	xabandaria+N+DIM+F+PL
xabariri	xabariri+N+M+SG
xabariris	xabariri+N+M+PL
xabaririzinho	xabariri+N+DIM+M+SG
xabaririzinhos	xabariri+N+DIM+M+PL
xabepa	xabepa+N+M+SG
xabepas	xabepa+N+M+PL
xabepazinho	xabepa+N+DIM+M+SG
xabepazinhos	xabepa+N+DIM+M+PL
xabepinha	xabepa+N+DIM+M+SG
xabepinhas	xabepa+N+DIM+M+PL
xaboco	xaboco+N+M+SG
xabocos	xaboco+N+M+PL
xabocozinho	xaboco+N+DIM+M+SG
xabocozinhos	xaboco+N+DIM+M+PL
xaboquinho	xaboco+N+DIM+M+SG
xaboquinhos	xaboco+N+DIM+M+PL
xabouqueira	xabouqueiro+N+F+SG
xabouqueiras	xabouqueiro+N+F+PL
xabouqueirazinha	xabouqueiro+N+DIM+F+SG
xabouqueirazinhas	xabouqueiro+N+DIM+F+PL
xabouqueirinha	xabouqueiro+N+DIM+F+SG
xabouqueirinhas	xabouqueiro+N+DIM+F+PL
xabouqueirinho	xabouqueiro+N+DIM+M+SG
xabouqueirinhos	xabouqueiro+N+DIM+M+PL
xabouqueiro	xabouqueiro+N+M+SG
xabouqueiros	xabouqueiro+N+M+PL
xabouqueirozinho	xabouqueiro+N+DIM+M+SG
xabouqueirozinhos	xabouqueiro+N+DIM+M+PL
xabraque	xabraque+N+M+SG
xabraques	xabraque+N+M+PL
xabraquezinho	xabraque+N+DIM+M+SG
xabraquezinhos	xabraque+N+DIM+M+PL
xabraquinho	xabraque+N+DIM+M+SG
xabraquinhos	xabraque+N+DIM+M+PL
xabrega	xabrega+N+F+SG
xabregas	xabrega+N+F+PL
xabregazinha	xabrega+N+DIM+F+SG
xabregazinhas	xabrega+N+DIM+F+PL
xabreguinha	xabrega+N+DIM+F+SG
xabreguinhas	xabrega+N+DIM+F+PL
xabandarezinhos	xabândar+N+DIM+M+PL
xabandarzinho	xabândar+N+DIM+M+SG
xabandarzinhos	xabândar+N+DIM+M+PL
xabândar	xabândar+N+M+SG
xabândares	xabândar+N+M+PL
xabanderezinhos	xabânder+N+DIM+M+PL
xabanderzinho	xabânder+N+DIM+M+SG
xabanderzinhos	xabânder+N+DIM+M+PL
xabânder	xabânder+N+M+SG
xabânderes	xabânder+N+M+PL
xacatuala	xacatuala+N+F+SG
xacatualas	xacatuala+N+F+PL
xacatualazinha	xacatuala+N+DIM+F+SG
xacatualazinhas	xacatuala+N+DIM+F+PL
xacatualinha	xacatuala+N+DIM+F+SG
xacatualinhas	xacatuala+N+DIM+F+PL
xaco	xaco+N+M+SG
xacos	xaco+N+M+PL
xacozinho	xaco+N+DIM+M+SG
xacozinhos	xaco+N+DIM+M+PL
xaquinho	xaco+N+DIM+M+SG
xaquinhos	xaco+N+DIM+M+PL
xacotinho	xacoto+N+DIM+M+SG
xacotinhos	xacoto+N+DIM+M+PL
xacoto	xacoto+N+M+SG
xacotos	xacoto+N+M+PL
xacotozinho	xacoto+N+DIM+M+SG
xacotozinhos	xacoto+N+DIM+M+PL
xacra	xacra+N+M+SG
xacras	xacra+N+M+PL
xacrazinho	xacra+N+DIM+M+SG
xacrazinhos	xacra+N+DIM+M+PL
xacrinha	xacra+N+DIM+M+SG
xacrinhas	xacra+N+DIM+M+PL
xador	xador+N+M+SG
xadora	xador+N+F+SG
xadoras	xador+N+F+PL
xadorazinha	xador+N+DIM+F+SG
xadorazinhas	xador+N+DIM+F+PL
xadores	xador+N+M+PL
xadorezinhos	xador+N+DIM+M+PL
xadorinha	xador+N+DIM+F+SG
xadorinhas	xador+N+DIM+F+PL
xadorzinho	xador+N+DIM+M+SG
xadorzinhos	xador+N+DIM+M+PL
xadrez	xadrez+N
xadrezes	xadrez+N+M+PL
xadrezezinhos	xadrez+N+DIM+M+PL
xadrezinha	xadrez+N+DIM+F+SG
xadrezinhas	xadrez+N+DIM+F+PL
xadrezinho	xadrez+N+DIM+M+SG
xadrezinhos	xadrez+N+DIM+M+PL
xadrezito	xadrez+N+DIM+M+SG
xadrezitos	xadrez+N+DIM+M+PL
xadrezista	xadrezista+N+SG
xadrezistas	xadrezista+N+PL
xadrezistazinha	xadrezista+N+DIM+F+SG
xadrezistazinhas	xadrezista+N+DIM+F+PL
xadrezistazinho	xadrezista+N+DIM+M+SG
xadrezistazinhos	xadrezista+N+DIM+M+PL
xadrezistinha	xadrezista+N+DIM+SG
xadrezistinhas	xadrezista+N+DIM+PL
xafarraz	xafarraz+N+M+SG
xafarrazes	xafarraz+N+M+PL
xafarrazezinhos	xafarraz+N+DIM+M+PL
xafarrazinho	xafarraz+N+DIM+M+SG
xafarrazinhos	xafarraz+N+DIM+M+PL
xaguão	xaguão+N+M+SG
xaguãozinho	xaguão+N+DIM+M+SG
xaguões	xaguão+N+M+PL
xaguõezinhos	xaguão+N+DIM+M+PL
xaia	xaia+N+F+SG
xaias	xaia+N+F+PL
xaiazinha	xaia+N+DIM+F+SG
xaiazinhas	xaia+N+DIM+F+PL
xainha	xaia+N+DIM+F+SG
xainhas	xaia+N+DIM+F+PL
xaile	xaile+N+M+SG
xailes	xaile+N+M+PL
xailezinho	xaile+N+DIM+M+SG
xailezinhos	xaile+N+DIM+M+PL
xailinho	xaile+N+DIM+M+SG
xailinhos	xaile+N+DIM+M+PL
xailemanta	xailemanta+N+F+SG
xailemantas	xailemanta+N+F+PL
xailemantazinha	xailemanta+N+DIM+F+SG
xailemantazinhas	xailemanta+N+DIM+F+PL
xailemantinha	xailemanta+N+DIM+F+SG
xailemantinhas	xailemanta+N+DIM+F+PL
xaimeis	xaimel+N+M+PL
xaimeizinhos	xaimel+N+DIM+M+PL
xaimel	xaimel+N+M+SG
xaimelzinho	xaimel+N+DIM+M+SG
xaiméis	xaimel+N+M+PL
xaimão	xaimão+N+M+SG
xaimãozinho	xaimão+N+DIM+M+SG
xaimões	xaimão+N+M+PL
xaimõezinhos	xaimão+N+DIM+M+PL
xaireis	xairel+N+M+PL
xaireizinhos	xairel+N+DIM+M+PL
xairel	xairel+N+M+SG
xairelzinho	xairel+N+DIM+M+SG
xairéis	xairel+N+M+PL
xais	xais+N+M+SG
xaises	xais+N+M+PL
xaisezinhos	xais+N+DIM+M+PL
xaisinho	xais+N+DIM+M+SG
xaisinhos	xais+N+DIM+M+PL
xaiazinha	xaiá+N+DIM+F+SG
xaiazinhas	xaiá+N+DIM+F+PL
xaiá	xaiá+N+F+SG
xaiás	xaiá+N+F+PL
xajazinha	xajá+N+DIM+F+SG
xajazinhas	xajá+N+DIM+F+PL
xajá	xajá+N+F+SG
xajás	xajá+N+F+PL
xalavar	xalavar+N+M+SG
xalavares	xalavar+N+M+PL
xalavarezinhos	xalavar+N+DIM+M+PL
xalavarzinho	xalavar+N+DIM+M+SG
xalavarzinhos	xalavar+N+DIM+M+PL
xale	xale+N+M+SG
xales	xale+N+M+PL
xalezinho	xale+N+DIM+M+SG
xalezinhos	xale+N+DIM+M+PL
xalezito	xale+N+DIM+M+SG
xalezitos	xale+N+DIM+M+PL
xalinho	xale+N+DIM+M+SG
xalinhos	xale+N+DIM+M+PL
xalemanta	xalemanta+N+M+SG
xalemantas	xalemanta+N+M+PL
xalemantazinho	xalemanta+N+DIM+M+SG
xalemantazinhos	xalemanta+N+DIM+M+PL
xalemantinha	xalemanta+N+DIM+M+SG
xalemantinhas	xalemanta+N+DIM+M+PL
xalmas	xalmas+N+F+PL
xalostocita	xalostocita+N+F+SG
xalostocitas	xalostocita+N+F+PL
xalostocitazinha	xalostocita+N+DIM+F+SG
xalostocitazinhas	xalostocita+N+DIM+F+PL
xalostocitinha	xalostocita+N+DIM+F+SG
xalostocitinhas	xalostocita+N+DIM+F+PL
xalostociticidade	xalostociticidade+N+F+SG
xalostociticidades	xalostociticidade+N+F+PL
xalostociticidadezinha	xalostociticidade+N+DIM+F+SG
xalostociticidadezinhas	xalostociticidade+N+DIM+F+PL
xalostociticidadinha	xalostociticidade+N+DIM+F+SG
xalostociticidadinhas	xalostociticidade+N+DIM+F+PL
xalostoquita	xalostoquita+N+F+SG
xalostoquitas	xalostoquita+N+F+PL
xalostoquitazinha	xalostoquita+N+DIM+F+SG
xalostoquitazinhas	xalostoquita+N+DIM+F+PL
xalostoquitinha	xalostoquita+N+DIM+F+SG
xalostoquitinhas	xalostoquita+N+DIM+F+PL
xalostoquiticidade	xalostoquiticidade+N+F+SG
xalostoquiticidades	xalostoquiticidade+N+F+PL
xalostoquiticidadezinha	xalostoquiticidade+N+DIM+F+SG
xalostoquiticidadezinhas	xalostoquiticidade+N+DIM+F+PL
xalostoquiticidadinha	xalostoquiticidade+N+DIM+F+SG
xalostoquiticidadinhas	xalostoquiticidade+N+DIM+F+PL
xama	xama+N+SG
xamas	xama+N+PL
xamazinha	xama+N+DIM+F+SG
xamazinhas	xama+N+DIM+F+PL
xamazinho	xama+N+DIM+M+SG
xamazinhos	xama+N+DIM+M+PL
xaminha	xama+N+DIM+SG
xaminhas	xama+N+DIM+PL
xamane	xamane+N+SG
xamanes	xamane+N+PL
xamanezinha	xamane+N+DIM+F+SG
xamanezinhas	xamane+N+DIM+F+PL
xamanezinho	xamane+N+DIM+M+SG
xamanezinhos	xamane+N+DIM+M+PL
xamaninha	xamane+N+DIM+F+SG
xamaninhas	xamane+N+DIM+F+PL
xamaninho	xamane+N+DIM+M+SG
xamaninhos	xamane+N+DIM+M+PL
xamanisminho	xamanismo+N+DIM+M+SG
xamanisminhos	xamanismo+N+DIM+M+PL
xamanismo	xamanismo+N+M+SG
xamanismos	xamanismo+N+M+PL
xamanismozinho	xamanismo+N+DIM+M+SG
xamanismozinhos	xamanismo+N+DIM+M+PL
xamanista	xamanista+N+SG
xamanistas	xamanista+N+PL
xamanistazinha	xamanista+N+DIM+F+SG
xamanistazinhas	xamanista+N+DIM+F+PL
xamanistazinho	xamanista+N+DIM+M+SG
xamanistazinhos	xamanista+N+DIM+M+PL
xamanistinha	xamanista+N+DIM+SG
xamanistinhas	xamanista+N+DIM+PL
xamanisticidade	xamanisticidade+N+F+SG
xamanisticidades	xamanisticidade+N+F+PL
xamanisticidadezinha	xamanisticidade+N+DIM+F+SG
xamanisticidadezinhas	xamanisticidade+N+DIM+F+PL
xamanisticidadinha	xamanisticidade+N+DIM+F+SG
xamanisticidadinhas	xamanisticidade+N+DIM+F+PL
xamata	xamata+N+F+SG
xamatas	xamata+N+F+PL
xamatazinha	xamata+N+DIM+F+SG
xamatazinhas	xamata+N+DIM+F+PL
xamatinha	xamata+N+DIM+F+SG
xamatinhas	xamata+N+DIM+F+PL
xamate	xamate+N+M+SG
xamates	xamate+N+M+PL
xamatezinho	xamate+N+DIM+M+SG
xamatezinhos	xamate+N+DIM+M+PL
xamatinho	xamate+N+DIM+M+SG
xamatinhos	xamate+N+DIM+M+PL
xambarezinho	xambaré+N+DIM+M+SG
xambarezinhos	xambaré+N+DIM+M+PL
xambaré	xambaré+N+M+SG
xambarés	xambaré+N+M+PL
xambuje	xambuje+N+M+SG
xambujes	xambuje+N+M+PL
xambujezinho	xambuje+N+DIM+M+SG
xambujezinhos	xambuje+N+DIM+M+PL
xambujinho	xambuje+N+DIM+M+SG
xambujinhos	xambuje+N+DIM+M+PL
xambazinho	xambá+N+DIM+M+SG
xambazinhos	xambá+N+DIM+M+PL
xambá	xambá+N+M+SG
xambás	xambá+N+M+PL
xampu	xampu+N+M+SG
xampus	xampu+N+M+PL
xampuzinho	xampu+N+DIM+M+SG
xampuzinhos	xampu+N+DIM+M+PL
xamã	xamã+N+SG
xamãs	xamã+N+PL
xamãzinha	xamã+N+DIM+F+SG
xamãzinhas	xamã+N+DIM+F+PL
xamãzinho	xamã+N+DIM+M+SG
xamãzinhos	xamã+N+DIM+M+PL
xandanga	xandanga+N+F+SG
xandangas	xandanga+N+F+PL
xandangazinha	xandanga+N+DIM+F+SG
xandangazinhas	xandanga+N+DIM+F+PL
xandanguinha	xandanga+N+DIM+F+SG
xandanguinhas	xandanga+N+DIM+F+PL
xangaense	xangaense+N+SG
xangaenses	xangaense+N+PL
xangaensezinha	xangaense+N+DIM+F+SG
xangaensezinhas	xangaense+N+DIM+F+PL
xangaensezinho	xangaense+N+DIM+M+SG
xangaensezinhos	xangaense+N+DIM+M+PL
xangaensinha	xangaense+N+DIM+F+SG
xangaensinhas	xangaense+N+DIM+F+PL
xangaensinho	xangaense+N+DIM+M+SG
xangaensinhos	xangaense+N+DIM+M+PL
xangaia	xangaia+N+F+SG
xangaias	xangaia+N+F+PL
xangaiazinha	xangaia+N+DIM+F+SG
xangaiazinhas	xangaia+N+DIM+F+PL
xangainha	xangaia+N+DIM+F+SG
xangainhas	xangaia+N+DIM+F+PL
xangaesazinha	xangaês+N+DIM+F+SG
xangaesazinhas	xangaês+N+DIM+F+PL
xangaesezinhos	xangaês+N+DIM+M+PL
xangaesinha	xangaês+N+DIM+F+SG
xangaesinhas	xangaês+N+DIM+F+PL
xangaesinho	xangaês+N+DIM+M+SG
xangaesinhos	xangaês+N+DIM+M+PL
xangaês	xangaês+N+M+SG
xangaêsa	xangaês+N+F+SG
xangaêsas	xangaês+N+F+PL
xangaêses	xangaês+N+M+PL
xangozinho	xangó+N+DIM+M+SG
xangozinhos	xangó+N+DIM+M+PL
xangó	xangó+N+M+SG
xangós	xangó+N+M+PL
xangozinho	xangô+N+DIM+M+SG
xangozinhos	xangô+N+DIM+M+PL
xangô	xangô+N+M+SG
xangôs	xangô+N+M+PL
xantalina	xantalina+N+F+SG
xantalinas	xantalina+N+F+PL
xantalinazinha	xantalina+N+DIM+F+SG
xantalinazinhas	xantalina+N+DIM+F+PL
xantalininha	xantalina+N+DIM+F+SG
xantalininhas	xantalina+N+DIM+F+PL
xantamidinho	xantamido+N+DIM+M+SG
xantamidinhos	xantamido+N+DIM+M+PL
xantamido	xantamido+N+M+SG
xantamidos	xantamido+N+M+PL
xantamidozinho	xantamido+N+DIM+M+SG
xantamidozinhos	xantamido+N+DIM+M+PL
xantamilicidade	xantamilicidade+N+F+SG
xantamilicidades	xantamilicidade+N+F+PL
xantamilicidadezinha	xantamilicidade+N+DIM+F+SG
xantamilicidadezinhas	xantamilicidade+N+DIM+F+PL
xantamilicidadinha	xantamilicidade+N+DIM+F+SG
xantamilicidadinhas	xantamilicidade+N+DIM+F+PL
xantarsenita	xantarsenita+N+F+SG
xantarsenitas	xantarsenita+N+F+PL
xantarsenitazinha	xantarsenita+N+DIM+F+SG
xantarsenitazinhas	xantarsenita+N+DIM+F+PL
xantarsenitinha	xantarsenita+N+DIM+F+SG
xantarsenitinhas	xantarsenita+N+DIM+F+PL
xantaticidade	xantaticidade+N+F+SG
xantaticidades	xantaticidade+N+F+PL
xantaticidadezinha	xantaticidade+N+DIM+F+SG
xantaticidadezinhas	xantaticidade+N+DIM+F+PL
xantaticidadinha	xantaticidade+N+DIM+F+SG
xantaticidadinhas	xantaticidade+N+DIM+F+PL
xantatinho	xantato+N+DIM+M+SG
xantatinhos	xantato+N+DIM+M+PL
xantato	xantato+N+M+SG
xantatos	xantato+N+M+PL
xantatozinho	xantato+N+DIM+M+SG
xantatozinhos	xantato+N+DIM+M+PL
xantazarina	xantazarina+N+F+SG
xantazarinas	xantazarina+N+F+PL
xantazarinazinha	xantazarina+N+DIM+F+SG
xantazarinazinhas	xantazarina+N+DIM+F+PL
xantazarininha	xantazarina+N+DIM+F+SG
xantazarininhas	xantazarina+N+DIM+F+PL
xantação	xantação+N+F+SG
xantaçãozinha	xantação+N+DIM+F+SG
xantações	xantação+N+F+PL
xantaçõezinhas	xantação+N+DIM+F+PL
xantelasma	xantelasma+N+M+SG
xantelasmas	xantelasma+N+M+PL
xantelasmazinho	xantelasma+N+DIM+M+SG
xantelasmazinhos	xantelasma+N+DIM+M+PL
xantelasminha	xantelasma+N+DIM+M+SG
xantelasminhas	xantelasma+N+DIM+M+PL
xanteloma	xanteloma+N+M+SG
xantelomas	xanteloma+N+M+PL
xantelomazinho	xanteloma+N+DIM+M+SG
xantelomazinhos	xanteloma+N+DIM+M+PL
xantelominha	xanteloma+N+DIM+M+SG
xantelominhas	xanteloma+N+DIM+M+PL
xantematina	xantematina+N+F+SG
xantematinas	xantematina+N+F+PL
xantematinazinha	xantematina+N+DIM+F+SG
xantematinazinhas	xantematina+N+DIM+F+PL
xantematininha	xantematina+N+DIM+F+SG
xantematininhas	xantematina+N+DIM+F+PL
xantemia	xantemia+N+F+SG
xantemias	xantemia+N+F+PL
xantemiazinha	xantemia+N+DIM+F+SG
xantemiazinhas	xantemia+N+DIM+F+PL
xanteminha	xantemia+N+DIM+F+SG
xanteminhas	xantemia+N+DIM+F+PL
xantemicidade	xantemicidade+N+F+SG
xantemicidades	xantemicidade+N+F+PL
xantemicidadezinha	xantemicidade+N+DIM+F+SG
xantemicidadezinhas	xantemicidade+N+DIM+F+PL
xantemicidadinha	xantemicidade+N+DIM+F+SG
xantemicidadinhas	xantemicidade+N+DIM+F+PL
xantena	xantena+N+F+SG
xantenas	xantena+N+F+PL
xantenazinha	xantena+N+DIM+F+SG
xantenazinhas	xantena+N+DIM+F+PL
xanteninha	xantena+N+DIM+F+SG
xanteninhas	xantena+N+DIM+F+PL
xanterina	xanterina+N+F+SG
xanterinas	xanterina+N+F+PL
xanterinazinha	xanterina+N+DIM+F+SG
xanterinazinhas	xanterina+N+DIM+F+PL
xanterininha	xanterina+N+DIM+F+SG
xanterininhas	xanterina+N+DIM+F+PL
xanteinazinha	xanteína+N+DIM+F+SG
xanteinazinhas	xanteína+N+DIM+F+PL
xanteininha	xanteína+N+DIM+F+SG
xanteininhas	xanteína+N+DIM+F+PL
xanteína	xanteína+N+F+SG
xanteínas	xanteína+N+F+PL
xanticidade	xanticidade+N+F+SG
xanticidades	xanticidade+N+F+PL
xanticidadezinha	xanticidade+N+DIM+F+SG
xanticidadezinhas	xanticidade+N+DIM+F+PL
xanticidadinha	xanticidade+N+DIM+F+SG
xanticidadinhas	xanticidade+N+DIM+F+PL
xantidase	xantidase+N+F+SG
xantidases	xantidase+N+F+PL
xantidasezinha	xantidase+N+DIM+F+SG
xantidasezinhas	xantidase+N+DIM+F+PL
xantidasinha	xantidase+N+DIM+F+SG
xantidasinhas	xantidase+N+DIM+F+PL
xantidrois	xantidrol+N+M+PL
xantidroizinhos	xantidrol+N+DIM+M+PL
xantidrol	xantidrol+N+M+SG
xantidrolzinho	xantidrol+N+DIM+M+SG
xantilicidade	xantilicidade+N+F+SG
xantilicidades	xantilicidade+N+F+PL
xantilicidadezinha	xantilicidade+N+DIM+F+SG
xantilicidadezinhas	xantilicidade+N+DIM+F+PL
xantilicidadinha	xantilicidade+N+DIM+F+SG
xantilicidadinhas	xantilicidade+N+DIM+F+PL
xantilina	xantilina+N+F+SG
xantilinas	xantilina+N+F+PL
xantilinazinha	xantilina+N+DIM+F+SG
xantilinazinhas	xantilina+N+DIM+F+PL
xantilininha	xantilina+N+DIM+F+SG
xantilininhas	xantilina+N+DIM+F+PL
xantina	xantina+N+F+SG
xantinas	xantina+N+F+PL
xantinazinha	xantina+N+DIM+F+SG
xantinazinhas	xantina+N+DIM+F+PL
xantininha	xantina+N+DIM+F+SG
xantininhas	xantina+N+DIM+F+PL
xantininho	xantino+N+DIM+M+SG
xantininhos	xantino+N+DIM+M+PL
xantino	xantino+N+M+SG
xantinos	xantino+N+M+PL
xantinozinho	xantino+N+DIM+M+SG
xantinozinhos	xantino+N+DIM+M+PL
xantinoxidase	xantinoxidase+N+F+SG
xantinoxidases	xantinoxidase+N+F+PL
xantinoxidasezinha	xantinoxidase+N+DIM+F+SG
xantinoxidasezinhas	xantinoxidase+N+DIM+F+PL
xantinoxidasinha	xantinoxidase+N+DIM+F+SG
xantinoxidasinhas	xantinoxidase+N+DIM+F+PL
xantinuria	xantinuria+N+F+SG
xantinurias	xantinuria+N+F+PL
xantinuriazinha	xantinuria+N+DIM+F+SG
xantinuriazinhas	xantinuria+N+DIM+F+PL
xantinurinha	xantinuria+N+DIM+F+SG
xantinurinhas	xantinuria+N+DIM+F+PL
xantinuricidade	xantinuricidade+N+F+SG
xantinuricidades	xantinuricidade+N+F+PL
xantinuricidadezinha	xantinuricidade+N+DIM+F+SG
xantinuricidadezinhas	xantinuricidade+N+DIM+F+PL
xantinuricidadinha	xantinuricidade+N+DIM+F+SG
xantinuricidadinhas	xantinuricidade+N+DIM+F+PL
xantiosita	xantiosita+N+F+SG
xantiositas	xantiosita+N+F+PL
xantiositazinha	xantiosita+N+DIM+F+SG
xantiositazinhas	xantiosita+N+DIM+F+PL
xantiositinha	xantiosita+N+DIM+F+SG
xantiositinhas	xantiosita+N+DIM+F+PL
xantipa	xantipa+N+F+SG
xantipas	xantipa+N+F+PL
xantipazinha	xantipa+N+DIM+F+SG
xantipazinhas	xantipa+N+DIM+F+PL
xantipinha	xantipa+N+DIM+F+SG
xantipinhas	xantipa+N+DIM+F+PL
xantisma	xantisma+N+F+SG
xantismas	xantisma+N+F+PL
xantismazinha	xantisma+N+DIM+F+SG
xantismazinhas	xantisma+N+DIM+F+PL
xantisminha	xantisma+N+DIM+F+SG
xantisminhas	xantisma+N+DIM+F+PL
xantita	xantita+N+F+SG
xantitas	xantita+N+F+PL
xantitazinha	xantita+N+DIM+F+SG
xantitazinhas	xantita+N+DIM+F+PL
xantitinha	xantita+N+DIM+F+SG
xantitinhas	xantita+N+DIM+F+PL
xantitaninho	xantitano+N+DIM+M+SG
xantitaninhos	xantitano+N+DIM+M+PL
xantitano	xantitano+N+M+SG
xantitanos	xantitano+N+M+PL
xantitanozinho	xantitano+N+DIM+M+SG
xantitanozinhos	xantitano+N+DIM+M+PL
xantinho	xanto+N+DIM+M+SG
xantinhos	xanto+N+DIM+M+PL
xanto	xanto+N+M+SG
xantos	xanto+N+M+PL
xantozinho	xanto+N+DIM+M+SG
xantozinhos	xanto+N+DIM+M+PL
xantoarsenite	xantoarsenite+N+F+SG
xantoarsenites	xantoarsenite+N+F+PL
xantoarsenitezinha	xantoarsenite+N+DIM+F+SG
xantoarsenitezinhas	xantoarsenite+N+DIM+F+PL
xantoarsenitinha	xantoarsenite+N+DIM+F+SG
xantoarsenitinhas	xantoarsenite+N+DIM+F+PL
xantocarotina	xantocarotina+N+F+SG
xantocarotinas	xantocarotina+N+F+PL
xantocarotinazinha	xantocarotina+N+DIM+F+SG
xantocarotinazinhas	xantocarotina+N+DIM+F+PL
xantocarotininha	xantocarotina+N+DIM+F+SG
xantocarotininhas	xantocarotina+N+DIM+F+PL
xantocianopsia	xantocianopsia+N+F+SG
xantocianopsias	xantocianopsia+N+F+PL
xantocianopsiazinha	xantocianopsia+N+DIM+F+SG
xantocianopsiazinhas	xantocianopsia+N+DIM+F+PL
xantocianopsinha	xantocianopsia+N+DIM+F+SG
xantocianopsinhas	xantocianopsia+N+DIM+F+PL
xantocistina	xantocistina+N+F+SG
xantocistinas	xantocistina+N+F+PL
xantocistinazinha	xantocistina+N+DIM+F+SG
xantocistinazinhas	xantocistina+N+DIM+F+PL
xantocistininha	xantocistina+N+DIM+F+SG
xantocistininhas	xantocistina+N+DIM+F+PL
xantoconitinho	xantoconito+N+DIM+M+SG
xantoconitinhos	xantoconito+N+DIM+M+PL
xantoconito	xantoconito+N+M+SG
xantoconitos	xantoconito+N+M+PL
xantoconitozinho	xantoconito+N+DIM+M+SG
xantoconitozinhos	xantoconito+N+DIM+M+PL
xantocreatina	xantocreatina+N+F+SG
xantocreatinas	xantocreatina+N+F+PL
xantocreatinazinha	xantocreatina+N+DIM+F+SG
xantocreatinazinhas	xantocreatina+N+DIM+F+PL
xantocreatininha	xantocreatina+N+DIM+F+SG
xantocreatininhas	xantocreatina+N+DIM+F+PL
xantocreatinina	xantocreatinina+N+F+SG
xantocreatininas	xantocreatinina+N+F+PL
xantocreatininazinha	xantocreatinina+N+DIM+F+SG
xantocreatininazinhas	xantocreatinina+N+DIM+F+PL
xantocreatinininha	xantocreatinina+N+DIM+F+SG
xantocreatinininhas	xantocreatinina+N+DIM+F+PL
xantocroia	xantocroia+N+F+SG
xantocroias	xantocroia+N+F+PL
xantocroiazinha	xantocroia+N+DIM+F+SG
xantocroiazinhas	xantocroia+N+DIM+F+PL
xantocroinha	xantocroia+N+DIM+F+SG
xantocroinhas	xantocroia+N+DIM+F+PL
xantocromaticidade	xantocromaticidade+N+F+SG
xantocromaticidades	xantocromaticidade+N+F+PL
xantocromaticidadezinha	xantocromaticidade+N+DIM+F+SG
xantocromaticidadezinhas	xantocromaticidade+N+DIM+F+PL
xantocromaticidadinha	xantocromaticidade+N+DIM+F+SG
xantocromaticidadinhas	xantocromaticidade+N+DIM+F+PL
xantocromia	xantocromia+N+F+SG
xantocromias	xantocromia+N+F+PL
xantocromiazinha	xantocromia+N+DIM+F+SG
xantocromiazinhas	xantocromia+N+DIM+F+PL
xantocrominha	xantocromia+N+DIM+F+SG
xantocrominhas	xantocromia+N+DIM+F+PL
xantocromicidade	xantocromicidade+N+F+SG
xantocromicidades	xantocromicidade+N+F+PL
xantocromicidadezinha	xantocromicidade+N+DIM+F+SG
xantocromicidadezinhas	xantocromicidade+N+DIM+F+PL
xantocromicidadinha	xantocromicidade+N+DIM+F+SG
xantocromicidadinhas	xantocromicidade+N+DIM+F+PL
xantodermia	xantodermia+N+F+SG
xantodermias	xantodermia+N+F+PL
xantodermiazinha	xantodermia+N+DIM+F+SG
xantodermiazinhas	xantodermia+N+DIM+F+PL
xantoderminha	xantodermia+N+DIM+F+SG
xantoderminhas	xantodermia+N+DIM+F+PL
xantodermicidade	xantodermicidade+N+F+SG
xantodermicidades	xantodermicidade+N+F+PL
xantodermicidadezinha	xantodermicidade+N+DIM+F+SG
xantodermicidadezinhas	xantodermicidade+N+DIM+F+PL
xantodermicidadinha	xantodermicidade+N+DIM+F+SG
xantodermicidadinhas	xantodermicidade+N+DIM+F+PL
xantodoncia	xantodoncia+N+F+SG
xantodoncias	xantodoncia+N+F+PL
xantodonciazinha	xantodoncia+N+DIM+F+SG
xantodonciazinhas	xantodoncia+N+DIM+F+PL
xantodoncinha	xantodoncia+N+DIM+F+SG
xantodoncinhas	xantodoncia+N+DIM+F+PL
xantofibroma	xantofibroma+N+F+SG
xantofibromas	xantofibroma+N+F+PL
xantofibromazinha	xantofibroma+N+DIM+F+SG
xantofibromazinhas	xantofibroma+N+DIM+F+PL
xantofibrominha	xantofibroma+N+DIM+F+SG
xantofibrominhas	xantofibroma+N+DIM+F+PL
xantofila	xantofila+N+F+SG
xantofilas	xantofila+N+F+PL
xantofilazinha	xantofila+N+DIM+F+SG
xantofilazinhas	xantofila+N+DIM+F+PL
xantofilinha	xantofila+N+DIM+F+SG
xantofilinhas	xantofila+N+DIM+F+PL
xantofilita	xantofilita+N+F+SG
xantofilitas	xantofilita+N+F+PL
xantofilitazinha	xantofilita+N+DIM+F+SG
xantofilitazinhas	xantofilita+N+DIM+F+PL
xantofilitinha	xantofilita+N+DIM+F+SG
xantofilitinhas	xantofilita+N+DIM+F+PL
xantofosia	xantofosia+N+F+SG
xantofosias	xantofosia+N+F+PL
xantofosiazinha	xantofosia+N+DIM+F+SG
xantofosiazinhas	xantofosia+N+DIM+F+PL
xantofosinha	xantofosia+N+DIM+F+SG
xantofosinhas	xantofosia+N+DIM+F+PL
xantofoticidade	xantofoticidade+N+F+SG
xantofoticidades	xantofoticidade+N+F+PL
xantofoticidadezinha	xantofoticidade+N+DIM+F+SG
xantofoticidadezinhas	xantofoticidade+N+DIM+F+PL
xantofoticidadinha	xantofoticidade+N+DIM+F+SG
xantofoticidadinhas	xantofoticidade+N+DIM+F+PL
xantoficeazinha	xantofícea+N+DIM+F+SG
xantoficeazinhas	xantofícea+N+DIM+F+PL
xantoficeinha	xantofícea+N+DIM+F+SG
xantoficeinhas	xantofícea+N+DIM+F+PL
xantofícea	xantofícea+N+F+SG
xantofíceas	xantofícea+N+F+PL
xantogenatinho	xantogenato+N+DIM+M+SG
xantogenatinhos	xantogenato+N+DIM+M+PL
xantogenato	xantogenato+N+M+SG
xantogenatos	xantogenato+N+M+PL
xantogenatozinho	xantogenato+N+DIM+M+SG
xantogenatozinhos	xantogenato+N+DIM+M+PL
xantogenicidade	xantogenicidade+N+F+SG
xantogenicidades	xantogenicidade+N+F+PL
xantogenicidadezinha	xantogenicidade+N+DIM+F+SG
xantogenicidadezinhas	xantogenicidade+N+DIM+F+PL
xantogenicidadinha	xantogenicidade+N+DIM+F+SG
xantogenicidadinhas	xantogenicidade+N+DIM+F+PL
xantoglobulina	xantoglobulina+N+F+SG
xantoglobulinas	xantoglobulina+N+F+PL
xantoglobulinazinha	xantoglobulina+N+DIM+F+SG
xantoglobulinazinhas	xantoglobulina+N+DIM+F+PL
xantoglobulininha	xantoglobulina+N+DIM+F+SG
xantoglobulininhas	xantoglobulina+N+DIM+F+PL
xantogeninho	xantogénio+N+DIM+M+SG
xantogeninhos	xantogénio+N+DIM+M+PL
xantogeniozinho	xantogénio+N+DIM+M+SG
xantogeniozinhos	xantogénio+N+DIM+M+PL
xantogénio	xantogénio+N+M+SG
xantogénios	xantogénio+N+M+PL
xantogeninho	xantogênio+N+DIM+M+SG
xantogeninhos	xantogênio+N+DIM+M+PL
xantogeniozinho	xantogênio+N+DIM+M+SG
xantogeniozinhos	xantogênio+N+DIM+M+PL
xantogênio	xantogênio+N+M+SG
xantogênios	xantogênio+N+M+PL
xantoleucitinho	xantoleucito+N+DIM+M+SG
xantoleucitinhos	xantoleucito+N+DIM+M+PL
xantoleucito	xantoleucito+N+M+SG
xantoleucitos	xantoleucito+N+M+PL
xantoleucitozinho	xantoleucito+N+DIM+M+SG
xantoleucitozinhos	xantoleucito+N+DIM+M+PL
xantolininho	xantolino+N+DIM+M+SG
xantolininhos	xantolino+N+DIM+M+PL
xantolino	xantolino+N+M+SG
xantolinos	xantolino+N+M+PL
xantolinozinho	xantolino+N+DIM+M+SG
xantolinozinhos	xantolino+N+DIM+M+PL
xantolita	xantolita+N+F+SG
xantolitas	xantolita+N+F+PL
xantolitazinha	xantolita+N+DIM+F+SG
xantolitazinhas	xantolita+N+DIM+F+PL
xantolitinha	xantolita+N+DIM+F+SG
xantolitinhas	xantolita+N+DIM+F+PL
xantoma	xantoma+N+M+SG
xantomas	xantoma+N+M+PL
xantomazinho	xantoma+N+DIM+M+SG
xantomazinhos	xantoma+N+DIM+M+PL
xantominha	xantoma+N+DIM+M+SG
xantominhas	xantoma+N+DIM+M+PL
xantomatose	xantomatose+N+F+SG
xantomatoses	xantomatose+N+F+PL
xantomatosezinha	xantomatose+N+DIM+F+SG
xantomatosezinhas	xantomatose+N+DIM+F+PL
xantomatosinha	xantomatose+N+DIM+F+SG
xantomatosinhas	xantomatose+N+DIM+F+PL
xantomatosicidade	xantomatosicidade+N+F+SG
xantomatosicidades	xantomatosicidade+N+F+PL
xantomatosicidadezinha	xantomatosicidade+N+DIM+F+SG
xantomatosicidadezinhas	xantomatosicidade+N+DIM+F+PL
xantomatosicidadinha	xantomatosicidade+N+DIM+F+SG
xantomatosicidadinhas	xantomatosicidade+N+DIM+F+PL
xantomatoticidade	xantomatoticidade+N+F+SG
xantomatoticidades	xantomatoticidade+N+F+PL
xantomatoticidadezinha	xantomatoticidade+N+DIM+F+SG
xantomatoticidadezinhas	xantomatoticidade+N+DIM+F+PL
xantomatoticidadinha	xantomatoticidade+N+DIM+F+SG
xantomatoticidadinhas	xantomatoticidade+N+DIM+F+PL
xantomonadina	xantomonadina+N+F+SG
xantomonadinas	xantomonadina+N+F+PL
xantomonadinazinha	xantomonadina+N+DIM+F+SG
xantomonadinazinhas	xantomonadina+N+DIM+F+PL
xantomonadininha	xantomonadina+N+DIM+F+SG
xantomonadininhas	xantomonadina+N+DIM+F+PL
xantona	xantona+N+F+SG
xantonas	xantona+N+F+PL
xantonazinha	xantona+N+DIM+F+SG
xantonazinhas	xantona+N+DIM+F+PL
xantoninha	xantona+N+DIM+F+SG
xantoninhas	xantona+N+DIM+F+PL
xantopicrina	xantopicrina+N+F+SG
xantopicrinas	xantopicrina+N+F+PL
xantopicrinazinha	xantopicrina+N+DIM+F+SG
xantopicrinazinhas	xantopicrina+N+DIM+F+PL
xantopicrininha	xantopicrina+N+DIM+F+SG
xantopicrininhas	xantopicrina+N+DIM+F+PL
xantopicritinho	xantopicrito+N+DIM+M+SG
xantopicritinhos	xantopicrito+N+DIM+M+PL
xantopicrito	xantopicrito+N+M+SG
xantopicritos	xantopicrito+N+M+PL
xantopicritozinho	xantopicrito+N+DIM+M+SG
xantopicritozinhos	xantopicrito+N+DIM+M+PL
xantopirita	xantopirita+N+F+SG
xantopiritas	xantopirita+N+F+PL
xantopiritazinha	xantopirita+N+DIM+F+SG
xantopiritazinhas	xantopirita+N+DIM+F+PL
xantopiritinha	xantopirita+N+DIM+F+SG
xantopiritinhas	xantopirita+N+DIM+F+PL
xantoplasma	xantoplasma+N+M+SG
xantoplasmas	xantoplasma+N+M+PL
xantoplasmazinho	xantoplasma+N+DIM+M+SG
xantoplasmazinhos	xantoplasma+N+DIM+M+PL
xantoplasminha	xantoplasma+N+DIM+M+SG
xantoplasminhas	xantoplasma+N+DIM+M+PL
xantoplastidinho	xantoplastídio+N+DIM+M+SG
xantoplastidinhos	xantoplastídio+N+DIM+M+PL
xantoplastidiozinho	xantoplastídio+N+DIM+M+SG
xantoplastidiozinhos	xantoplastídio+N+DIM+M+PL
xantoplastídio	xantoplastídio+N+M+SG
xantoplastídios	xantoplastídio+N+M+PL
xantoproteinazinha	xantoproteína+N+DIM+F+SG
xantoproteinazinhas	xantoproteína+N+DIM+F+PL
xantoproteininha	xantoproteína+N+DIM+F+SG
xantoproteininhas	xantoproteína+N+DIM+F+PL
xantoproteína	xantoproteína+N+F+SG
xantoproteínas	xantoproteína+N+F+PL
xantopse	xantopse+N+F+SG
xantopses	xantopse+N+F+PL
xantopsezinha	xantopse+N+DIM+F+SG
xantopsezinhas	xantopse+N+DIM+F+PL
xantopsinha	xantopse+N+DIM+F+SG
xantopsinhas	xantopse+N+DIM+F+PL
xantopsia	xantopsia+N+F+SG
xantopsias	xantopsia+N+F+PL
xantopsiazinha	xantopsia+N+DIM+F+SG
xantopsiazinhas	xantopsia+N+DIM+F+PL
xantopsinha	xantopsia+N+DIM+F+SG
xantopsinhas	xantopsia+N+DIM+F+PL
xantopsidracia	xantopsidracia+N+F+SG
xantopsidracias	xantopsidracia+N+F+PL
xantopsidraciazinha	xantopsidracia+N+DIM+F+SG
xantopsidraciazinhas	xantopsidracia+N+DIM+F+PL
xantopsidracinha	xantopsidracia+N+DIM+F+SG
xantopsidracinhas	xantopsidracia+N+DIM+F+PL
xantopsidracicidade	xantopsidracicidade+N+F+SG
xantopsidracicidades	xantopsidracicidade+N+F+PL
xantopsidracicidadezinha	xantopsidracicidade+N+DIM+F+SG
xantopsidracicidadezinhas	xantopsidracicidade+N+DIM+F+PL
xantopsidracicidadinha	xantopsidracicidade+N+DIM+F+SG
xantopsidracicidadinhas	xantopsidracicidade+N+DIM+F+PL
xantopsina	xantopsina+N+F+SG
xantopsinas	xantopsina+N+F+PL
xantopsinazinha	xantopsina+N+DIM+F+SG
xantopsinazinhas	xantopsina+N+DIM+F+PL
xantopsininha	xantopsina+N+DIM+F+SG
xantopsininhas	xantopsina+N+DIM+F+PL
xantopterina	xantopterina+N+F+SG
xantopterinas	xantopterina+N+F+PL
xantopterinazinha	xantopterina+N+DIM+F+SG
xantopterinazinhas	xantopterina+N+DIM+F+PL
xantopterininha	xantopterina+N+DIM+F+SG
xantopterininhas	xantopterina+N+DIM+F+PL
xantopticidade	xantopticidade+N+F+SG
xantopticidades	xantopticidade+N+F+PL
xantopticidadezinha	xantopticidade+N+DIM+F+SG
xantopticidadezinhas	xantopticidade+N+DIM+F+PL
xantopticidadinha	xantopticidade+N+DIM+F+SG
xantopticidadinhas	xantopticidade+N+DIM+F+PL
xantopucina	xantopucina+N+F+SG
xantopucinas	xantopucina+N+F+PL
xantopucinazinha	xantopucina+N+DIM+F+SG
xantopucinazinhas	xantopucina+N+DIM+F+PL
xantopucininha	xantopucina+N+DIM+F+SG
xantopucininhas	xantopucina+N+DIM+F+PL
xantopurpurina	xantopurpurina+N+F+SG
xantopurpurinas	xantopurpurina+N+F+PL
xantopurpurinazinha	xantopurpurina+N+DIM+F+SG
xantopurpurinazinhas	xantopurpurina+N+DIM+F+PL
xantopurpurininha	xantopurpurina+N+DIM+F+SG
xantopurpurininhas	xantopurpurina+N+DIM+F+PL
xantoquiminho	xantoquimo+N+DIM+M+SG
xantoquiminhos	xantoquimo+N+DIM+M+PL
xantoquimo	xantoquimo+N+M+SG
xantoquimos	xantoquimo+N+M+PL
xantoquimozinho	xantoquimo+N+DIM+M+SG
xantoquimozinhos	xantoquimo+N+DIM+M+PL
xantorramnina	xantorramnina+N+F+SG
xantorramninas	xantorramnina+N+F+PL
xantorramninazinha	xantorramnina+N+DIM+F+SG
xantorramninazinhas	xantorramnina+N+DIM+F+PL
xantorramnininha	xantorramnina+N+DIM+F+SG
xantorramnininhas	xantorramnina+N+DIM+F+PL
xantorreia	xantorreia+N+F+SG
xantorreias	xantorreia+N+F+PL
xantorreiazinha	xantorreia+N+DIM+F+SG
xantorreiazinhas	xantorreia+N+DIM+F+PL
xantorreinha	xantorreia+N+DIM+F+SG
xantorreinhas	xantorreia+N+DIM+F+PL
xantortitinho	xantortito+N+DIM+M+SG
xantortitinhos	xantortito+N+DIM+M+PL
xantortito	xantortito+N+M+SG
xantortitos	xantortito+N+M+PL
xantortitozinho	xantortito+N+DIM+M+SG
xantortitozinhos	xantortito+N+DIM+M+PL
xantose	xantose+N+F+SG
xantoses	xantose+N+F+PL
xantosezinha	xantose+N+DIM+F+SG
xantosezinhas	xantose+N+DIM+F+PL
xantosinha	xantose+N+DIM+F+SG
xantosinhas	xantose+N+DIM+F+PL
xantosia	xantosia+N+F+SG
xantosias	xantosia+N+F+PL
xantosiazinha	xantosia+N+DIM+F+SG
xantosiazinhas	xantosia+N+DIM+F+PL
xantosinha	xantosia+N+DIM+F+SG
xantosinhas	xantosia+N+DIM+F+PL
xantosidade	xantosidade+N+F+SG
xantosidades	xantosidade+N+F+PL
xantosidadezinha	xantosidade+N+DIM+F+SG
xantosidadezinhas	xantosidade+N+DIM+F+PL
xantosidadinha	xantosidade+N+DIM+F+SG
xantosidadinhas	xantosidade+N+DIM+F+PL
xantossarcoma	xantossarcoma+N+M+SG
xantossarcomas	xantossarcoma+N+M+PL
xantossarcomazinho	xantossarcoma+N+DIM+M+SG
xantossarcomazinhos	xantossarcoma+N+DIM+M+PL
xantossarcominha	xantossarcoma+N+DIM+M+SG
xantossarcominhas	xantossarcoma+N+DIM+M+PL
xantossideritinho	xantossiderito+N+DIM+M+SG
xantossideritinhos	xantossiderito+N+DIM+M+PL
xantossiderito	xantossiderito+N+M+SG
xantossideritos	xantossiderito+N+M+PL
xantossideritozinho	xantossiderito+N+DIM+M+SG
xantossideritozinhos	xantossiderito+N+DIM+M+PL
xantossoma	xantossoma+N+M+SG
xantossomas	xantossoma+N+M+PL
xantossomazinho	xantossoma+N+DIM+M+SG
xantossomazinhos	xantossoma+N+DIM+M+PL
xantossominha	xantossoma+N+DIM+M+SG
xantossominhas	xantossoma+N+DIM+M+PL
xantostromina	xantostromina+N+F+SG
xantostrominas	xantostromina+N+F+PL
xantostrominazinha	xantostromina+N+DIM+F+SG
xantostrominazinhas	xantostromina+N+DIM+F+PL
xantostromininha	xantostromina+N+DIM+F+SG
xantostromininhas	xantostromina+N+DIM+F+PL
xantoxilaceazinha	xantoxilácea+N+DIM+F+SG
xantoxilaceazinhas	xantoxilácea+N+DIM+F+PL
xantoxilaceinha	xantoxilácea+N+DIM+F+SG
xantoxilaceinhas	xantoxilácea+N+DIM+F+PL
xantoxilácea	xantoxilácea+N+F+SG
xantoxiláceas	xantoxilácea+N+F+PL
xantoxileazinha	xantoxílea+N+DIM+F+SG
xantoxileazinhas	xantoxílea+N+DIM+F+PL
xantoxileinha	xantoxílea+N+DIM+F+SG
xantoxileinhas	xantoxílea+N+DIM+F+PL
xantoxílea	xantoxílea+N+F+SG
xantoxíleas	xantoxílea+N+F+PL
xantungue	xantungue+N+M+SG
xantungues	xantungue+N+M+PL
xantunguezinho	xantungue+N+DIM+M+SG
xantunguezinhos	xantungue+N+DIM+M+PL
xantunguinho	xantungue+N+DIM+M+SG
xantunguinhos	xantungue+N+DIM+M+PL
xanturia	xanturia+N+F+SG
xanturias	xanturia+N+F+PL
xanturiazinha	xanturia+N+DIM+F+SG
xanturiazinhas	xanturia+N+DIM+F+PL
xanturinha	xanturia+N+DIM+F+SG
xanturinhas	xanturia+N+DIM+F+PL
xantidinho	xantídio+N+DIM+M+SG
xantidinhos	xantídio+N+DIM+M+PL
xantidiozinho	xantídio+N+DIM+M+SG
xantidiozinhos	xantídio+N+DIM+M+PL
xantídio	xantídio+N+M+SG
xantídios	xantídio+N+M+PL
xantinonzinho	xantínon+N+DIM+M+SG
xantinonzinhos	xantínon+N+DIM+M+PL
xantínon	xantínon+N+M+SG
xantínons	xantínon+N+M+PL
xantocerazinha	xantócera+N+DIM+F+SG
xantocerazinhas	xantócera+N+DIM+F+PL
xantocerinha	xantócera+N+DIM+F+SG
xantocerinhas	xantócera+N+DIM+F+PL
xantócera	xantócera+N+F+SG
xantóceras	xantócera+N+F+PL
xantocominho	xantócomo+N+DIM+M+SG
xantocominhos	xantócomo+N+DIM+M+PL
xantocomozinho	xantócomo+N+DIM+M+SG
xantocomozinhos	xantócomo+N+DIM+M+PL
xantócomo	xantócomo+N+M+SG
xantócomos	xantócomo+N+M+PL
xantoforinho	xantóforo+N+DIM+M+SG
xantoforinhos	xantóforo+N+DIM+M+PL
xantoforozinho	xantóforo+N+DIM+M+SG
xantoforozinhos	xantóforo+N+DIM+M+PL
xantóforo	xantóforo+N+M+SG
xantóforos	xantóforo+N+M+PL
xantogeninho	xantógeno+N+DIM+M+SG
xantogeninhos	xantógeno+N+DIM+M+PL
xantogenozinho	xantógeno+N+DIM+M+SG
xantogenozinhos	xantógeno+N+DIM+M+PL
xantógeno	xantógeno+N+M+SG
xantógenos	xantógeno+N+M+PL
xantolitinho	xantólito+N+DIM+M+SG
xantolitinhos	xantólito+N+DIM+M+PL
xantolitozinho	xantólito+N+DIM+M+SG
xantolitozinhos	xantólito+N+DIM+M+PL
xantólito	xantólito+N+M+SG
xantólitos	xantólito+N+M+PL
xanturiazinha	xantúria+N+DIM+F+SG
xanturiazinhas	xantúria+N+DIM+F+PL
xanturinha	xantúria+N+DIM+F+SG
xanturinhas	xantúria+N+DIM+F+PL
xantúria	xantúria+N+F+SG
xantúrias	xantúria+N+F+PL
xaorozinho	xaorô+N+DIM+M+SG
xaorozinhos	xaorô+N+DIM+M+PL
xaorô	xaorô+N+M+SG
xaorôs	xaorô+N+M+PL
xapanã	xapanã+N+M+SG
xapanãs	xapanã+N+M+PL
xapanãzinho	xapanã+N+DIM+M+SG
xapanãzinhos	xapanã+N+DIM+M+PL
xaponã	xaponã+N+M+SG
xaponãs	xaponã+N+M+PL
xaponãzinho	xaponã+N+DIM+M+SG
xaponãzinhos	xaponã+N+DIM+M+PL
xaputa	xaputa+N+F+SG
xaputas	xaputa+N+F+PL
xaputazinha	xaputa+N+DIM+F+SG
xaputazinhas	xaputa+N+DIM+F+PL
xaputinha	xaputa+N+DIM+F+SG
xaputinhas	xaputa+N+DIM+F+PL
xaque	xaque+N+M+SG
xaques	xaque+N+M+PL
xaquezinho	xaque+N+DIM+M+SG
xaquezinhos	xaque+N+DIM+M+PL
xaquinho	xaque+N+DIM+M+SG
xaquinhos	xaque+N+DIM+M+PL
xara	xara+N+F+SG
xaras	xara+N+F+PL
xarazinha	xara+N+DIM+F+SG
xarazinhas	xara+N+DIM+F+PL
xarinha	xara+N+DIM+F+SG
xarinhas	xara+N+DIM+F+PL
xarada	xarada+N+F+SG
xaradas	xarada+N+F+PL
xaradazinha	xarada+N+DIM+F+SG
xaradazinhas	xarada+N+DIM+F+PL
xaradinha	xarada+N+DIM+F+SG
xaradinhas	xarada+N+DIM+F+PL
xarafim	xarafim+N+M+SG
xarafins	xarafim+N+M+PL
xarafinzinho	xarafim+N+DIM+M+SG
xarafinzinhos	xarafim+N+DIM+M+PL
xarafa	xarafo+N+F+SG
xarafas	xarafo+N+F+PL
xarafazinha	xarafo+N+DIM+F+SG
xarafazinhas	xarafo+N+DIM+F+PL
xarafinha	xarafo+N+DIM+F+SG
xarafinhas	xarafo+N+DIM+F+PL
xarafinho	xarafo+N+DIM+M+SG
xarafinhos	xarafo+N+DIM+M+PL
xarafo	xarafo+N+M+SG
xarafos	xarafo+N+M+PL
xarafozinho	xarafo+N+DIM+M+SG
xarafozinhos	xarafo+N+DIM+M+PL
xarapa	xarapa+N+SG
xarapas	xarapa+N+PL
xarapazinha	xarapa+N+DIM+F+SG
xarapazinhas	xarapa+N+DIM+F+PL
xarapazinho	xarapa+N+DIM+M+SG
xarapazinhos	xarapa+N+DIM+M+PL
xarapinha	xarapa+N+DIM+SG
xarapinhas	xarapa+N+DIM+PL
xarau	xarau+N+M+SG
xaraus	xarau+N+M+PL
xarauzinho	xarau+N+DIM+M+SG
xarauzinhos	xarau+N+DIM+M+PL
xarda	xarda+N+F+SG
xardas	xarda+N+F+PL
xardazinha	xarda+N+DIM+F+SG
xardazinhas	xarda+N+DIM+F+PL
xardinha	xarda+N+DIM+F+SG
xardinhas	xarda+N+DIM+F+PL
xardosidade	xardosidade+N+F+SG
xardosidades	xardosidade+N+F+PL
xardosidadezinha	xardosidade+N+DIM+F+SG
xardosidadezinhas	xardosidade+N+DIM+F+PL
xardosidadinha	xardosidade+N+DIM+F+SG
xardosidadinhas	xardosidade+N+DIM+F+PL
xareis	xarel+N+M+PL
xareizinhos	xarel+N+DIM+M+PL
xarel	xarel+N+M+SG
xarelzinho	xarel+N+DIM+M+SG
xaréis	xarel+N+M+PL
xarelete	xarelete+N+M+SG
xareletes	xarelete+N+M+PL
xareletezinho	xarelete+N+DIM+M+SG
xareletezinhos	xarelete+N+DIM+M+PL
xareletinho	xarelete+N+DIM+M+SG
xareletinhos	xarelete+N+DIM+M+PL
xareta	xareta+N+F+SG
xaretas	xareta+N+F+PL
xaretazinha	xareta+N+DIM+F+SG
xaretazinhas	xareta+N+DIM+F+PL
xaretinha	xareta+N+DIM+F+SG
xaretinhas	xareta+N+DIM+F+PL
xarifadinho	xarifado+N+DIM+M+SG
xarifadinhos	xarifado+N+DIM+M+PL
xarifado	xarifado+N+M+SG
xarifados	xarifado+N+M+PL
xarifadozinho	xarifado+N+DIM+M+SG
xarifadozinhos	xarifado+N+DIM+M+PL
xarife	xarife+N+M+SG
xarifes	xarife+N+M+PL
xarifezinho	xarife+N+DIM+M+SG
xarifezinhos	xarife+N+DIM+M+PL
xarifinho	xarife+N+DIM+M+SG
xarifinhos	xarife+N+DIM+M+PL
xaroco	xaroco+N+M+SG
xarocos	xaroco+N+M+PL
xarocozinho	xaroco+N+DIM+M+SG
xarocozinhos	xaroco+N+DIM+M+PL
xaroquinho	xaroco+N+DIM+M+SG
xaroquinhos	xaroco+N+DIM+M+PL
xaropada	xaropada+N+F+SG
xaropadas	xaropada+N+F+PL
xaropadazinha	xaropada+N+DIM+F+SG
xaropadazinhas	xaropada+N+DIM+F+PL
xaropadinha	xaropada+N+DIM+F+SG
xaropadinhas	xaropada+N+DIM+F+PL
xarope	xarope+N+M+SG
xaropes	xarope+N+M+PL
xaropezinho	xarope+N+DIM+M+SG
xaropezinhos	xarope+N+DIM+M+PL
xaropinho	xarope+N+DIM+M+SG
xaropinhos	xarope+N+DIM+M+PL
xaroposidade	xaroposidade+N+F+SG
xaroposidades	xaroposidade+N+F+PL
xaroposidadezinha	xaroposidade+N+DIM+F+SG
xaroposidadezinhas	xaroposidade+N+DIM+F+PL
xaroposidadinha	xaroposidade+N+DIM+F+SG
xaroposidadinhas	xaroposidade+N+DIM+F+PL
xarrasca	xarrasca+N+F+SG
xarrascas	xarrasca+N+F+PL
xarrascazinha	xarrasca+N+DIM+F+SG
xarrascazinhas	xarrasca+N+DIM+F+PL
xarrasquinha	xarrasca+N+DIM+F+SG
xarrasquinhas	xarrasca+N+DIM+F+PL
xarroco	xarroco+N+M+SG
xarrocos	xarroco+N+M+PL
xarrocozinho	xarroco+N+DIM+M+SG
xarrocozinhos	xarroco+N+DIM+M+PL
xarroquinho	xarroco+N+DIM+M+SG
xarroquinhos	xarroco+N+DIM+M+PL
xaru	xaru+N+M+SG
xarus	xaru+N+M+PL
xaruzinho	xaru+N+DIM+M+SG
xaruzinhos	xaru+N+DIM+M+PL
xarazinha	xará+N+DIM+F+SG
xarazinhas	xará+N+DIM+F+PL
xarazinho	xará+N+DIM+M+SG
xarazinhos	xará+N+DIM+M+PL
xará	xará+N+SG
xarás	xará+N+PL
xarenzinho	xarém+N+DIM+M+SG
xarenzinhos	xarém+N+DIM+M+PL
xarém	xarém+N+M+SG
xaréns	xarém+N+M+PL
xareuzinho	xaréu+N+DIM+M+SG
xareuzinhos	xaréu+N+DIM+M+PL
xaréu	xaréu+N+M+SG
xaréus	xaréu+N+M+PL
xate	xate+N+M+SG
xates	xate+N+M+PL
xatezinho	xate+N+DIM+M+SG
xatezinhos	xate+N+DIM+M+PL
xatinho	xate+N+DIM+M+SG
xatinhos	xate+N+DIM+M+PL
xauim	xauim+N+M+SG
xauins	xauim+N+M+PL
xauinzinho	xauim+N+DIM+M+SG
xauinzinhos	xauim+N+DIM+M+PL
xauter	xauter+N+M+SG
xauteres	xauter+N+M+PL
xauterezinhos	xauter+N+DIM+M+PL
xauterzinho	xauter+N+DIM+M+SG
xauterzinhos	xauter+N+DIM+M+PL
xavante	xavante+N+SG
xavantes	xavante+N+PL
xavantezinha	xavante+N+DIM+F+SG
xavantezinhas	xavante+N+DIM+F+PL
xavantezinho	xavante+N+DIM+M+SG
xavantezinhos	xavante+N+DIM+M+PL
xavantinha	xavante+N+DIM+F+SG
xavantinhas	xavante+N+DIM+F+PL
xavantinho	xavante+N+DIM+M+SG
xavantinhos	xavante+N+DIM+M+PL
xavantinense	xavantinense+N+SG
xavantinenses	xavantinense+N+PL
xavantinensezinha	xavantinense+N+DIM+F+SG
xavantinensezinhas	xavantinense+N+DIM+F+PL
xavantinensezinho	xavantinense+N+DIM+M+SG
xavantinensezinhos	xavantinense+N+DIM+M+PL
xavantinensinha	xavantinense+N+DIM+F+SG
xavantinensinhas	xavantinense+N+DIM+F+PL
xavantinensinho	xavantinense+N+DIM+M+SG
xavantinensinhos	xavantinense+N+DIM+M+PL
xaveco	xaveco+N+M+SG
xavecos	xaveco+N+M+PL
xavecozinho	xaveco+N+DIM+M+SG
xavecozinhos	xaveco+N+DIM+M+PL
xavequinho	xaveco+N+DIM+M+SG
xavequinhos	xaveco+N+DIM+M+PL
xaxadinho	xaxado+N+DIM+M+SG
xaxadinhos	xaxado+N+DIM+M+PL
xaxado	xaxado+N+M+SG
xaxados	xaxado+N+M+PL
xaxadozinho	xaxado+N+DIM+M+SG
xaxadozinhos	xaxado+N+DIM+M+PL
xaxarazinho	xaxará+N+DIM+M+SG
xaxarazinhos	xaxará+N+DIM+M+PL
xaxará	xaxará+N+M+SG
xaxarás	xaxará+N+M+PL
xaxim	xaxim+N+M+SG
xaxins	xaxim+N+M+PL
xaxinzinho	xaxim+N+DIM+M+SG
xaxinzinhos	xaxim+N+DIM+M+PL
xaizinho	xaí+N+DIM+M+SG
xaizinhos	xaí+N+DIM+M+PL
xaí	xaí+N+M+SG
xaís	xaí+N+M+PL
xecadinho	xecado+N+DIM+M+SG
xecadinhos	xecado+N+DIM+M+PL
xecado	xecado+N+M+SG
xecados	xecado+N+M+PL
xecadozinho	xecado+N+DIM+M+SG
xecadozinhos	xecado+N+DIM+M+PL
xeique	xeique+N+M+SG
xeiques	xeique+N+M+PL
xeiquezinho	xeique+N+DIM+M+SG
xeiquezinhos	xeique+N+DIM+M+PL
xeiquinho	xeique+N+DIM+M+SG
xeiquinhos	xeique+N+DIM+M+PL
xelim	xelim+N+M+SG
xelins	xelim+N+M+PL
xelinzinho	xelim+N+DIM+M+SG
xelinzinhos	xelim+N+DIM+M+PL
xelindrozinho	xelindró+N+DIM+M+SG
xelindrozinhos	xelindró+N+DIM+M+PL
xelindró	xelindró+N+M+SG
xelindrós	xelindró+N+M+PL
xelma	xelma+N+F+SG
xelmas	xelma+N+F+PL
xelmazinha	xelma+N+DIM+F+SG
xelmazinhas	xelma+N+DIM+F+PL
xelminha	xelma+N+DIM+F+SG
xelminhas	xelma+N+DIM+F+PL
xenagia	xenagia+N+F+SG
xenagias	xenagia+N+F+PL
xenagiazinha	xenagia+N+DIM+F+SG
xenagiazinhas	xenagia+N+DIM+F+PL
xenaginha	xenagia+N+DIM+F+SG
xenaginhas	xenagia+N+DIM+F+PL
xenartinho	xenarto+N+DIM+M+SG
xenartinhos	xenarto+N+DIM+M+PL
xenarto	xenarto+N+M+SG
xenartos	xenarto+N+M+PL
xenartozinho	xenarto+N+DIM+M+SG
xenartozinhos	xenarto+N+DIM+M+PL
xenatinho	xenato+N+DIM+M+SG
xenatinhos	xenato+N+DIM+M+PL
xenato	xenato+N+M+SG
xenatos	xenato+N+M+PL
xenatozinho	xenato+N+DIM+M+SG
xenatozinhos	xenato+N+DIM+M+PL
xenelasia	xenelasia+N+F+SG
xenelasias	xenelasia+N+F+PL
xenelasiazinha	xenelasia+N+DIM+F+SG
xenelasiazinhas	xenelasia+N+DIM+F+PL
xenelasinha	xenelasia+N+DIM+F+SG
xenelasinhas	xenelasia+N+DIM+F+PL
xenicidade	xenicidade+N+F+SG
xenicidades	xenicidade+N+F+PL
xenicidadezinha	xenicidade+N+DIM+F+SG
xenicidadezinhas	xenicidade+N+DIM+F+PL
xenicidadinha	xenicidade+N+DIM+F+SG
xenicidadinhas	xenicidade+N+DIM+F+PL
xenobiose	xenobiose+N+F+SG
xenobioses	xenobiose+N+F+PL
xenobiosezinha	xenobiose+N+DIM+F+SG
xenobiosezinhas	xenobiose+N+DIM+F+PL
xenobiosinha	xenobiose+N+DIM+F+SG
xenobiosinhas	xenobiose+N+DIM+F+PL
xenoblasticidade	xenoblasticidade+N+F+SG
xenoblasticidades	xenoblasticidade+N+F+PL
xenoblasticidadezinha	xenoblasticidade+N+DIM+F+SG
xenoblasticidadezinhas	xenoblasticidade+N+DIM+F+PL
xenoblasticidadinha	xenoblasticidade+N+DIM+F+SG
xenoblasticidadinhas	xenoblasticidade+N+DIM+F+PL
xenodiagnosticozinho	xenodiagnóstico+N+DIM+M+SG
xenodiagnosticozinhos	xenodiagnóstico+N+DIM+M+PL
xenodiagnostiquinho	xenodiagnóstico+N+DIM+M+SG
xenodiagnostiquinhos	xenodiagnóstico+N+DIM+M+PL
xenodiagnóstico	xenodiagnóstico+N+M+SG
xenodiagnósticos	xenodiagnóstico+N+M+PL
xenodonte	xenodonte+N+M+SG
xenodontes	xenodonte+N+M+PL
xenodontezinho	xenodonte+N+DIM+M+SG
xenodontezinhos	xenodonte+N+DIM+M+PL
xenodontinho	xenodonte+N+DIM+M+SG
xenodontinhos	xenodonte+N+DIM+M+PL
xenoestrogeninho	xenoestrogénios+N+DIM+M+SG
xenoestrogeninhos	xenoestrogénios+N+DIM+M+PL
xenoestrogeniosinhas	xenoestrogénios+N+DIM+F+PL
xenoestrogeniosinhos	xenoestrogénios+N+DIM+M+PL
xenoestrogeniozinho	xenoestrogénios+N+DIM+M+SG
xenoestrogénio	xenoestrogénios+N+M+SG
xenoestrogénios	xenoestrogénios+N+M+PL
xenofilia	xenofilia+N+F+SG
xenofilias	xenofilia+N+F+PL
xenofiliazinha	xenofilia+N+DIM+F+SG
xenofiliazinhas	xenofilia+N+DIM+F+PL
xenofilinha	xenofilia+N+DIM+F+SG
xenofilinhas	xenofilia+N+DIM+F+PL
xenofilicidade	xenofilicidade+N+F+SG
xenofilicidades	xenofilicidade+N+F+PL
xenofilicidadezinha	xenofilicidade+N+DIM+F+SG
xenofilicidadezinhas	xenofilicidade+N+DIM+F+PL
xenofilicidadinha	xenofilicidade+N+DIM+F+SG
xenofilicidadinhas	xenofilicidade+N+DIM+F+PL
xenofilisminho	xenofilismo+N+DIM+M+SG
xenofilisminhos	xenofilismo+N+DIM+M+PL
xenofilismo	xenofilismo+N+M+SG
xenofilismos	xenofilismo+N+M+PL
xenofilismozinho	xenofilismo+N+DIM+M+SG
xenofilismozinhos	xenofilismo+N+DIM+M+PL
xenofobia	xenofobia+N+F+SG
xenofobias	xenofobia+N+F+PL
xenofobiazinha	xenofobia+N+DIM+F+SG
xenofobiazinhas	xenofobia+N+DIM+F+PL
xenofobinha	xenofobia+N+DIM+F+SG
xenofobinhas	xenofobia+N+DIM+F+PL
xenofobicidade	xenofobicidade+N+F+SG
xenofobicidades	xenofobicidade+N+F+PL
xenofobicidadezinha	xenofobicidade+N+DIM+F+SG
xenofobicidadezinhas	xenofobicidade+N+DIM+F+PL
xenofobicidadinha	xenofobicidade+N+DIM+F+SG
xenofobicidadinhas	xenofobicidade+N+DIM+F+PL
xenofobisminho	xenofobismo+N+DIM+M+SG
xenofobisminhos	xenofobismo+N+DIM+M+PL
xenofobismo	xenofobismo+N+M+SG
xenofobismos	xenofobismo+N+M+PL
xenofobismozinho	xenofobismo+N+DIM+M+SG
xenofobismozinhos	xenofobismo+N+DIM+M+PL
xenofonia	xenofonia+N+F+SG
xenofonias	xenofonia+N+F+PL
xenofoniazinha	xenofonia+N+DIM+F+SG
xenofoniazinhas	xenofonia+N+DIM+F+PL
xenofoninha	xenofonia+N+DIM+F+SG
xenofoninhas	xenofonia+N+DIM+F+PL
xenofonicidade	xenofonicidade+N+F+SG
xenofonicidades	xenofonicidade+N+F+PL
xenofonicidadezinha	xenofonicidade+N+DIM+F+SG
xenofonicidadezinhas	xenofonicidade+N+DIM+F+PL
xenofonicidadinha	xenofonicidade+N+DIM+F+SG
xenofonicidadinhas	xenofonicidade+N+DIM+F+PL
xenoftalmia	xenoftalmia+N+F+SG
xenoftalmias	xenoftalmia+N+F+PL
xenoftalmiazinha	xenoftalmia+N+DIM+F+SG
xenoftalmiazinhas	xenoftalmia+N+DIM+F+PL
xenoftalminha	xenoftalmia+N+DIM+F+SG
xenoftalminhas	xenoftalmia+N+DIM+F+PL
xenogeneticidade	xenogeneticidade+N+F+SG
xenogeneticidades	xenogeneticidade+N+F+PL
xenogeneticidadezinha	xenogeneticidade+N+DIM+F+SG
xenogeneticidadezinhas	xenogeneticidade+N+DIM+F+PL
xenogeneticidadinha	xenogeneticidade+N+DIM+F+SG
xenogeneticidadinhas	xenogeneticidade+N+DIM+F+PL
xenoglossia	xenoglossia+N+F+SG
xenoglossias	xenoglossia+N+F+PL
xenoglossiazinha	xenoglossia+N+DIM+F+SG
xenoglossiazinhas	xenoglossia+N+DIM+F+PL
xenoglossinha	xenoglossia+N+DIM+F+SG
xenoglossinhas	xenoglossia+N+DIM+F+PL
xenografia	xenografia+N+F+SG
xenografias	xenografia+N+F+PL
xenografiazinha	xenografia+N+DIM+F+SG
xenografiazinhas	xenografia+N+DIM+F+PL
xenografinha	xenografia+N+DIM+F+SG
xenografinhas	xenografia+N+DIM+F+PL
xenograficidade	xenograficidade+N+F+SG
xenograficidades	xenograficidade+N+F+PL
xenograficidadezinha	xenograficidade+N+DIM+F+SG
xenograficidadezinhas	xenograficidade+N+DIM+F+PL
xenograficidadinha	xenograficidade+N+DIM+F+SG
xenograficidadinhas	xenograficidade+N+DIM+F+PL
xenogenesezinho	xenogênese+N+DIM+M+SG
xenogenesezinhos	xenogênese+N+DIM+M+PL
xenogenesinho	xenogênese+N+DIM+M+SG
xenogenesinhos	xenogênese+N+DIM+M+PL
xenogênese	xenogênese+N+M+SG
xenogêneses	xenogênese+N+M+PL
xenologia	xenologia+N+F+SG
xenologias	xenologia+N+F+PL
xenologiazinha	xenologia+N+DIM+F+SG
xenologiazinhas	xenologia+N+DIM+F+PL
xenologinha	xenologia+N+DIM+F+SG
xenologinhas	xenologia+N+DIM+F+PL
xenomania	xenomania+N+F+SG
xenomanias	xenomania+N+F+PL
xenomaniazinha	xenomania+N+DIM+F+SG
xenomaniazinhas	xenomania+N+DIM+F+PL
xenomaninha	xenomania+N+DIM+F+SG
xenomaninhas	xenomania+N+DIM+F+PL
xenomenia	xenomenia+N+F+SG
xenomenias	xenomenia+N+F+PL
xenomeniazinha	xenomenia+N+DIM+F+SG
xenomeniazinhas	xenomenia+N+DIM+F+PL
xenomeninha	xenomenia+N+DIM+F+SG
xenomeninhas	xenomenia+N+DIM+F+PL
xenomorficidade	xenomorficidade+N+F+SG
xenomorficidades	xenomorficidade+N+F+PL
xenomorficidadezinha	xenomorficidade+N+DIM+F+SG
xenomorficidadezinhas	xenomorficidade+N+DIM+F+PL
xenomorficidadinha	xenomorficidade+N+DIM+F+SG
xenomorficidadinhas	xenomorficidade+N+DIM+F+PL
xenotima	xenotima+N+F+SG
xenotimas	xenotima+N+F+PL
xenotimazinha	xenotima+N+DIM+F+SG
xenotimazinhas	xenotima+N+DIM+F+PL
xenotiminha	xenotima+N+DIM+F+SG
xenotiminhas	xenotima+N+DIM+F+PL
xenxenzinho	xenxém+N+DIM+M+SG
xenxenzinhos	xenxém+N+DIM+M+PL
xenxém	xenxém+N+M+SG
xenxéns	xenxém+N+M+PL
xenofobazinha	xenófobo+N+DIM+F+SG
xenofobazinhas	xenófobo+N+DIM+F+PL
xenofobinha	xenófobo+N+DIM+F+SG
xenofobinhas	xenófobo+N+DIM+F+PL
xenofobinho	xenófobo+N+DIM+M+SG
xenofobinhos	xenófobo+N+DIM+M+PL
xenofobozinho	xenófobo+N+DIM+M+SG
xenofobozinhos	xenófobo+N+DIM+M+PL
xenófoba	xenófobo+N+F+SG
xenófobas	xenófobo+N+F+PL
xenófobo	xenófobo+N+M+SG
xenófobos	xenófobo+N+M+PL
xenografinho	xenógrafo+N+DIM+M+SG
xenografinhos	xenógrafo+N+DIM+M+PL
xenografozinho	xenógrafo+N+DIM+M+SG
xenografozinhos	xenógrafo+N+DIM+M+PL
xenógrafo	xenógrafo+N+M+SG
xenógrafos	xenógrafo+N+M+PL
xenolitinho	xenólito+N+DIM+M+SG
xenolitinhos	xenólito+N+DIM+M+PL
xenolitozinho	xenólito+N+DIM+M+SG
xenolitozinhos	xenólito+N+DIM+M+PL
xenólito	xenólito+N+M+SG
xenólitos	xenólito+N+M+PL
xenomaninho	xenómano+N+DIM+M+SG
xenomaninhos	xenómano+N+DIM+M+PL
xenomanozinho	xenómano+N+DIM+M+SG
xenomanozinhos	xenómano+N+DIM+M+PL
xenómano	xenómano+N+M+SG
xenómanos	xenómano+N+M+PL
xenotiminho	xenótimo+N+DIM+M+SG
xenotiminhos	xenótimo+N+DIM+M+PL
xenotimozinho	xenótimo+N+DIM+M+SG
xenotimozinhos	xenótimo+N+DIM+M+PL
xenótimo	xenótimo+N+M+SG
xenótimos	xenótimo+N+M+PL
xenomaninho	xenômano+N+DIM+M+SG
xenomaninhos	xenômano+N+DIM+M+PL
xenomanozinho	xenômano+N+DIM+M+SG
xenomanozinhos	xenômano+N+DIM+M+PL
xenômano	xenômano+N+M+SG
xenômanos	xenômano+N+M+PL
xenoninho	xenônio+N+DIM+M+SG
xenoninhos	xenônio+N+DIM+M+PL
xenoniozinho	xenônio+N+DIM+M+SG
xenoniozinhos	xenônio+N+DIM+M+PL
xenônio	xenônio+N+M+SG
xenônios	xenônio+N+M+PL
xepa	xepa+N+F+SG
xepas	xepa+N+F+PL
xepazinha	xepa+N+DIM+F+SG
xepazinhas	xepa+N+DIM+F+PL
xepinha	xepa+N+DIM+F+SG
xepinhas	xepa+N+DIM+F+PL
xepeirinho	xepeiro+N+DIM+M+SG
xepeirinhos	xepeiro+N+DIM+M+PL
xepeiro	xepeiro+N+M+SG
xepeiros	xepeiro+N+M+PL
xepeirozinho	xepeiro+N+DIM+M+SG
xepeirozinhos	xepeiro+N+DIM+M+PL
xeque	xeque+N+M+SG
xeques	xeque+N+M+PL
xequezinho	xeque+N+DIM+M+SG
xequezinhos	xeque+N+DIM+M+PL
xequinho	xeque+N+DIM+M+SG
xequinhos	xeque+N+DIM+M+PL
xeque-mate	xeque-mate+N+M+SG
xeque-matezinho	xeque-mate+N+DIM+M+SG
xeque-matinho	xeque-mate+N+DIM+M+SG
xeque-matinhos	xeque-mate+N+DIM+M+PL
xeques-mates	xeque-mate+N+M+PL
xeques-matezinhos	xeque-mate+N+DIM+M+PL
xerafim	xerafim+N+M+SG
xerafins	xerafim+N+M+PL
xerafinzinho	xerafim+N+DIM+M+SG
xerafinzinhos	xerafim+N+DIM+M+PL
xerardização	xerardização+N+F+SG
xerardizaçãozinha	xerardização+N+DIM+F+SG
xerardizações	xerardização+N+F+PL
xerardizaçõezinhas	xerardização+N+DIM+F+PL
xerasia	xerasia+N+F+SG
xerasias	xerasia+N+F+PL
xerasiazinha	xerasia+N+DIM+F+SG
xerasiazinhas	xerasia+N+DIM+F+PL
xerasinha	xerasia+N+DIM+F+SG
xerasinhas	xerasia+N+DIM+F+PL
xereca	xereca+N+F+SG
xerecas	xereca+N+F+PL
xerecazinha	xereca+N+DIM+F+SG
xerecazinhas	xereca+N+DIM+F+PL
xerequinha	xereca+N+DIM+F+SG
xerequinhas	xereca+N+DIM+F+PL
xerelete	xerelete+N+M+SG
xereletes	xerelete+N+M+PL
xereletezinho	xerelete+N+DIM+M+SG
xereletezinhos	xerelete+N+DIM+M+PL
xereletinho	xerelete+N+DIM+M+SG
xereletinhos	xerelete+N+DIM+M+PL
xerengue	xerengue+N+M+SG
xerengues	xerengue+N+M+PL
xerenguezinho	xerengue+N+DIM+M+SG
xerenguezinhos	xerengue+N+DIM+M+PL
xerenguinho	xerengue+N+DIM+M+SG
xerenguinhos	xerengue+N+DIM+M+PL
xererezinho	xereré+N+DIM+M+SG
xererezinhos	xereré+N+DIM+M+PL
xereré	xereré+N+M+SG
xererés	xereré+N+M+PL
xererenzinho	xererém+N+DIM+M+SG
xererenzinhos	xererém+N+DIM+M+PL
xererém	xererém+N+M+SG
xereréns	xererém+N+M+PL
xereta	xereta+N+SG
xeretas	xereta+N+PL
xeretazinha	xereta+N+DIM+F+SG
xeretazinhas	xereta+N+DIM+F+PL
xeretazinho	xereta+N+DIM+M+SG
xeretazinhos	xereta+N+DIM+M+PL
xeretinha	xereta+N+DIM+SG
xeretinhas	xereta+N+DIM+PL
xerez	xerez+N+M+SG
xerezes	xerez+N+M+PL
xerezezinhos	xerez+N+DIM+M+PL
xerezinho	xerez+N+DIM+M+SG
xerezinhos	xerez+N+DIM+M+PL
xerga	xerga+N+F+SG
xergas	xerga+N+F+PL
xergazinha	xerga+N+DIM+F+SG
xergazinhas	xerga+N+DIM+F+PL
xerguinha	xerga+N+DIM+F+SG
xerguinhas	xerga+N+DIM+F+PL
xergão	xergão+N+M+SG
xergãozinho	xergão+N+DIM+M+SG
xergões	xergão+N+M+PL
xergõezinhos	xergão+N+DIM+M+PL
xerifadinho	xerifado+N+DIM+M+SG
xerifadinhos	xerifado+N+DIM+M+PL
xerifado	xerifado+N+M+SG
xerifados	xerifado+N+M+PL
xerifadozinho	xerifado+N+DIM+M+SG
xerifadozinhos	xerifado+N+DIM+M+PL
xerife	xerife+N+M+SG
xerifes	xerife+N+M+PL
xerifezinho	xerife+N+DIM+M+SG
xerifezinhos	xerife+N+DIM+M+PL
xerifinho	xerife+N+DIM+M+SG
xerifinhos	xerife+N+DIM+M+PL
xerimbabinho	xerimbabo+N+DIM+M+SG
xerimbabinhos	xerimbabo+N+DIM+M+PL
xerimbabo	xerimbabo+N+M+SG
xerimbabos	xerimbabo+N+M+PL
xerimbabozinho	xerimbabo+N+DIM+M+SG
xerimbabozinhos	xerimbabo+N+DIM+M+PL
xeringosa	xeringosa+N+F+SG
xeringosas	xeringosa+N+F+PL
xeringosazinha	xeringosa+N+DIM+F+SG
xeringosazinhas	xeringosa+N+DIM+F+PL
xeringosinha	xeringosa+N+DIM+F+SG
xeringosinhas	xeringosa+N+DIM+F+PL
xeringueira	xeringueira+N+F+SG
xeringueiras	xeringueira+N+F+PL
xeringueirazinha	xeringueira+N+DIM+F+SG
xeringueirazinhas	xeringueira+N+DIM+F+PL
xeringueirinha	xeringueira+N+DIM+F+SG
xeringueirinhas	xeringueira+N+DIM+F+PL
xeripana	xeripana+N+F+SG
xeripanas	xeripana+N+F+PL
xeripanazinha	xeripana+N+DIM+F+SG
xeripanazinhas	xeripana+N+DIM+F+PL
xeripaninha	xeripana+N+DIM+F+SG
xeripaninhas	xeripana+N+DIM+F+PL
xerocopiazinha	xerocópia+N+DIM+F+SG
xerocopiazinhas	xerocópia+N+DIM+F+PL
xerocopinha	xerocópia+N+DIM+F+SG
xerocopinhas	xerocópia+N+DIM+F+PL
xerocópia	xerocópia+N+F+SG
xerocópias	xerocópia+N+F+PL
xerodermia	xerodermia+N+F+SG
xerodermias	xerodermia+N+F+PL
xerodermiazinha	xerodermia+N+DIM+F+SG
xerodermiazinhas	xerodermia+N+DIM+F+PL
xeroderminha	xerodermia+N+DIM+F+SG
xeroderminhas	xerodermia+N+DIM+F+PL
xerodermicidade	xerodermicidade+N+F+SG
xerodermicidades	xerodermicidade+N+F+PL
xerodermicidadezinha	xerodermicidade+N+DIM+F+SG
xerodermicidadezinhas	xerodermicidade+N+DIM+F+PL
xerodermicidadinha	xerodermicidade+N+DIM+F+SG
xerodermicidadinhas	xerodermicidade+N+DIM+F+PL
xerofagia	xerofagia+N+F+SG
xerofagias	xerofagia+N+F+PL
xerofagiazinha	xerofagia+N+DIM+F+SG
xerofagiazinhas	xerofagia+N+DIM+F+PL
xerofaginha	xerofagia+N+DIM+F+SG
xerofaginhas	xerofagia+N+DIM+F+PL
xerofagicidade	xerofagicidade+N+F+SG
xerofagicidades	xerofagicidade+N+F+PL
xerofagicidadezinha	xerofagicidade+N+DIM+F+SG
xerofagicidadezinhas	xerofagicidade+N+DIM+F+PL
xerofagicidadinha	xerofagicidade+N+DIM+F+SG
xerofagicidadinhas	xerofagicidade+N+DIM+F+PL
xerofilia	xerofilia+N+F+SG
xerofilias	xerofilia+N+F+PL
xerofiliazinha	xerofilia+N+DIM+F+SG
xerofiliazinhas	xerofilia+N+DIM+F+PL
xerofilinha	xerofilia+N+DIM+F+SG
xerofilinhas	xerofilia+N+DIM+F+PL
xerofilicidade	xerofilicidade+N+F+SG
xerofilicidades	xerofilicidade+N+F+PL
xerofilicidadezinha	xerofilicidade+N+DIM+F+SG
xerofilicidadezinhas	xerofilicidade+N+DIM+F+PL
xerofilicidadinha	xerofilicidade+N+DIM+F+SG
xerofilicidadinhas	xerofilicidade+N+DIM+F+PL
xerofitia	xerofitia+N+F+SG
xerofitias	xerofitia+N+F+PL
xerofitiazinha	xerofitia+N+DIM+F+SG
xerofitiazinhas	xerofitia+N+DIM+F+PL
xerofitinha	xerofitia+N+DIM+F+SG
xerofitinhas	xerofitia+N+DIM+F+PL
xerofiticidade	xerofiticidade+N+F+SG
xerofiticidades	xerofiticidade+N+F+PL
xerofiticidadezinha	xerofiticidade+N+DIM+F+SG
xerofiticidadezinhas	xerofiticidade+N+DIM+F+PL
xerofiticidadinha	xerofiticidade+N+DIM+F+SG
xerofiticidadinhas	xerofiticidade+N+DIM+F+PL
xerofitisminho	xerofitismo+N+DIM+M+SG
xerofitisminhos	xerofitismo+N+DIM+M+PL
xerofitismo	xerofitismo+N+M+SG
xerofitismos	xerofitismo+N+M+PL
xerofitismozinho	xerofitismo+N+DIM+M+SG
xerofitismozinhos	xerofitismo+N+DIM+M+PL
xeroftalmia	xeroftalmia+N+F+SG
xeroftalmias	xeroftalmia+N+F+PL
xeroftalmiazinha	xeroftalmia+N+DIM+F+SG
xeroftalmiazinhas	xeroftalmia+N+DIM+F+PL
xeroftalminha	xeroftalmia+N+DIM+F+SG
xeroftalminhas	xeroftalmia+N+DIM+F+PL
xeroftalmicidade	xeroftalmicidade+N+F+SG
xeroftalmicidades	xeroftalmicidade+N+F+PL
xeroftalmicidadezinha	xeroftalmicidade+N+DIM+F+SG
xeroftalmicidadezinhas	xeroftalmicidade+N+DIM+F+PL
xeroftalmicidadinha	xeroftalmicidade+N+DIM+F+SG
xeroftalmicidadinhas	xeroftalmicidade+N+DIM+F+PL
xerogeis	xerogel+N+M+PL
xerogeizinhos	xerogel+N+DIM+M+PL
xerogel	xerogel+N+M+SG
xerogelzinho	xerogel+N+DIM+M+SG
xerografia	xerografia+N+F+SG
xerografias	xerografia+N+F+PL
xerografiazinha	xerografia+N+DIM+F+SG
xerografiazinhas	xerografia+N+DIM+F+PL
xerografinha	xerografia+N+DIM+F+SG
xerografinhas	xerografia+N+DIM+F+PL
xerograficidade	xerograficidade+N+F+SG
xerograficidades	xerograficidade+N+F+PL
xerograficidadezinha	xerograficidade+N+DIM+F+SG
xerograficidadezinhas	xerograficidade+N+DIM+F+PL
xerograficidadinha	xerograficidade+N+DIM+F+SG
xerograficidadinhas	xerograficidade+N+DIM+F+PL
xeroma	xeroma+N+M+SG
xeromas	xeroma+N+M+PL
xeromazinho	xeroma+N+DIM+M+SG
xeromazinhos	xeroma+N+DIM+M+PL
xerominha	xeroma+N+DIM+M+SG
xerominhas	xeroma+N+DIM+M+PL
xeromenia	xeromenia+N+F+SG
xeromenias	xeromenia+N+F+PL
xeromeniazinha	xeromenia+N+DIM+F+SG
xeromeniazinhas	xeromenia+N+DIM+F+PL
xeromeninha	xeromenia+N+DIM+F+SG
xeromeninhas	xeromenia+N+DIM+F+PL
xeromorficidade	xeromorficidade+N+F+SG
xeromorficidades	xeromorficidade+N+F+PL
xeromorficidadezinha	xeromorficidade+N+DIM+F+SG
xeromorficidadezinhas	xeromorficidade+N+DIM+F+PL
xeromorficidadinha	xeromorficidade+N+DIM+F+SG
xeromorficidadinhas	xeromorficidade+N+DIM+F+PL
xerorradiografia	xerorradiografia+N+F+SG
xerorradiografias	xerorradiografia+N+F+PL
xerorradiografiazinha	xerorradiografia+N+DIM+F+SG
xerorradiografiazinhas	xerorradiografia+N+DIM+F+PL
xerorradiografinha	xerorradiografia+N+DIM+F+SG
xerorradiografinhas	xerorradiografia+N+DIM+F+PL
xerose	xerose+N+F+SG
xeroses	xerose+N+F+PL
xerosezinha	xerose+N+DIM+F+SG
xerosezinhas	xerose+N+DIM+F+PL
xerosinha	xerose+N+DIM+F+SG
xerosinhas	xerose+N+DIM+F+PL
xerostomia	xerostomia+N+F+SG
xerostomias	xerostomia+N+F+PL
xerostomiazinha	xerostomia+N+DIM+F+SG
xerostomiazinhas	xerostomia+N+DIM+F+PL
xerostominha	xerostomia+N+DIM+F+SG
xerostominhas	xerostomia+N+DIM+F+PL
xerostomicidade	xerostomicidade+N+F+SG
xerostomicidades	xerostomicidade+N+F+PL
xerostomicidadezinha	xerostomicidade+N+DIM+F+SG
xerostomicidadezinhas	xerostomicidade+N+DIM+F+PL
xerostomicidadinha	xerostomicidade+N+DIM+F+SG
xerostomicidadinhas	xerostomicidade+N+DIM+F+PL
xerotribia	xerotribia+N+F+SG
xerotribias	xerotribia+N+F+PL
xerotribiazinha	xerotribia+N+DIM+F+SG
xerotribiazinhas	xerotribia+N+DIM+F+PL
xerotribinha	xerotribia+N+DIM+F+SG
xerotribinhas	xerotribia+N+DIM+F+PL
xerume	xerume+N+M+SG
xerumes	xerume+N+M+PL
xerumezinho	xerume+N+DIM+M+SG
xerumezinhos	xerume+N+DIM+M+PL
xeruminho	xerume+N+DIM+M+SG
xeruminhos	xerume+N+DIM+M+PL
xerva	xerva+N+F+SG
xervas	xerva+N+F+PL
xervazinha	xerva+N+DIM+F+SG
xervazinhas	xerva+N+DIM+F+PL
xervinha	xerva+N+DIM+F+SG
xervinhas	xerva+N+DIM+F+PL
xerenzinho	xerém+N+DIM+M+SG
xerenzinhos	xerém+N+DIM+M+PL
xerém	xerém+N+M+SG
xeréns	xerém+N+M+PL
xerofitinho	xerófito+N+DIM+M+SG
xerofitinhos	xerófito+N+DIM+M+PL
xerofitozinho	xerófito+N+DIM+M+SG
xerofitozinhos	xerófito+N+DIM+M+PL
xerófito	xerófito+N+M+SG
xerófitos	xerófito+N+M+PL
xeta	xeta+N+F+SG
xetas	xeta+N+F+PL
xetazinha	xeta+N+DIM+F+SG
xetazinhas	xeta+N+DIM+F+PL
xetinha	xeta+N+DIM+F+SG
xetinhas	xeta+N+DIM+F+PL
xeura	xeura+N+F+SG
xeuras	xeura+N+F+PL
xeurazinha	xeura+N+DIM+F+SG
xeurazinhas	xeura+N+DIM+F+PL
xeurinha	xeura+N+DIM+F+SG
xeurinhas	xeura+N+DIM+F+PL
xexezinho	xexé+N+DIM+M+SG
xexezinhos	xexé+N+DIM+M+PL
xexé	xexé+N+M+SG
xexés	xexé+N+M+PL
xexeuzinho	xexéu+N+DIM+M+SG
xexeuzinhos	xexéu+N+DIM+M+PL
xexéu	xexéu+N+M+SG
xexéus	xexéu+N+M+PL
xiba	xiba+N+SG
xibas	xiba+N+PL
xibazinha	xiba+N+DIM+F+SG
xibazinhas	xiba+N+DIM+F+PL
xibazinho	xiba+N+DIM+M+SG
xibazinhos	xiba+N+DIM+M+PL
xibinha	xiba+N+DIM+SG
xibinhas	xiba+N+DIM+PL
xibatã	xibatã+N+F+SG
xibatãs	xibatã+N+F+PL
xibatãzinha	xibatã+N+DIM+F+SG
xibatãzinhas	xibatã+N+DIM+F+PL
xibimba	xibimba+N+SG
xibimbas	xibimba+N+PL
xibimbazinha	xibimba+N+DIM+F+SG
xibimbazinhas	xibimba+N+DIM+F+PL
xibimbazinho	xibimba+N+DIM+M+SG
xibimbazinhos	xibimba+N+DIM+M+PL
xibimbinha	xibimba+N+DIM+SG
xibimbinhas	xibimba+N+DIM+PL
xibinho	xibio+N+DIM+M+SG
xibinhos	xibio+N+DIM+M+PL
xibio	xibio+N+M+SG
xibios	xibio+N+M+PL
xibiozinho	xibio+N+DIM+M+SG
xibiozinhos	xibio+N+DIM+M+PL
xibiu	xibiu+N+M+SG
xibius	xibiu+N+M+PL
xibiuzinho	xibiu+N+DIM+M+SG
xibiuzinhos	xibiu+N+DIM+M+PL
xibolete	xibolete+N+M+SG
xiboletes	xibolete+N+M+PL
xiboletezinho	xibolete+N+DIM+M+SG
xiboletezinhos	xibolete+N+DIM+M+PL
xiboletinho	xibolete+N+DIM+M+SG
xiboletinhos	xibolete+N+DIM+M+PL
xibungo	xibungo+N+M+SG
xibungos	xibungo+N+M+PL
xibungozinho	xibungo+N+DIM+M+SG
xibungozinhos	xibungo+N+DIM+M+PL
xibunguinho	xibungo+N+DIM+M+SG
xibunguinhos	xibungo+N+DIM+M+PL
xicaca	xicaca+N+F+SG
xicacas	xicaca+N+F+PL
xicacazinha	xicaca+N+DIM+F+SG
xicacazinhas	xicaca+N+DIM+F+PL
xicaquinha	xicaca+N+DIM+F+SG
xicaquinhas	xicaca+N+DIM+F+PL
xicarada	xicarada+N+F+SG
xicaradas	xicarada+N+F+PL
xicaradazinha	xicarada+N+DIM+F+SG
xicaradazinhas	xicarada+N+DIM+F+PL
xicaradinha	xicarada+N+DIM+F+SG
xicaradinhas	xicarada+N+DIM+F+PL
xicu	xicu+N+M+SG
xicus	xicu+N+M+PL
xicuzinho	xicu+N+DIM+M+SG
xicuzinhos	xicu+N+DIM+M+PL
xifiplastrão	xifiplastrão+N+M+SG
xifiplastrãozinho	xifiplastrão+N+DIM+M+SG
xifiplastrões	xifiplastrão+N+M+PL
xifiplastrõezinhos	xifiplastrão+N+DIM+M+PL
xifisterninho	xifisterno+N+DIM+M+SG
xifisterninhos	xifisterno+N+DIM+M+PL
xifisterno	xifisterno+N+M+SG
xifisternos	xifisterno+N+M+PL
xifisternozinho	xifisterno+N+DIM+M+SG
xifisternozinhos	xifisterno+N+DIM+M+PL
xifopagia	xifopagia+N+F+SG
xifopagias	xifopagia+N+F+PL
xifopagiazinha	xifopagia+N+DIM+F+SG
xifopagiazinhas	xifopagia+N+DIM+F+PL
xifopaginha	xifopagia+N+DIM+F+SG
xifopaginhas	xifopagia+N+DIM+F+PL
xifopagotomia	xifopagotomia+N+F+SG
xifopagotomias	xifopagotomia+N+F+PL
xifopagotomiazinha	xifopagotomia+N+DIM+F+SG
xifopagotomiazinhas	xifopagotomia+N+DIM+F+PL
xifopagotominha	xifopagotomia+N+DIM+F+SG
xifopagotominhas	xifopagotomia+N+DIM+F+PL
xifosurinho	xifosuro+N+DIM+M+SG
xifosurinhos	xifosuro+N+DIM+M+PL
xifosuro	xifosuro+N+M+SG
xifosuros	xifosuro+N+M+PL
xifosurozinho	xifosuro+N+DIM+M+SG
xifosurozinhos	xifosuro+N+DIM+M+PL
xifiidazinho	xifíida+N+DIM+M+SG
xifiidazinhos	xifíida+N+DIM+M+PL
xifiidinha	xifíida+N+DIM+M+SG
xifiidinhas	xifíida+N+DIM+M+PL
xifíida	xifíida+N+M+SG
xifíidas	xifíida+N+M+PL
xifopagazinha	xifópago+N+DIM+F+SG
xifopagazinhas	xifópago+N+DIM+F+PL
xifopagozinho	xifópago+N+DIM+M+SG
xifopagozinhos	xifópago+N+DIM+M+PL
xifopaguinha	xifópago+N+DIM+F+SG
xifopaguinhas	xifópago+N+DIM+F+PL
xifopaguinho	xifópago+N+DIM+M+SG
xifopaguinhos	xifópago+N+DIM+M+PL
xifópaga	xifópago+N+F+SG
xifópagas	xifópago+N+F+PL
xifópago	xifópago+N+M+SG
xifópagos	xifópago+N+M+PL
xigogo	xigogo+N+M+SG
xigogos	xigogo+N+M+PL
xigogozinho	xigogo+N+DIM+M+SG
xigogozinhos	xigogo+N+DIM+M+PL
xigoguinho	xigogo+N+DIM+M+SG
xigoguinhos	xigogo+N+DIM+M+PL
xiisminho	xiismo+N+DIM+M+SG
xiisminhos	xiismo+N+DIM+M+PL
xiismo	xiismo+N+M+SG
xiismos	xiismo+N+M+PL
xiismozinho	xiismo+N+DIM+M+SG
xiismozinhos	xiismo+N+DIM+M+PL
xiita	xiita+N+SG
xiitas	xiita+N+PL
xiitazinha	xiita+N+DIM+F+SG
xiitazinhas	xiita+N+DIM+F+PL
xiitazinho	xiita+N+DIM+M+SG
xiitazinhos	xiita+N+DIM+M+PL
xiitinha	xiita+N+DIM+SG
xiitinhas	xiita+N+DIM+PL
xila	xila+N+F+SG
xilas	xila+N+F+PL
xilazinha	xila+N+DIM+F+SG
xilazinhas	xila+N+DIM+F+PL
xilinha	xila+N+DIM+F+SG
xilinhas	xila+N+DIM+F+PL
xilarmonicozinho	xilarmónico+N+DIM+M+SG
xilarmonicozinhos	xilarmónico+N+DIM+M+PL
xilarmoniquinho	xilarmónico+N+DIM+M+SG
xilarmoniquinhos	xilarmónico+N+DIM+M+PL
xilarmónico	xilarmónico+N+M+SG
xilarmónicos	xilarmónico+N+M+PL
xilarmonicozinho	xilarmônico+N+DIM+M+SG
xilarmonicozinhos	xilarmônico+N+DIM+M+PL
xilarmoniquinho	xilarmônico+N+DIM+M+SG
xilarmoniquinhos	xilarmônico+N+DIM+M+PL
xilarmônico	xilarmônico+N+M+SG
xilarmônicos	xilarmônico+N+M+PL
xilema	xilema+N+M+SG
xilemas	xilema+N+M+PL
xilemazinho	xilema+N+DIM+M+SG
xilemazinhos	xilema+N+DIM+M+PL
xileminha	xilema+N+DIM+M+SG
xileminhas	xilema+N+DIM+M+PL
xilematicidade	xilematicidade+N+F+SG
xilematicidades	xilematicidade+N+F+PL
xilematicidadezinha	xilematicidade+N+DIM+F+SG
xilematicidadezinhas	xilematicidade+N+DIM+F+PL
xilematicidadinha	xilematicidade+N+DIM+F+SG
xilematicidadinhas	xilematicidade+N+DIM+F+PL
xilenicidade	xilenicidade+N+F+SG
xilenicidades	xilenicidade+N+F+PL
xilenicidadezinha	xilenicidade+N+DIM+F+SG
xilenicidadezinhas	xilenicidade+N+DIM+F+PL
xilenicidadinha	xilenicidade+N+DIM+F+SG
xilenicidadinhas	xilenicidade+N+DIM+F+PL
xileninho	xileno+N+DIM+M+SG
xileninhos	xileno+N+DIM+M+PL
xileno	xileno+N+M+SG
xilenos	xileno+N+M+PL
xilenozinho	xileno+N+DIM+M+SG
xilenozinhos	xileno+N+DIM+M+PL
xilicidade	xilicidade+N+F+SG
xilicidades	xilicidade+N+F+PL
xilicidadezinha	xilicidade+N+DIM+F+SG
xilicidadezinhas	xilicidade+N+DIM+F+PL
xilicidadinha	xilicidade+N+DIM+F+SG
xilicidadinhas	xilicidade+N+DIM+F+PL
xilidina	xilidina+N+F+SG
xilidinas	xilidina+N+F+PL
xilidinazinha	xilidina+N+DIM+F+SG
xilidinazinhas	xilidina+N+DIM+F+PL
xilidininha	xilidina+N+DIM+F+SG
xilidininhas	xilidina+N+DIM+F+PL
xilindrozinho	xilindró+N+DIM+M+SG
xilindrozinhos	xilindró+N+DIM+M+PL
xilindró	xilindró+N+M+SG
xilindrós	xilindró+N+M+PL
xilitois	xilitol+N+M+PL
xilitoizinhos	xilitol+N+DIM+M+PL
xilitol	xilitol+N+M+SG
xilitolzinho	xilitol+N+DIM+M+SG
xilinho	xilo+N+DIM+M+SG
xilinhos	xilo+N+DIM+M+PL
xilo	xilo+N+M+SG
xilos	xilo+N+M+PL
xilozinho	xilo+N+DIM+M+SG
xilozinhos	xilo+N+DIM+M+PL
xilobalsaminho	xilobálsamo+N+DIM+M+SG
xilobalsaminhos	xilobálsamo+N+DIM+M+PL
xilobalsamozinho	xilobálsamo+N+DIM+M+SG
xilobalsamozinhos	xilobálsamo+N+DIM+M+PL
xilobálsamo	xilobálsamo+N+M+SG
xilobálsamos	xilobálsamo+N+M+PL
xilocarpinho	xilocarpo+N+DIM+M+SG
xilocarpinhos	xilocarpo+N+DIM+M+PL
xilocarpo	xilocarpo+N+M+SG
xilocarpos	xilocarpo+N+M+PL
xilocarpozinho	xilocarpo+N+DIM+M+SG
xilocarpozinhos	xilocarpo+N+DIM+M+PL
xilocainazinha	xilocaína+N+DIM+F+SG
xilocainazinhas	xilocaína+N+DIM+F+PL
xilocaininha	xilocaína+N+DIM+F+SG
xilocaininhas	xilocaína+N+DIM+F+PL
xilocaína	xilocaína+N+F+SG
xilocaínas	xilocaína+N+F+PL
xilocultura	xilocultura+N+F+SG
xiloculturas	xilocultura+N+F+PL
xiloculturazinha	xilocultura+N+DIM+F+SG
xiloculturazinhas	xilocultura+N+DIM+F+PL
xiloculturinha	xilocultura+N+DIM+F+SG
xiloculturinhas	xilocultura+N+DIM+F+PL
xilofagia	xilofagia+N+F+SG
xilofagias	xilofagia+N+F+PL
xilofagiazinha	xilofagia+N+DIM+F+SG
xilofagiazinhas	xilofagia+N+DIM+F+PL
xilofaginha	xilofagia+N+DIM+F+SG
xilofaginhas	xilofagia+N+DIM+F+PL
xilofagicidade	xilofagicidade+N+F+SG
xilofagicidades	xilofagicidade+N+F+PL
xilofagicidadezinha	xilofagicidade+N+DIM+F+SG
xilofagicidadezinhas	xilofagicidade+N+DIM+F+PL
xilofagicidadinha	xilofagicidade+N+DIM+F+SG
xilofagicidadinhas	xilofagicidade+N+DIM+F+PL
xilofinista	xilofinista+N+SG
xilofinistas	xilofinista+N+PL
xilofinistazinha	xilofinista+N+DIM+F+SG
xilofinistazinhas	xilofinista+N+DIM+F+PL
xilofinistazinho	xilofinista+N+DIM+M+SG
xilofinistazinhos	xilofinista+N+DIM+M+PL
xilofinistinha	xilofinista+N+DIM+SG
xilofinistinhas	xilofinista+N+DIM+PL
xilofone	xilofone+N+M+SG
xilofones	xilofone+N+M+PL
xilofonezinho	xilofone+N+DIM+M+SG
xilofonezinhos	xilofone+N+DIM+M+PL
xilofoninho	xilofone+N+DIM+M+SG
xilofoninhos	xilofone+N+DIM+M+PL
xilofoninho	xilofono+N+DIM+M+SG
xilofoninhos	xilofono+N+DIM+M+PL
xilofono	xilofono+N+M+SG
xilofonos	xilofono+N+M+PL
xilofonozinho	xilofono+N+DIM+M+SG
xilofonozinhos	xilofono+N+DIM+M+PL
xiloforiazinha	xilofória+N+DIM+F+SG
xiloforiazinhas	xilofória+N+DIM+F+PL
xiloforinha	xilofória+N+DIM+F+SG
xiloforinhas	xilofória+N+DIM+F+PL
xilofória	xilofória+N+F+SG
xilofórias	xilofória+N+F+PL
xiloglifia	xiloglifia+N+F+SG
xiloglifias	xiloglifia+N+F+PL
xiloglifiazinha	xiloglifia+N+DIM+F+SG
xiloglifiazinhas	xiloglifia+N+DIM+F+PL
xiloglifinha	xiloglifia+N+DIM+F+SG
xiloglifinhas	xiloglifia+N+DIM+F+PL
xiloglificidade	xiloglificidade+N+F+SG
xiloglificidades	xiloglificidade+N+F+PL
xiloglificidadezinha	xiloglificidade+N+DIM+F+SG
xiloglificidadezinhas	xiloglificidade+N+DIM+F+PL
xiloglificidadinha	xiloglificidade+N+DIM+F+SG
xiloglificidadinhas	xiloglificidade+N+DIM+F+PL
xilografia	xilografia+N+F+SG
xilografias	xilografia+N+F+PL
xilografiazinha	xilografia+N+DIM+F+SG
xilografiazinhas	xilografia+N+DIM+F+PL
xilografinha	xilografia+N+DIM+F+SG
xilografinhas	xilografia+N+DIM+F+PL
xilograficidade	xilograficidade+N+F+SG
xilograficidades	xilograficidade+N+F+PL
xilograficidadezinha	xilograficidade+N+DIM+F+SG
xilograficidadezinhas	xilograficidade+N+DIM+F+PL
xilograficidadinha	xilograficidade+N+DIM+F+SG
xilograficidadinhas	xilograficidade+N+DIM+F+PL
xilogravador	xilogravador+N+M+SG
xilogravadora	xilogravador+N+F+SG
xilogravadoras	xilogravador+N+F+PL
xilogravadorazinha	xilogravador+N+DIM+F+SG
xilogravadorazinhas	xilogravador+N+DIM+F+PL
xilogravadores	xilogravador+N+M+PL
xilogravadorezinhos	xilogravador+N+DIM+M+PL
xilogravadorinha	xilogravador+N+DIM+F+SG
xilogravadorinhas	xilogravador+N+DIM+F+PL
xilogravadorzinho	xilogravador+N+DIM+M+SG
xilogravadorzinhos	xilogravador+N+DIM+M+PL
xilogravura	xilogravura+N+F+SG
xilogravuras	xilogravura+N+F+PL
xilogravurazinha	xilogravura+N+DIM+F+SG
xilogravurazinhas	xilogravura+N+DIM+F+PL
xilogravurinha	xilogravura+N+DIM+F+SG
xilogravurinhas	xilogravura+N+DIM+F+PL
xilogeninho	xilogénio+N+DIM+M+SG
xilogeninhos	xilogénio+N+DIM+M+PL
xilogeniozinho	xilogénio+N+DIM+M+SG
xilogeniozinhos	xilogénio+N+DIM+M+PL
xilogénio	xilogénio+N+M+SG
xilogénios	xilogénio+N+M+PL
xilogeninho	xilogênio+N+DIM+M+SG
xilogeninhos	xilogênio+N+DIM+M+PL
xilogeniozinho	xilogênio+N+DIM+M+SG
xilogeniozinhos	xilogênio+N+DIM+M+PL
xilogênio	xilogênio+N+M+SG
xilogênios	xilogênio+N+M+PL
xiloidina	xiloidina+N+F+SG
xiloidinas	xiloidina+N+F+PL
xiloidinazinha	xiloidina+N+DIM+F+SG
xiloidinazinhas	xiloidina+N+DIM+F+PL
xiloidininha	xiloidina+N+DIM+F+SG
xiloidininhas	xiloidina+N+DIM+F+PL
xilois	xilol+N+M+PL
xiloizinhos	xilol+N+DIM+M+PL
xilol	xilol+N+M+SG
xilolzinho	xilol+N+DIM+M+SG
xilóis	xilol+N+M+PL
xilolatria	xilolatria+N+F+SG
xilolatrias	xilolatria+N+F+PL
xilolatriazinha	xilolatria+N+DIM+F+SG
xilolatriazinhas	xilolatria+N+DIM+F+PL
xilolatrinha	xilolatria+N+DIM+F+SG
xilolatrinhas	xilolatria+N+DIM+F+PL
xilolatricidade	xilolatricidade+N+F+SG
xilolatricidades	xilolatricidade+N+F+PL
xilolatricidadezinha	xilolatricidade+N+DIM+F+SG
xilolatricidadezinhas	xilolatricidade+N+DIM+F+PL
xilolatricidadinha	xilolatricidade+N+DIM+F+SG
xilolatricidadinhas	xilolatricidade+N+DIM+F+PL
xilologia	xilologia+N+F+SG
xilologias	xilologia+N+F+PL
xilologiazinha	xilologia+N+DIM+F+SG
xilologiazinhas	xilologia+N+DIM+F+PL
xilologinha	xilologia+N+DIM+F+SG
xilologinhas	xilologia+N+DIM+F+PL
xilologicidade	xilologicidade+N+F+SG
xilologicidades	xilologicidade+N+F+PL
xilologicidadezinha	xilologicidade+N+DIM+F+SG
xilologicidadezinhas	xilologicidade+N+DIM+F+PL
xilologicidadinha	xilologicidade+N+DIM+F+SG
xilologicidadinhas	xilologicidade+N+DIM+F+PL
xiloma	xiloma+N+M+SG
xilomas	xiloma+N+M+PL
xilomazinho	xiloma+N+DIM+M+SG
xilomazinhos	xiloma+N+DIM+M+PL
xilominha	xiloma+N+DIM+M+SG
xilominhas	xiloma+N+DIM+M+PL
xilomancia	xilomancia+N+F+SG
xilomancias	xilomancia+N+F+PL
xilomanciazinha	xilomancia+N+DIM+F+SG
xilomanciazinhas	xilomancia+N+DIM+F+PL
xilomancinha	xilomancia+N+DIM+F+SG
xilomancinhas	xilomancia+N+DIM+F+PL
xilomante	xilomante+N+SG
xilomantes	xilomante+N+PL
xilomantezinha	xilomante+N+DIM+F+SG
xilomantezinhas	xilomante+N+DIM+F+PL
xilomantezinho	xilomante+N+DIM+M+SG
xilomantezinhos	xilomante+N+DIM+M+PL
xilomantinha	xilomante+N+DIM+F+SG
xilomantinhas	xilomante+N+DIM+F+PL
xilomantinho	xilomante+N+DIM+M+SG
xilomantinhos	xilomante+N+DIM+M+PL
xilomanticidade	xilomanticidade+N+F+SG
xilomanticidades	xilomanticidade+N+F+PL
xilomanticidadezinha	xilomanticidade+N+DIM+F+SG
xilomanticidadezinhas	xilomanticidade+N+DIM+F+PL
xilomanticidadinha	xilomanticidade+N+DIM+F+SG
xilomanticidadinhas	xilomanticidade+N+DIM+F+PL
xilometria	xilometria+N+F+SG
xilometrias	xilometria+N+F+PL
xilometriazinha	xilometria+N+DIM+F+SG
xilometriazinhas	xilometria+N+DIM+F+PL
xilometrinha	xilometria+N+DIM+F+SG
xilometrinhas	xilometria+N+DIM+F+PL
xilopodinho	xilopódio+N+DIM+M+SG
xilopodinhos	xilopódio+N+DIM+M+PL
xilopodiozinho	xilopódio+N+DIM+M+SG
xilopodiozinhos	xilopódio+N+DIM+M+PL
xilopódio	xilopódio+N+M+SG
xilopódios	xilopódio+N+M+PL
xilose	xilose+N+F+SG
xiloses	xilose+N+F+PL
xilosezinha	xilose+N+DIM+F+SG
xilosezinhas	xilose+N+DIM+F+PL
xilosinha	xilose+N+DIM+F+SG
xilosinhas	xilose+N+DIM+F+PL
xilreu	xilreu+N+M+SG
xilreus	xilreu+N+M+PL
xilreuzinho	xilreu+N+DIM+M+SG
xilreuzinhos	xilreu+N+DIM+M+PL
xileninho	xilénio+N+DIM+M+SG
xileninhos	xilénio+N+DIM+M+PL
xileniozinho	xilénio+N+DIM+M+SG
xileniozinhos	xilénio+N+DIM+M+PL
xilénio	xilénio+N+M+SG
xilénios	xilénio+N+M+PL
xileninho	xilênio+N+DIM+M+SG
xileninhos	xilênio+N+DIM+M+PL
xileniozinho	xilênio+N+DIM+M+SG
xileniozinhos	xilênio+N+DIM+M+PL
xilênio	xilênio+N+M+SG
xilênios	xilênio+N+M+PL
xilodiazinha	xilódia+N+DIM+F+SG
xilodiazinhas	xilódia+N+DIM+F+PL
xilodinha	xilódia+N+DIM+F+SG
xilodinhas	xilódia+N+DIM+F+PL
xilódia	xilódia+N+F+SG
xilódias	xilódia+N+F+PL
xilodinho	xilódio+N+DIM+M+SG
xilodinhos	xilódio+N+DIM+M+PL
xilodiozinho	xilódio+N+DIM+M+SG
xilodiozinhos	xilódio+N+DIM+M+PL
xilódio	xilódio+N+M+SG
xilódios	xilódio+N+M+PL
xilofilinho	xilófilo+N+DIM+M+SG
xilofilinhos	xilófilo+N+DIM+M+PL
xilofilozinho	xilófilo+N+DIM+M+SG
xilofilozinhos	xilófilo+N+DIM+M+PL
xilófilo	xilófilo+N+M+SG
xilófilos	xilófilo+N+M+PL
xilofitinho	xilófito+N+DIM+M+SG
xilofitinhos	xilófito+N+DIM+M+PL
xilofitozinho	xilófito+N+DIM+M+SG
xilofitozinhos	xilófito+N+DIM+M+PL
xilófito	xilófito+N+M+SG
xilófitos	xilófito+N+M+PL
xiloforinho	xilóforo+N+DIM+M+SG
xiloforinhos	xilóforo+N+DIM+M+PL
xiloforozinho	xilóforo+N+DIM+M+SG
xiloforozinhos	xilóforo+N+DIM+M+PL
xilóforo	xilóforo+N+M+SG
xilóforos	xilóforo+N+M+PL
xiloglifazinha	xilóglifo+N+DIM+F+SG
xiloglifazinhas	xilóglifo+N+DIM+F+PL
xiloglifinha	xilóglifo+N+DIM+F+SG
xiloglifinhas	xilóglifo+N+DIM+F+PL
xiloglifinho	xilóglifo+N+DIM+M+SG
xiloglifinhos	xilóglifo+N+DIM+M+PL
xiloglifozinho	xilóglifo+N+DIM+M+SG
xiloglifozinhos	xilóglifo+N+DIM+M+PL
xilóglifa	xilóglifo+N+F+SG
xilóglifas	xilóglifo+N+F+PL
xilóglifo	xilóglifo+N+M+SG
xilóglifos	xilóglifo+N+M+PL
xilografazinha	xilógrafo+N+DIM+F+SG
xilografazinhas	xilógrafo+N+DIM+F+PL
xilografinha	xilógrafo+N+DIM+F+SG
xilografinhas	xilógrafo+N+DIM+F+PL
xilografinho	xilógrafo+N+DIM+M+SG
xilografinhos	xilógrafo+N+DIM+M+PL
xilografozinho	xilógrafo+N+DIM+M+SG
xilografozinhos	xilógrafo+N+DIM+M+PL
xilógrafa	xilógrafo+N+F+SG
xilógrafas	xilógrafo+N+F+PL
xilógrafo	xilógrafo+N+M+SG
xilógrafos	xilógrafo+N+M+PL
xilolatrazinha	xilólatra+N+DIM+F+SG
xilolatrazinhas	xilólatra+N+DIM+F+PL
xilolatrazinho	xilólatra+N+DIM+M+SG
xilolatrazinhos	xilólatra+N+DIM+M+PL
xilolatrinha	xilólatra+N+DIM+SG
xilolatrinhas	xilólatra+N+DIM+PL
xilólatra	xilólatra+N+SG
xilólatras	xilólatra+N+PL
xilolitinho	xilólito+N+DIM+M+SG
xilolitinhos	xilólito+N+DIM+M+PL
xilolitozinho	xilólito+N+DIM+M+SG
xilolitozinhos	xilólito+N+DIM+M+PL
xilólito	xilólito+N+M+SG
xilólitos	xilólito+N+M+PL
xilologazinha	xilólogo+N+DIM+F+SG
xilologazinhas	xilólogo+N+DIM+F+PL
xilologozinho	xilólogo+N+DIM+M+SG
xilologozinhos	xilólogo+N+DIM+M+PL
xilologuinha	xilólogo+N+DIM+F+SG
xilologuinhas	xilólogo+N+DIM+F+PL
xilologuinho	xilólogo+N+DIM+M+SG
xilologuinhos	xilólogo+N+DIM+M+PL
xilóloga	xilólogo+N+F+SG
xilólogas	xilólogo+N+F+PL
xilólogo	xilólogo+N+M+SG
xilólogos	xilólogo+N+M+PL
xilopiazinha	xilópia+N+DIM+F+SG
xilopiazinhas	xilópia+N+DIM+F+PL
xilopinha	xilópia+N+DIM+F+SG
xilopinhas	xilópia+N+DIM+F+PL
xilópia	xilópia+N+F+SG
xilópias	xilópia+N+F+PL
xilorgãozinho	xilórgão+N+DIM+M+SG
xilorgõezinhos	xilórgão+N+DIM+M+PL
xilórgão	xilórgão+N+M+SG
xilórgões	xilórgão+N+M+PL
ximango	ximango+N+M+SG
ximangos	ximango+N+M+PL
ximangozinho	ximango+N+DIM+M+SG
ximangozinhos	ximango+N+DIM+M+PL
ximanguinho	ximango+N+DIM+M+SG
ximanguinhos	ximango+N+DIM+M+PL
ximarrão	ximarrão+N+M+SG
ximarrãozinho	ximarrão+N+DIM+M+SG
ximarrões	ximarrão+N+M+PL
ximarrõezinhos	ximarrão+N+DIM+M+PL
ximbauvazinha	ximbaúva+N+DIM+F+SG
ximbauvazinhas	ximbaúva+N+DIM+F+PL
ximbauvinha	ximbaúva+N+DIM+F+SG
ximbauvinhas	ximbaúva+N+DIM+F+PL
ximbaúva	ximbaúva+N+F+SG
ximbaúvas	ximbaúva+N+F+PL
ximbelinho	ximbelo+N+DIM+M+SG
ximbelinhos	ximbelo+N+DIM+M+PL
ximbelo	ximbelo+N+M+SG
ximbelos	ximbelo+N+M+PL
ximbelozinho	ximbelo+N+DIM+M+SG
ximbelozinhos	ximbelo+N+DIM+M+PL
ximbeque	ximbeque+N+M+SG
ximbeques	ximbeque+N+M+PL
ximbequezinho	ximbeque+N+DIM+M+SG
ximbequezinhos	ximbeque+N+DIM+M+PL
ximbequinho	ximbeque+N+DIM+M+SG
ximbequinhos	ximbeque+N+DIM+M+PL
ximbeva	ximbeva+N+SG
ximbevas	ximbeva+N+PL
ximbevazinha	ximbeva+N+DIM+F+SG
ximbevazinhas	ximbeva+N+DIM+F+PL
ximbevazinho	ximbeva+N+DIM+M+SG
ximbevazinhos	ximbeva+N+DIM+M+PL
ximbevinha	ximbeva+N+DIM+SG
ximbevinhas	ximbeva+N+DIM+PL
ximbica	ximbica+N+F+SG
ximbicas	ximbica+N+F+PL
ximbicazinha	ximbica+N+DIM+F+SG
ximbicazinhas	ximbica+N+DIM+F+PL
ximbiquinha	ximbica+N+DIM+F+SG
ximbiquinhas	ximbica+N+DIM+F+PL
ximborezinho	ximboré+N+DIM+M+SG
ximborezinhos	ximboré+N+DIM+M+PL
ximboré	ximboré+N+M+SG
ximborés	ximboré+N+M+PL
ximbra	ximbra+N+F+SG
ximbras	ximbra+N+F+PL
ximbrazinha	ximbra+N+DIM+F+SG
ximbrazinhas	ximbra+N+DIM+F+PL
ximbrinha	ximbra+N+DIM+F+SG
ximbrinhas	ximbra+N+DIM+F+PL
ximburetinga	ximburetinga+N+M+SG
ximburetingas	ximburetinga+N+M+PL
ximburetingazinho	ximburetinga+N+DIM+M+SG
ximburetingazinhos	ximburetinga+N+DIM+M+PL
ximburetinguinha	ximburetinga+N+DIM+M+SG
ximburetinguinhas	ximburetinga+N+DIM+M+PL
ximburu	ximburu+N+M+SG
ximburus	ximburu+N+M+PL
ximburuzinho	ximburu+N+DIM+M+SG
ximburuzinhos	ximburu+N+DIM+M+PL
ximburezinho	ximburé+N+DIM+M+SG
ximburezinhos	ximburé+N+DIM+M+PL
ximburé	ximburé+N+M+SG
ximburés	ximburé+N+M+PL
ximbute	ximbute+N+M+SG
ximbutes	ximbute+N+M+PL
ximbutezinho	ximbute+N+DIM+M+SG
ximbutezinhos	ximbute+N+DIM+M+PL
ximbutinho	ximbute+N+DIM+M+SG
ximbutinhos	ximbute+N+DIM+M+PL
ximão	ximão+N+M+SG
ximãozinho	ximão+N+DIM+M+SG
ximões	ximão+N+M+PL
ximõezinhos	ximão+N+DIM+M+PL
ximeniazinha	ximénia+N+DIM+F+SG
ximeniazinhas	ximénia+N+DIM+F+PL
ximeninha	ximénia+N+DIM+F+SG
ximeninhas	ximénia+N+DIM+F+PL
ximénia	ximénia+N+F+SG
ximénias	ximénia+N+F+PL
ximeniazinha	ximênia+N+DIM+F+SG
ximeniazinhas	ximênia+N+DIM+F+PL
ximeninha	ximênia+N+DIM+F+SG
ximeninhas	ximênia+N+DIM+F+PL
ximênia	ximênia+N+F+SG
ximênias	ximênia+N+F+PL
xinane	xinane+N+M+SG
xinanes	xinane+N+M+PL
xinanezinho	xinane+N+DIM+M+SG
xinanezinhos	xinane+N+DIM+M+PL
xinaninho	xinane+N+DIM+M+SG
xinaninhos	xinane+N+DIM+M+PL
xinapre	xinapre+N+M+SG
xinapres	xinapre+N+M+PL
xinaprezinho	xinapre+N+DIM+M+SG
xinaprezinhos	xinapre+N+DIM+M+PL
xinaprinho	xinapre+N+DIM+M+SG
xinaprinhos	xinapre+N+DIM+M+PL
xinga	xinga+N+F+SG
xingas	xinga+N+F+PL
xingazinha	xinga+N+DIM+F+SG
xingazinhas	xinga+N+DIM+F+PL
xinguinha	xinga+N+DIM+F+SG
xinguinhas	xinga+N+DIM+F+PL
xingadela	xingadela+N+F+SG
xingadelas	xingadela+N+F+PL
xingadelazinha	xingadela+N+DIM+F+SG
xingadelazinhas	xingadela+N+DIM+F+PL
xingadelinha	xingadela+N+DIM+F+SG
xingadelinhas	xingadela+N+DIM+F+PL
xingador	xingador+N+M+SG
xingadora	xingador+N+F+SG
xingadoras	xingador+N+F+PL
xingadorazinha	xingador+N+DIM+F+SG
xingadorazinhas	xingador+N+DIM+F+PL
xingadores	xingador+N+M+PL
xingadorezinhos	xingador+N+DIM+M+PL
xingadorinha	xingador+N+DIM+F+SG
xingadorinhas	xingador+N+DIM+F+PL
xingadorzinho	xingador+N+DIM+M+SG
xingadorzinhos	xingador+N+DIM+M+PL
xingamentinho	xingamento+N+DIM+M+SG
xingamentinhos	xingamento+N+DIM+M+PL
xingamento	xingamento+N+M+SG
xingamentos	xingamento+N+M+PL
xingamentozinho	xingamento+N+DIM+M+SG
xingamentozinhos	xingamento+N+DIM+M+PL
xingaraviz	xingaraviz+N+M+SG
xingaravizes	xingaraviz+N+M+PL
xingaravizezinhos	xingaraviz+N+DIM+M+PL
xingaravizinho	xingaraviz+N+DIM+M+SG
xingaravizinhos	xingaraviz+N+DIM+M+PL
xingação	xingação+N+SG
xingaçãozinha	xingação+N+DIM+F+SG
xingaçãozinho	xingação+N+DIM+M+SG
xingações	xingação+N+PL
xingaçõezinhas	xingação+N+DIM+F+PL
xingaçõezinhos	xingação+N+DIM+M+PL
xingo	xingo+N+M+SG
xingos	xingo+N+M+PL
xingozinho	xingo+N+DIM+M+SG
xingozinhos	xingo+N+DIM+M+PL
xinguinho	xingo+N+DIM+M+SG
xinguinhos	xingo+N+DIM+M+PL
xintoisminho	xintoísmo+N+DIM+M+SG
xintoisminhos	xintoísmo+N+DIM+M+PL
xintoismozinho	xintoísmo+N+DIM+M+SG
xintoismozinhos	xintoísmo+N+DIM+M+PL
xintoísmo	xintoísmo+N+M+SG
xintoísmos	xintoísmo+N+M+PL
xintoistazinha	xintoísta+N+DIM+F+SG
xintoistazinhas	xintoísta+N+DIM+F+PL
xintoistazinho	xintoísta+N+DIM+M+SG
xintoistazinhos	xintoísta+N+DIM+M+PL
xintoistinha	xintoísta+N+DIM+SG
xintoistinhas	xintoísta+N+DIM+PL
xintoísta	xintoísta+N+SG
xintoístas	xintoísta+N+PL
xintozinho	xintó+N+DIM+M+SG
xintozinhos	xintó+N+DIM+M+PL
xintó	xintó+N+M+SG
xintós	xintó+N+M+PL
xinxilha	xinxilha+N+M+SG
xinxilhas	xinxilha+N+M+PL
xinxilhazinho	xinxilha+N+DIM+M+SG
xinxilhazinhos	xinxilha+N+DIM+M+PL
xinxilhinha	xinxilha+N+DIM+M+SG
xinxilhinhas	xinxilha+N+DIM+M+PL
xinxim	xinxim+N+M+SG
xinxins	xinxim+N+M+PL
xinxinzinho	xinxim+N+DIM+M+SG
xinxinzinhos	xinxim+N+DIM+M+PL
xipamida	xipamida+N+F+SG
xipamidas	xipamida+N+F+PL
xipamidazinha	xipamida+N+DIM+F+SG
xipamidazinhas	xipamida+N+DIM+F+PL
xipamidinha	xipamida+N+DIM+F+SG
xipamidinhas	xipamida+N+DIM+F+PL
xipante	xipante+N+M+SG
xipantes	xipante+N+M+PL
xipantezinho	xipante+N+DIM+M+SG
xipantezinhos	xipante+N+DIM+M+PL
xipantinho	xipante+N+DIM+M+SG
xipantinhos	xipante+N+DIM+M+PL
xipinho	xipo+N+DIM+M+SG
xipinhos	xipo+N+DIM+M+PL
xipo	xipo+N+M+SG
xipos	xipo+N+M+PL
xipozinho	xipo+N+DIM+M+SG
xipozinhos	xipo+N+DIM+M+PL
xiquexique	xiquexique+N+M+SG
xiquexiques	xiquexique+N+M+PL
xiquexiquezinho	xiquexique+N+DIM+M+SG
xiquexiquezinhos	xiquexique+N+DIM+M+PL
xiquexiquinho	xiquexique+N+DIM+M+SG
xiquexiquinhos	xiquexique+N+DIM+M+PL
xira	xira+N+SG
xiras	xira+N+PL
xirazinha	xira+N+DIM+F+SG
xirazinhas	xira+N+DIM+F+PL
xirazinho	xira+N+DIM+M+SG
xirazinhos	xira+N+DIM+M+PL
xirinha	xira+N+DIM+SG
xirinhas	xira+N+DIM+PL
xiridaceazinha	xiridácea+N+DIM+F+SG
xiridaceazinhas	xiridácea+N+DIM+F+PL
xiridaceinha	xiridácea+N+DIM+F+SG
xiridaceinhas	xiridácea+N+DIM+F+PL
xiridácea	xiridácea+N+F+SG
xiridáceas	xiridácea+N+F+PL
xiridaceazinha	xiridáceo+N+DIM+F+SG
xiridaceazinhas	xiridáceo+N+DIM+F+PL
xiridaceinha	xiridáceo+N+DIM+F+SG
xiridaceinhas	xiridáceo+N+DIM+F+PL
xiridaceinho	xiridáceo+N+DIM+M+SG
xiridaceinhos	xiridáceo+N+DIM+M+PL
xiridaceozinho	xiridáceo+N+DIM+M+SG
xiridaceozinhos	xiridáceo+N+DIM+M+PL
xiridácea	xiridáceo+N+F+SG
xiridáceas	xiridáceo+N+F+PL
xiridáceo	xiridáceo+N+M+SG
xiridáceos	xiridáceo+N+M+PL
xiriubeira	xiriubeira+N+F+SG
xiriubeiras	xiriubeira+N+F+PL
xiriubeirazinha	xiriubeira+N+DIM+F+SG
xiriubeirazinhas	xiriubeira+N+DIM+F+PL
xiriubeirinha	xiriubeira+N+DIM+F+SG
xiriubeirinhas	xiriubeira+N+DIM+F+PL
xiru	xiru+N+M+SG
xirus	xiru+N+M+PL
xiruzinho	xiru+N+DIM+M+SG
xiruzinhos	xiru+N+DIM+M+PL
xirozinho	xiró+N+DIM+M+SG
xirozinhos	xiró+N+DIM+M+PL
xiró	xiró+N+M+SG
xirós	xiró+N+M+PL
xis	xis+N+M
xises	xis+N+M+PL
xisezinhos	xis+N+DIM+M+PL
xisinhas	xis+N+DIM+F+PL
xisinho	xis+N+DIM+M+SG
xisinhos	xis+N+DIM+M+PL
xisgaraviz	xisgaraviz+N+M+SG
xisgaravizes	xisgaraviz+N+M+PL
xisgaravizezinhos	xisgaraviz+N+DIM+M+PL
xisgaravizinho	xisgaraviz+N+DIM+M+SG
xisgaravizinhos	xisgaraviz+N+DIM+M+PL
xistarca	xistarca+N+M+SG
xistarcas	xistarca+N+M+PL
xistarcazinho	xistarca+N+DIM+M+SG
xistarcazinhos	xistarca+N+DIM+M+PL
xistarquinha	xistarca+N+DIM+M+SG
xistarquinhas	xistarca+N+DIM+M+PL
xisticidade	xisticidade+N+F+SG
xisticidades	xisticidade+N+F+PL
xisticidadezinha	xisticidade+N+DIM+F+SG
xisticidadezinhas	xisticidade+N+DIM+F+PL
xisticidadinha	xisticidade+N+DIM+F+SG
xisticidadinhas	xisticidade+N+DIM+F+PL
xistinho	xisto+N+DIM+M+SG
xistinhos	xisto+N+DIM+M+PL
xisto	xisto+N+M+SG
xistos	xisto+N+M+PL
xistozinho	xisto+N+DIM+M+SG
xistozinhos	xisto+N+DIM+M+PL
xistocarpinho	xistocarpo+N+DIM+M+SG
xistocarpinhos	xistocarpo+N+DIM+M+PL
xistocarpo	xistocarpo+N+M+SG
xistocarpos	xistocarpo+N+M+PL
xistocarpozinho	xistocarpo+N+DIM+M+SG
xistocarpozinhos	xistocarpo+N+DIM+M+PL
xistoquimicidade	xistoquimicidade+N+F+SG
xistoquimicidades	xistoquimicidade+N+F+PL
xistoquimicidadezinha	xistoquimicidade+N+DIM+F+SG
xistoquimicidadezinhas	xistoquimicidade+N+DIM+F+PL
xistoquimicidadinha	xistoquimicidade+N+DIM+F+SG
xistoquimicidadinhas	xistoquimicidade+N+DIM+F+PL
xistosidade	xistosidade+N+F+SG
xistosidades	xistosidade+N+F+PL
xistosidadezinha	xistosidade+N+DIM+F+SG
xistosidadezinhas	xistosidade+N+DIM+F+PL
xistosidadinha	xistosidade+N+DIM+F+SG
xistosidadinhas	xistosidade+N+DIM+F+PL
xistossominho	xistossomo+N+DIM+M+SG
xistossominhos	xistossomo+N+DIM+M+PL
xistossomo	xistossomo+N+M+SG
xistossomos	xistossomo+N+M+PL
xistossomozinho	xistossomo+N+DIM+M+SG
xistossomozinhos	xistossomo+N+DIM+M+PL
xistossomose	xistossomose+N+F+SG
xistossomoses	xistossomose+N+F+PL
xistossomosezinha	xistossomose+N+DIM+F+SG
xistossomosezinhas	xistossomose+N+DIM+F+PL
xistossomosinha	xistossomose+N+DIM+F+SG
xistossomosinhas	xistossomose+N+DIM+F+PL
xistossomiasezinha	xistossomíase+N+DIM+F+SG
xistossomiasezinhas	xistossomíase+N+DIM+F+PL
xistossomiasinha	xistossomíase+N+DIM+F+SG
xistossomiasinhas	xistossomíase+N+DIM+F+PL
xistossomíase	xistossomíase+N+F+SG
xistossomíases	xistossomíase+N+F+PL
xistrinho	xistro+N+DIM+M+SG
xistrinhos	xistro+N+DIM+M+PL
xistro	xistro+N+M+SG
xistros	xistro+N+M+PL
xistrozinho	xistro+N+DIM+M+SG
xistrozinhos	xistro+N+DIM+M+PL
xistropodezinho	xistrópode+N+DIM+M+SG
xistropodezinhos	xistrópode+N+DIM+M+PL
xistropodinho	xistrópode+N+DIM+M+SG
xistropodinhos	xistrópode+N+DIM+M+PL
xistrópode	xistrópode+N+M+SG
xistrópodes	xistrópode+N+M+PL
xivaisminho	xivaísmo+N+DIM+M+SG
xivaisminhos	xivaísmo+N+DIM+M+PL
xivaismozinho	xivaísmo+N+DIM+M+SG
xivaismozinhos	xivaísmo+N+DIM+M+PL
xivaísmo	xivaísmo+N+M+SG
xivaísmos	xivaísmo+N+M+PL
xivaistazinha	xivaísta+N+DIM+F+SG
xivaistazinhas	xivaísta+N+DIM+F+PL
xivaistazinho	xivaísta+N+DIM+M+SG
xivaistazinhos	xivaísta+N+DIM+M+PL
xivaistinha	xivaísta+N+DIM+SG
xivaistinhas	xivaísta+N+DIM+PL
xivaísta	xivaísta+N+SG
xivaístas	xivaísta+N+PL
xivaitazinha	xivaíta+N+DIM+F+SG
xivaitazinhas	xivaíta+N+DIM+F+PL
xivaitazinho	xivaíta+N+DIM+M+SG
xivaitazinhos	xivaíta+N+DIM+M+PL
xivaitinha	xivaíta+N+DIM+SG
xivaitinhas	xivaíta+N+DIM+PL
xivaíta	xivaíta+N+SG
xivaítas	xivaíta+N+PL
xixi	xixi+N+M+SG
xixis	xixi+N+M+PL
xixizinho	xixi+N+DIM+M+SG
xixizinhos	xixi+N+DIM+M+PL
xixizito	xixi+N+DIM+M+SG
xixizitos	xixi+N+DIM+M+PL
xixica	xixica+N+F+SG
xixicas	xixica+N+F+PL
xixicazinha	xixica+N+DIM+F+SG
xixicazinhas	xixica+N+DIM+F+PL
xixiquinha	xixica+N+DIM+F+SG
xixiquinhas	xixica+N+DIM+F+PL
xixuão	xixuão+N+M+SG
xixuãos	xixuão+N+M+PL
xixuãozinho	xixuão+N+DIM+M+SG
xixuãozinhos	xixuão+N+DIM+M+PL
xixazinho	xixá+N+DIM+M+SG
xixazinhos	xixá+N+DIM+M+PL
xixá	xixá+N+M+SG
xixás	xixá+N+M+PL
xiezinho	xié+N+DIM+M+SG
xiezinhos	xié+N+DIM+M+PL
xié	xié+N+M+SG
xiés	xié+N+M+PL
xodozinho	xodó+N+DIM+M+SG
xodozinhos	xodó+N+DIM+M+PL
xodó	xodó+N+M+SG
xodós	xodó+N+M+PL
xofrango	xofrango+N+M+SG
xofrangos	xofrango+N+M+PL
xofrangozinho	xofrango+N+DIM+M+SG
xofrangozinhos	xofrango+N+DIM+M+PL
xofranguinho	xofrango+N+DIM+M+SG
xofranguinhos	xofrango+N+DIM+M+PL
xogunatinho	xogunato+N+DIM+M+SG
xogunatinhos	xogunato+N+DIM+M+PL
xogunato	xogunato+N+M+SG
xogunatos	xogunato+N+M+PL
xogunatozinho	xogunato+N+DIM+M+SG
xogunatozinhos	xogunato+N+DIM+M+PL
xorca	xorca+N+F+SG
xorcas	xorca+N+F+PL
xorcazinha	xorca+N+DIM+F+SG
xorcazinhas	xorca+N+DIM+F+PL
xorquinha	xorca+N+DIM+F+SG
xorquinhas	xorca+N+DIM+F+PL
xoroca	xoroca+N+F+SG
xorocas	xoroca+N+F+PL
xorocazinha	xoroca+N+DIM+F+SG
xorocazinhas	xoroca+N+DIM+F+PL
xoroquinha	xoroca+N+DIM+F+SG
xoroquinhas	xoroca+N+DIM+F+PL
xoxinho	xoxo+N+DIM+M+SG
xoxinhos	xoxo+N+DIM+M+PL
xoxo	xoxo+N+M+SG
xoxos	xoxo+N+M+PL
xoxozinho	xoxo+N+DIM+M+SG
xoxozinhos	xoxo+N+DIM+M+PL
xoxota	xoxota+N+F+SG
xoxotas	xoxota+N+F+PL
xoxotazinha	xoxota+N+DIM+F+SG
xoxotazinhas	xoxota+N+DIM+F+PL
xoxotinha	xoxota+N+DIM+F+SG
xoxotinhas	xoxota+N+DIM+F+PL
xuatezinho	xuatê+N+DIM+M+SG
xuatezinhos	xuatê+N+DIM+M+PL
xuatê	xuatê+N+M+SG
xuatês	xuatê+N+M+PL
xucrice	xucrice+N+F+SG
xucrices	xucrice+N+F+PL
xucricezinha	xucrice+N+DIM+F+SG
xucricezinhas	xucrice+N+DIM+F+PL
xucricinha	xucrice+N+DIM+F+SG
xucricinhas	xucrice+N+DIM+F+PL
xucrisminho	xucrismo+N+DIM+M+SG
xucrisminhos	xucrismo+N+DIM+M+PL
xucrismo	xucrismo+N+M+SG
xucrismos	xucrismo+N+M+PL
xucrismozinho	xucrismo+N+DIM+M+SG
xucrismozinhos	xucrismo+N+DIM+M+PL
xumbregação	xumbregação+N+F+SG
xumbregaçãozinha	xumbregação+N+DIM+F+SG
xumbregações	xumbregação+N+F+PL
xumbregaçõezinhas	xumbregação+N+DIM+F+PL
xuri	xuri+N+M+SG
xuris	xuri+N+M+PL
xurizinho	xuri+N+DIM+M+SG
xurizinhos	xuri+N+DIM+M+PL
xurreira	xurreira+N+F+SG
xurreiras	xurreira+N+F+PL
xurreirazinha	xurreira+N+DIM+F+SG
xurreirazinhas	xurreira+N+DIM+F+PL
xurreirinha	xurreira+N+DIM+F+SG
xurreirinhas	xurreira+N+DIM+F+PL
xuru	xuru+N+M+SG
xurus	xuru+N+M+PL
xuruzinho	xuru+N+DIM+M+SG
xuruzinhos	xuru+N+DIM+M+PL
xurumbambinho	xurumbambo+N+DIM+M+SG
xurumbambinhos	xurumbambo+N+DIM+M+PL
xurumbambo	xurumbambo+N+M+SG
xurumbambos	xurumbambo+N+M+PL
xurumbambozinho	xurumbambo+N+DIM+M+SG
xurumbambozinhos	xurumbambo+N+DIM+M+PL
xurumbambos	xurumbambos+N+M+PL
xurumbambosinhas	xurumbambos+N+DIM+F+PL
xurumbambosinhos	xurumbambos+N+DIM+M+PL
xuxa	xuxa+N+SG
xuxas	xuxa+N+PL
xuxazinha	xuxa+N+DIM+F+SG
xuxazinhas	xuxa+N+DIM+F+PL
xuxazinho	xuxa+N+DIM+M+SG
xuxazinhos	xuxa+N+DIM+M+PL
xuxinha	xuxa+N+DIM+SG
xuxinhas	xuxa+N+DIM+PL
xuxinho	xuxo+N+DIM+M+SG
xuxinhos	xuxo+N+DIM+M+PL
xuxo	xuxo+N+M+SG
xuxos	xuxo+N+M+PL
xuxozinho	xuxo+N+DIM+M+SG
xuxozinhos	xuxo+N+DIM+M+PL
xuezinho	xué+N+DIM+M+SG
xuezinhos	xué+N+DIM+M+PL
xué	xué+N+M+SG
xués	xué+N+M+PL
xazinho	xá+N+DIM+M+SG
xazinhos	xá+N+DIM+M+PL
xá	xá+N+M+SG
xás	xá+N+M+PL
xabegazinha	xábega+N+DIM+F+SG
xabegazinhas	xábega+N+DIM+F+PL
xabeguinha	xábega+N+DIM+F+SG
xabeguinhas	xábega+N+DIM+F+PL
xábega	xábega+N+F+SG
xábegas	xábega+N+F+PL
xacarazinha	xácara+N+DIM+F+SG
xacarazinhas	xácara+N+DIM+F+PL
xacarinha	xácara+N+DIM+F+SG
xacarinhas	xácara+N+DIM+F+PL
xácara	xácara+N+F+SG
xácaras	xácara+N+F+PL
xacomazinha	xácoma+N+DIM+F+SG
xacomazinhas	xácoma+N+DIM+F+PL
xacominha	xácoma+N+DIM+F+SG
xacominhas	xácoma+N+DIM+F+PL
xácoma	xácoma+N+F+SG
xácomas	xácoma+N+F+PL
xagarazinha	xágara+N+DIM+F+SG
xagarazinhas	xágara+N+DIM+F+PL
xagarinha	xágara+N+DIM+F+SG
xagarinhas	xágara+N+DIM+F+PL
xágara	xágara+N+F+SG
xágaras	xágara+N+F+PL
xaquemazinha	xáquema+N+DIM+F+SG
xaquemazinhas	xáquema+N+DIM+F+PL
xaqueminha	xáquema+N+DIM+F+SG
xaqueminhas	xáquema+N+DIM+F+PL
xáquema	xáquema+N+F+SG
xáquemas	xáquema+N+F+PL
xaquimazinha	xáquima+N+DIM+F+SG
xaquimazinhas	xáquima+N+DIM+F+PL
xaquiminha	xáquima+N+DIM+F+SG
xaquiminhas	xáquima+N+DIM+F+PL
xáquima	xáquima+N+F+SG
xáquimas	xáquima+N+F+PL
xatriazinho	xátria+N+DIM+M+SG
xatriazinhos	xátria+N+DIM+M+PL
xatrinha	xátria+N+DIM+M+SG
xatrinhas	xátria+N+DIM+M+PL
xátria	xátria+N+M+SG
xátrias	xátria+N+M+PL
xavegazinha	xávega+N+DIM+F+SG
xavegazinhas	xávega+N+DIM+F+PL
xaveguinha	xávega+N+DIM+F+SG
xaveguinhas	xávega+N+DIM+F+PL
xávega	xávega+N+F+SG
xávegas	xávega+N+F+PL
xantinho	xântio+N+DIM+M+SG
xantinhos	xântio+N+DIM+M+PL
xantiozinho	xântio+N+DIM+M+SG
xantiozinhos	xântio+N+DIM+M+PL
xântio	xântio+N+M+SG
xântios	xântio+N+M+PL
xeniazinha	xénia+N+DIM+F+SG
xeniazinhas	xénia+N+DIM+F+PL
xeninha	xénia+N+DIM+F+SG
xeninhas	xénia+N+DIM+F+PL
xénia	xénia+N+F+SG
xénias	xénia+N+F+PL
xeninho	xénio+N+DIM+M+SG
xeninhos	xénio+N+DIM+M+PL
xeniozinho	xénio+N+DIM+M+SG
xeniozinhos	xénio+N+DIM+M+PL
xénio	xénio+N+M+SG
xénios	xénio+N+M+PL
xenonzinho	xénon+N+DIM+M+SG
xenonzinhos	xénon+N+DIM+M+PL
xénon	xénon+N+M+SG
xénons	xénon+N+M+PL
xeroxzinho	xérox+N+DIM+M+SG
xeroxzinhos	xérox+N+DIM+M+PL
xérox	xérox+N+M+SG
xéroxs	xérox+N+M+PL
xeuzinho	xéu+N+DIM+M+SG
xeuzinhos	xéu+N+DIM+M+PL
xéu	xéu+N+M+SG
xéus	xéu+N+M+PL
xeniazinha	xênia+N+DIM+F+SG
xeniazinhas	xênia+N+DIM+F+PL
xeninha	xênia+N+DIM+F+SG
xeninhas	xênia+N+DIM+F+PL
xênia	xênia+N+F+SG
xênias	xênia+N+F+PL
xeninho	xênio+N+DIM+M+SG
xeninhos	xênio+N+DIM+M+PL
xeniozinho	xênio+N+DIM+M+SG
xeniozinhos	xênio+N+DIM+M+PL
xênio	xênio+N+M+SG
xênios	xênio+N+M+PL
xenonezinhos	xênon+N+DIM+M+PL
xenonzinho	xênon+N+DIM+M+SG
xenonzinhos	xênon+N+DIM+M+PL
xênon	xênon+N+M+SG
xênones	xênon+N+M+PL
xênons	xênon+N+M+PL
xicarazinha	xícara+N+DIM+F+SG
xicarazinhas	xícara+N+DIM+F+PL
xicarinha	xícara+N+DIM+F+SG
xicarinhas	xícara+N+DIM+F+PL
xicrinha	xícara+N+DIM+F+SG
xicrinhas	xícara+N+DIM+F+PL
xícara	xícara+N+F+SG
xícaras	xícara+N+F+PL
xifinho	xífio+N+DIM+M+SG
xifinhos	xífio+N+DIM+M+PL
xifiozinho	xífio+N+DIM+M+SG
xifiozinhos	xífio+N+DIM+M+PL
xífio	xífio+N+M+SG
xífios	xífio+N+M+PL
xilonezinhos	xílon+N+DIM+M+PL
xilonzinho	xílon+N+DIM+M+SG
xílon	xílon+N+M+SG
xílones	xílon+N+M+PL
