k	k+N+M+SG
kk	k+N+M+PL
kV	kV+N
kW	kW+N
kWh	kWh+N
kabuqui	kabuqui+N+M+SG
kabuquis	kabuqui+N+M+PL
kabuquizinho	kabuqui+N+DIM+M+SG
kabuquizinhos	kabuqui+N+DIM+M+PL
kaiser	kaiser+N+M+SG
kaiseres	kaiser+N+M+PL
kaiserezinhos	kaiser+N+DIM+M+PL
kaiserzinho	kaiser+N+DIM+M+SG
kaiserzinhos	kaiser+N+DIM+M+PL
kamikaze	kamikaze+N+M+SG
kamikazes	kamikaze+N+M+PL
kamikazezinho	kamikaze+N+DIM+M+SG
kamikazezinhos	kamikaze+N+DIM+M+PL
kamikazinho	kamikaze+N+DIM+M+SG
kamikazinhos	kamikaze+N+DIM+M+PL
kanga	kanga+N+M+SG
kangas	kanga+N+M+PL
kangazinho	kanga+N+DIM+M+SG
kangazinhos	kanga+N+DIM+M+PL
kanguinha	kanga+N+DIM+M+SG
kanguinhas	kanga+N+DIM+M+PL
kantisminho	kantismo+N+DIM+M+SG
kantisminhos	kantismo+N+DIM+M+PL
kantismo	kantismo+N+M+SG
kantismos	kantismo+N+M+PL
kantismozinho	kantismo+N+DIM+M+SG
kantismozinhos	kantismo+N+DIM+M+PL
kantista	kantista+N+SG
kantistas	kantista+N+PL
kantistazinha	kantista+N+DIM+F+SG
kantistazinhas	kantista+N+DIM+F+PL
kantistazinho	kantista+N+DIM+M+SG
kantistazinhos	kantista+N+DIM+M+PL
kantistinha	kantista+N+DIM+SG
kantistinhas	kantista+N+DIM+PL
karaokezinho	karaokê+N+DIM+M+SG
karaokê	karaokê+N+M+SG
karatezinho	karaté+N+DIM+M+SG
karatezinhos	karaté+N+DIM+M+PL
karaté	karaté+N+M+SG
karatés	karaté+N+M+PL
karrinho	karro+N+DIM+M+SG
karrinhos	karro+N+DIM+M+PL
karro	karro+N+M+SG
karros	karro+N+M+PL
karrozinho	karro+N+DIM+M+SG
karrozinhos	karro+N+DIM+M+PL
kart	kart+N+M+SG
karts	kart+N+M+PL
kartzinho	kart+N+DIM+M+SG
kartzinhos	kart+N+DIM+M+PL
karting	karting+N+M+SG
kartings	karting+N+M+PL
kartingzinho	karting+N+DIM+M+SG
kartingzinhos	karting+N+DIM+M+PL
kartisminho	kartismo+N+DIM+M+SG
kartisminhos	kartismo+N+DIM+M+PL
kartismo	kartismo+N+M+SG
kartismos	kartismo+N+M+PL
kartismozinho	kartismo+N+DIM+M+SG
kartismozinhos	kartismo+N+DIM+M+PL
kartista	kartista+N+SG
kartistas	kartista+N+PL
kartistazinha	kartista+N+DIM+F+SG
kartistazinhas	kartista+N+DIM+F+PL
kartistazinho	kartista+N+DIM+M+SG
kartistazinhos	kartista+N+DIM+M+PL
kartistinha	kartista+N+DIM+SG
kartistinhas	kartista+N+DIM+PL
kartodrominho	kartódromo+N+DIM+M+SG
kartodrominhos	kartódromo+N+DIM+M+PL
kartodromozinho	kartódromo+N+DIM+M+SG
kartodromozinhos	kartódromo+N+DIM+M+PL
kartódromo	kartódromo+N+M+SG
kartódromos	kartódromo+N+M+PL
kayak-polinho	kayak-polo+N+DIM+M+SG
kayak-polinhos	kayak-polo+N+DIM+M+PL
kayak-polo	kayak-polo+N+M+SG
kayak-polozinho	kayak-polo+N+DIM+M+SG
kazanianinho	kazaniano+N+DIM+M+SG
kazanianinhos	kazaniano+N+DIM+M+PL
kazaniano	kazaniano+N+M+SG
kazanianos	kazaniano+N+M+PL
kazanianozinho	kazaniano+N+DIM+M+SG
kazanianozinhos	kazaniano+N+DIM+M+PL
kbyte	kbyte+N+M+SG
kbytes	kbyte+N+M+PL
kbytezinho	kbyte+N+DIM+M+SG
kbytezinhos	kbyte+N+DIM+M+PL
kbytinho	kbyte+N+DIM+M+SG
kbytinhos	kbyte+N+DIM+M+PL
kc	kc+N
keewatinianinho	keewatiniano+N+DIM+M+SG
keewatinianinhos	keewatiniano+N+DIM+M+PL
keewatiniano	keewatiniano+N+M+SG
keewatinianos	keewatiniano+N+M+PL
keewatinianozinho	keewatiniano+N+DIM+M+SG
keewatinianozinhos	keewatiniano+N+DIM+M+PL
kelper	kelper+N+M+SG
kelperzinho	kelper+N+DIM+M+SG
kelvin	kelvin+N+M+SG
kelvins	kelvin+N+M+PL
kelvinzinho	kelvin+N+DIM+M+SG
kelvinzinhos	kelvin+N+DIM+M+PL
kepleriazinha	kepléria+N+DIM+F+SG
kepleriazinhas	kepléria+N+DIM+F+PL
keplerinha	kepléria+N+DIM+F+SG
keplerinhas	kepléria+N+DIM+F+PL
kepléria	kepléria+N+F+SG
keplérias	kepléria+N+F+PL
ketchup	ketchup+N+M+SG
ketchups	ketchup+N+M+PL
ketchupzinho	ketchup+N+DIM+M+SG
ketchupzinhos	ketchup+N+DIM+M+PL
keuper	keuper+N+M+SG
keuperes	keuper+N+M+PL
keuperezinhos	keuper+N+DIM+M+PL
keuperzinho	keuper+N+DIM+M+SG
keuperzinhos	keuper+N+DIM+M+PL
keweenavianinho	keweenaviano+N+DIM+M+SG
keweenavianinhos	keweenaviano+N+DIM+M+PL
keweenaviano	keweenaviano+N+M+SG
keweenavianos	keweenaviano+N+M+PL
keweenavianozinho	keweenaviano+N+DIM+M+SG
keweenavianozinhos	keweenaviano+N+DIM+M+PL
keyboard	keyboard+N+M+SG
keyboards	keyboard+N+M+PL
keyboardzinho	keyboard+N+DIM+M+SG
keyboardzinhos	keyboard+N+DIM+M+PL
keynesiana	keynesiano+N+F+SG
keynesianas	keynesiano+N+F+PL
keynesianazinha	keynesiano+N+DIM+F+SG
keynesianazinhas	keynesiano+N+DIM+F+PL
keynesianinha	keynesiano+N+DIM+F+SG
keynesianinhas	keynesiano+N+DIM+F+PL
keynesianinho	keynesiano+N+DIM+M+SG
keynesianinhos	keynesiano+N+DIM+M+PL
keynesiano	keynesiano+N+M+SG
keynesianos	keynesiano+N+M+PL
keynesianozinho	keynesiano+N+DIM+M+SG
keynesianozinhos	keynesiano+N+DIM+M+PL
kg	kg+N
kgm	kgm+N
ki	ki+N+M+SG
kizinho	ki+N+DIM+M+SG
kibutz	kibutz+N+M+SG
kibutzinho	kibutz+N+DIM+M+SG
kick-boxing	kick-boxing+N+M
kick-boxingzinho	kick-boxing+N+DIM+M+SG
kick-boxingzinhos	kick-boxing+N+DIM+M+PL
killer	killer+N+M+SG
killers	killer+N+M+PL
killerzinho	killer+N+DIM+M+SG
killerzinhos	killer+N+DIM+M+PL
kilojoule	kilojoule+N+M+SG
kilojoules	kilojoule+N+M+PL
kilojoulezinho	kilojoule+N+DIM+M+SG
kilojoulezinhos	kilojoule+N+DIM+M+PL
kilojoulinho	kilojoule+N+DIM+M+SG
kilojoulinhos	kilojoule+N+DIM+M+PL
kilotão	kilotão+N+M+SG
kilotãozinho	kilotão+N+DIM+M+SG
kilotões	kilotão+N+M+PL
kilotõezinhos	kilotão+N+DIM+M+PL
kilovolt	kilovolt+N
kilovoltzinha	kilovolt+N+DIM+F+SG
kilovoltzinhas	kilovolt+N+DIM+F+PL
kilovoltzinho	kilovolt+N+DIM+M+SG
kilovoltzinhos	kilovolt+N+DIM+M+PL
kilowatt	kilowatt+N
kilowattzinha	kilowatt+N+DIM+F+SG
kilowattzinhas	kilowatt+N+DIM+F+PL
kilowattzinho	kilowatt+N+DIM+M+SG
kilowattzinhos	kilowatt+N+DIM+M+PL
kilt	kilt+N+M+SG
kilts	kilt+N+M+PL
kiltzinho	kilt+N+DIM+M+SG
kiltzinhos	kilt+N+DIM+M+PL
kimberlite	kimberlite+N+F+SG
kimberlites	kimberlite+N+F+PL
kimberlitezinha	kimberlite+N+DIM+F+SG
kimberlitezinhas	kimberlite+N+DIM+F+PL
kimberlitinha	kimberlite+N+DIM+F+SG
kimberlitinhas	kimberlite+N+DIM+F+PL
kimeridgianinho	kimeridgiano+N+DIM+M+SG
kimeridgianinhos	kimeridgiano+N+DIM+M+PL
kimeridgiano	kimeridgiano+N+M+SG
kimeridgianos	kimeridgiano+N+M+PL
kimeridgianozinho	kimeridgiano+N+DIM+M+SG
kimeridgianozinhos	kimeridgiano+N+DIM+M+PL
king	king+N+M+SG
kings	king+N+M+PL
kingzinho	king+N+DIM+M+SG
kingzinhos	king+N+DIM+M+PL
kirsch	kirsch+N+M+SG
kirschzinho	kirsch+N+DIM+M+SG
kirsh	kirsh+N+M+SG
kirshzinho	kirsh+N+DIM+M+SG
kit	kit+N+M+SG
kits	kit+N+M+PL
kitzinho	kit+N+DIM+M+SG
kitzinhos	kit+N+DIM+M+PL
kitchenette	kitchenette+N+F+SG
kitchenettes	kitchenette+N+F+PL
kitchenettezinha	kitchenette+N+DIM+F+SG
kitchenettezinhas	kitchenette+N+DIM+F+PL
kitchenettinha	kitchenette+N+DIM+F+SG
kitchenettinhas	kitchenette+N+DIM+F+PL
kitsch	kitsch+N+M+SG
kitschzinho	kitsch+N+DIM+M+SG
kiwi	kiwi+N+M+SG
kiwis	kiwi+N+M+PL
kiwizinho	kiwi+N+DIM+M+SG
kiwizinhos	kiwi+N+DIM+M+PL
kj	kj+N
kk	kk+N
kl	kl+N
klaxon	klaxon+N+M+SG
klaxonzinho	klaxon+N+DIM+M+SG
km	km+N
kneippisminho	kneippismo+N+DIM+M+SG
kneippisminhos	kneippismo+N+DIM+M+PL
kneippismo	kneippismo+N+M+SG
kneippismos	kneippismo+N+M+PL
kneippismozinho	kneippismo+N+DIM+M+SG
kneippismozinhos	kneippismo+N+DIM+M+PL
kneippista	kneippista+N+SG
kneippistas	kneippista+N+PL
kneippistazinha	kneippista+N+DIM+F+SG
kneippistazinhas	kneippista+N+DIM+F+PL
kneippistazinho	kneippista+N+DIM+M+SG
kneippistazinhos	kneippista+N+DIM+M+PL
kneippistinha	kneippista+N+DIM+SG
kneippistinhas	kneippista+N+DIM+PL
knob	knob+N+M+SG
knobzinho	knob+N+DIM+M+SG
knock-out	knock-out+N+M+SG
knock-outzinho	knock-out+N+DIM+M+SG
know-how	know-how+N+M
know-howzinho	know-how+N+DIM+M+SG
know-howzinhos	know-how+N+DIM+M+PL
krach	krach+N+M+SG
krachzinho	krach+N+DIM+M+SG
kremlim	kremlim+N+M+SG
kremlins	kremlim+N+M+PL
kremlinzinho	kremlim+N+DIM+M+SG
kremlinzinhos	kremlim+N+DIM+M+PL
kremlin	kremlin+N+M+SG
kremlinzinho	kremlin+N+DIM+M+SG
kungurianinho	kunguriano+N+DIM+M+SG
kungurianinhos	kunguriano+N+DIM+M+PL
kunguriano	kunguriano+N+M+SG
kungurianos	kunguriano+N+M+PL
kungurianozinho	kunguriano+N+DIM+M+SG
kungurianozinhos	kunguriano+N+DIM+M+PL
kyogen	kyogen+N+M+SG
kyogenzinho	kyogen+N+DIM+M+SG
kyrie	kyrie+N+M
kyriezinho	kyrie+N+DIM+M+SG
kyriezinhos	kyrie+N+DIM+M+PL
kyrinho	kyrie+N+DIM+M+SG
kyrinhos	kyrie+N+DIM+M+PL
kiriezinho	kírie+N+DIM+M+SG
kiriezinhos	kírie+N+DIM+M+PL
kirinho	kírie+N+DIM+M+SG
kirinhos	kírie+N+DIM+M+PL
kírie	kírie+N+M+SG
kíries	kírie+N+M+PL
kümmel	kümmel+N+M+SG
kümmelzinho	kümmel+N+DIM+M+SG
