j	j+N+M+SG
jj	j+N+M+PL
jaaraboazinho	jaaraboá+N+DIM+M+SG
jaaraboazinhos	jaaraboá+N+DIM+M+PL
jaaraboá	jaaraboá+N+M+SG
jaaraboás	jaaraboá+N+M+PL
jabiru	jabiru+N+M+SG
jabirus	jabiru+N+M+PL
jabiruzinho	jabiru+N+DIM+M+SG
jabiruzinhos	jabiru+N+DIM+M+PL
jabita	jabita+N+M+SG
jabitas	jabita+N+M+PL
jabitazinho	jabita+N+DIM+M+SG
jabitazinhos	jabita+N+DIM+M+PL
jabitinha	jabita+N+DIM+M+SG
jabitinhas	jabita+N+DIM+M+PL
jabota	jabota+N+F+SG
jabotas	jabota+N+F+PL
jabotazinha	jabota+N+DIM+F+SG
jabotazinhas	jabota+N+DIM+F+PL
jabotinha	jabota+N+DIM+F+SG
jabotinhas	jabota+N+DIM+F+PL
jaboti	jaboti+N+M+SG
jabotis	jaboti+N+M+PL
jabotizinho	jaboti+N+DIM+M+SG
jabotizinhos	jaboti+N+DIM+M+PL
jaburu	jaburu+N+M+SG
jaburus	jaburu+N+M+PL
jaburuzinho	jaburu+N+DIM+M+SG
jaburuzinhos	jaburu+N+DIM+M+PL
jabuti	jabuti+N+M+SG
jabutis	jabuti+N+M+PL
jabutizinho	jabuti+N+DIM+M+SG
jabutizinhos	jabuti+N+DIM+M+PL
jabutiboia	jabutiboia+N+F+SG
jabutiboias	jabutiboia+N+F+PL
jabutiboiazinha	jabutiboia+N+DIM+F+SG
jabutiboiazinhas	jabutiboia+N+DIM+F+PL
jabutiboinha	jabutiboia+N+DIM+F+SG
jabutiboinhas	jabutiboia+N+DIM+F+PL
jabuticaba	jabuticaba+N+F+SG
jabuticabas	jabuticaba+N+F+PL
jabuticabazinha	jabuticaba+N+DIM+F+SG
jabuticabazinhas	jabuticaba+N+DIM+F+PL
jabuticabinha	jabuticaba+N+DIM+F+SG
jabuticabinhas	jabuticaba+N+DIM+F+PL
jabuticabais	jabuticabal+N+M+PL
jabuticabaizinhos	jabuticabal+N+DIM+M+PL
jabuticabal	jabuticabal+N+M+SG
jabuticabalzinho	jabuticabal+N+DIM+M+SG
jabuticabeira	jabuticabeira+N+F+SG
jabuticabeiras	jabuticabeira+N+F+PL
jabuticabeirazinha	jabuticabeira+N+DIM+F+SG
jabuticabeirazinhas	jabuticabeira+N+DIM+F+PL
jabuticabeirinha	jabuticabeira+N+DIM+F+SG
jabuticabeirinhas	jabuticabeira+N+DIM+F+PL
jabutim	jabutim+N+M+SG
jabutins	jabutim+N+M+PL
jabutinzinho	jabutim+N+DIM+M+SG
jabutinzinhos	jabutim+N+DIM+M+PL
jabazinho	jabá+N+DIM+M+SG
jabazinhos	jabá+N+DIM+M+PL
jabá	jabá+N+M+SG
jabás	jabá+N+M+PL
jaca	jaca+N+SG
jacas	jaca+N+PL
jacazinha	jaca+N+DIM+F+SG
jacazinhas	jaca+N+DIM+F+PL
jacazinho	jaca+N+DIM+M+SG
jacazinhos	jaca+N+DIM+M+PL
jaquinha	jaca+N+DIM+SG
jaquinhas	jaca+N+DIM+PL
jacami	jacami+N+M+SG
jacamis	jacami+N+M+PL
jacamizinho	jacami+N+DIM+M+SG
jacamizinhos	jacami+N+DIM+M+PL
jacamim	jacamim+N+M+SG
jacamins	jacamim+N+M+PL
jacaminzinho	jacamim+N+DIM+M+SG
jacaminzinhos	jacamim+N+DIM+M+PL
jacapucaia	jacapucaia+N+M+SG
jacapucaias	jacapucaia+N+M+PL
jacapucaiazinho	jacapucaia+N+DIM+M+SG
jacapucaiazinhos	jacapucaia+N+DIM+M+PL
jacapucainha	jacapucaia+N+DIM+M+SG
jacapucainhas	jacapucaia+N+DIM+M+PL
jacarandana	jacarandana+N+F+SG
jacarandanas	jacarandana+N+F+PL
jacarandanazinha	jacarandana+N+DIM+F+SG
jacarandanazinhas	jacarandana+N+DIM+F+PL
jacarandaninha	jacarandana+N+DIM+F+SG
jacarandaninhas	jacarandana+N+DIM+F+PL
jacarandazinho	jacarandá+N+DIM+M+SG
jacarandazinhos	jacarandá+N+DIM+M+PL
jacarandá	jacarandá+N+M+SG
jacarandás	jacarandá+N+M+PL
jacarandA§-paulistazinho	jacarandá-paulista+N+DIM+M+SG
jacarandA§-paulistinha	jacarandá-paulista+N+DIM+M+SG
jacarandA§-paulistinhas	jacarandá-paulista+N+DIM+M+PL
jacarandA§s-paulistazinhos	jacarandá-paulista+N+DIM+M+PL
jacarandá-paulista	jacarandá-paulista+N+M+SG
jacarandás-paulistas	jacarandá-paulista+N+M+PL
jacaratinga	jacaratinga+N+F+SG
jacaratingas	jacaratinga+N+F+PL
jacaratingazinha	jacaratinga+N+DIM+F+SG
jacaratingazinhas	jacaratinga+N+DIM+F+PL
jacaratinguinha	jacaratinga+N+DIM+F+SG
jacaratinguinhas	jacaratinga+N+DIM+F+PL
jacaratiazinha	jacaratiá+N+DIM+F+SG
jacaratiazinhas	jacaratiá+N+DIM+F+PL
jacaratiá	jacaratiá+N+F+SG
jacaratiás	jacaratiá+N+F+PL
jacaretinga	jacaretinga+N+M+SG
jacaretingas	jacaretinga+N+M+PL
jacaretingazinho	jacaretinga+N+DIM+M+SG
jacaretingazinhos	jacaretinga+N+DIM+M+PL
jacaretinguinha	jacaretinga+N+DIM+M+SG
jacaretinguinhas	jacaretinga+N+DIM+M+PL
jacareibazinha	jacareíba+N+DIM+F+SG
jacareibazinhas	jacareíba+N+DIM+F+PL
jacareibinha	jacareíba+N+DIM+F+SG
jacareibinhas	jacareíba+N+DIM+F+PL
jacareíba	jacareíba+N+F+SG
jacareíbas	jacareíba+N+F+PL
jacareubazinha	jacareúba+N+DIM+F+SG
jacareubazinhas	jacareúba+N+DIM+F+PL
jacareubinha	jacareúba+N+DIM+F+SG
jacareubinhas	jacareúba+N+DIM+F+PL
jacareúba	jacareúba+N+F+SG
jacareúbas	jacareúba+N+F+PL
jacareuvazinho	jacareúva+N+DIM+M+SG
jacareuvazinhos	jacareúva+N+DIM+M+PL
jacareuvinha	jacareúva+N+DIM+M+SG
jacareuvinhas	jacareúva+N+DIM+M+PL
jacareúva	jacareúva+N+M+SG
jacareúvas	jacareúva+N+M+PL
jacarina	jacarina+N+F+SG
jacarinas	jacarina+N+F+PL
jacarinazinha	jacarina+N+DIM+F+SG
jacarinazinhas	jacarina+N+DIM+F+PL
jacarininha	jacarina+N+DIM+F+SG
jacarininhas	jacarina+N+DIM+F+PL
jacarini	jacarini+N+M+SG
jacarinis	jacarini+N+M+PL
jacarinizinho	jacarini+N+DIM+M+SG
jacarinizinhos	jacarini+N+DIM+M+PL
jacaraciazinha	jacarácia+N+DIM+F+SG
jacaraciazinhas	jacarácia+N+DIM+F+PL
jacaracinha	jacarácia+N+DIM+F+SG
jacaracinhas	jacarácia+N+DIM+F+PL
jacarácia	jacarácia+N+F+SG
jacarácias	jacarácia+N+F+PL
jacarezinho	jacaré+N+DIM+M+SG
jacarezinhos	jacaré+N+DIM+M+PL
jacaré	jacaré+N+M+SG
jacarés	jacaré+N+M+PL
jacatirão	jacatirão+N+M+SG
jacatirãozinho	jacatirão+N+DIM+M+SG
jacatirões	jacatirão+N+M+PL
jacatirõezinhos	jacatirão+N+DIM+M+PL
jacatupezinho	jacatupé+N+DIM+M+SG
jacatupezinhos	jacatupé+N+DIM+M+PL
jacatupé	jacatupé+N+M+SG
jacatupés	jacatupé+N+M+PL
jacente	jacente+N+M+SG
jacentes	jacente+N+M+PL
jacentezinho	jacente+N+DIM+M+SG
jacentezinhos	jacente+N+DIM+M+PL
jacentinho	jacente+N+DIM+M+SG
jacentinhos	jacente+N+DIM+M+PL
jacentes	jacentes+N+M+PL
jacentesinhas	jacentes+N+DIM+F+PL
jacentesinhos	jacentes+N+DIM+M+PL
jaci	jaci+N+M+SG
jacis	jaci+N+M+PL
jacizinho	jaci+N+DIM+M+SG
jacizinhos	jaci+N+DIM+M+PL
jacina	jacina+N+F+SG
jacinas	jacina+N+F+PL
jacinazinha	jacina+N+DIM+F+SG
jacinazinhas	jacina+N+DIM+F+PL
jacininha	jacina+N+DIM+F+SG
jacininhas	jacina+N+DIM+F+PL
jacinta	jacinta+N+F+SG
jacintas	jacinta+N+F+PL
jacintazinha	jacinta+N+DIM+F+SG
jacintazinhas	jacinta+N+DIM+F+PL
jacintinha	jacinta+N+DIM+F+SG
jacintinhas	jacinta+N+DIM+F+PL
jacintinho	jacinto+N+DIM+M+SG
jacintinhos	jacinto+N+DIM+M+PL
jacinto	jacinto+N+M+SG
jacintos	jacinto+N+M+PL
jacintozinho	jacinto+N+DIM+M+SG
jacintozinhos	jacinto+N+DIM+M+PL
jacinto-de-aguazinho	jacinto-de-água+N+DIM+M+SG
jacinto-de-aguinha	jacinto-de-água+N+DIM+M+SG
jacinto-de-aguinhas	jacinto-de-água+N+DIM+M+PL
jacinto-de-água	jacinto-de-água+N+M+SG
jacintos-de-aguazinhos	jacinto-de-água+N+DIM+M+PL
jacintos-de-água	jacinto-de-água+N+M+PL
jackpot	jackpot+N+M+SG
jackpots	jackpot+N+M+PL
jackpotzinho	jackpot+N+DIM+M+SG
jackpotzinhos	jackpot+N+DIM+M+PL
jacksoniazinha	jacksónia+N+DIM+F+SG
jacksoniazinhas	jacksónia+N+DIM+F+PL
jacksoninha	jacksónia+N+DIM+F+SG
jacksoninhas	jacksónia+N+DIM+F+PL
jacksónia	jacksónia+N+F+SG
jacksónias	jacksónia+N+F+PL
jacksoniazinha	jacksônia+N+DIM+F+SG
jacksoniazinhas	jacksônia+N+DIM+F+PL
jacksoninha	jacksônia+N+DIM+F+SG
jacksoninhas	jacksônia+N+DIM+F+PL
jacksônia	jacksônia+N+F+SG
jacksônias	jacksônia+N+F+PL
jacobeia	jacobeia+N+F+SG
jacobeias	jacobeia+N+F+PL
jacobeiazinha	jacobeia+N+DIM+F+SG
jacobeiazinhas	jacobeia+N+DIM+F+PL
jacobeinha	jacobeia+N+DIM+F+SG
jacobeinhas	jacobeia+N+DIM+F+PL
jacobeia	jacobeu+N+F+SG
jacobeias	jacobeu+N+F+PL
jacobeiazinha	jacobeu+N+DIM+F+SG
jacobeiazinhas	jacobeu+N+DIM+F+PL
jacobeinha	jacobeu+N+DIM+F+SG
jacobeinhas	jacobeu+N+DIM+F+PL
jacobeu	jacobeu+N+M+SG
jacobeus	jacobeu+N+M+PL
jacobeuzinho	jacobeu+N+DIM+M+SG
jacobeuzinhos	jacobeu+N+DIM+M+PL
jacobianinho	jacobiano+N+DIM+M+SG
jacobianinhos	jacobiano+N+DIM+M+PL
jacobiano	jacobiano+N+M+SG
jacobianos	jacobiano+N+M+PL
jacobianozinho	jacobiano+N+DIM+M+SG
jacobianozinhos	jacobiano+N+DIM+M+PL
jacobice	jacobice+N+F+SG
jacobices	jacobice+N+F+PL
jacobicezinha	jacobice+N+DIM+F+SG
jacobicezinhas	jacobice+N+DIM+F+PL
jacobicinha	jacobice+N+DIM+F+SG
jacobicinhas	jacobice+N+DIM+F+PL
jacobinice	jacobinice+N+F+SG
jacobinices	jacobinice+N+F+PL
jacobinicezinha	jacobinice+N+DIM+F+SG
jacobinicezinhas	jacobinice+N+DIM+F+PL
jacobinicinha	jacobinice+N+DIM+F+SG
jacobinicinhas	jacobinice+N+DIM+F+PL
jacobinisminho	jacobinismo+N+DIM+M+SG
jacobinisminhos	jacobinismo+N+DIM+M+PL
jacobinismo	jacobinismo+N+M+SG
jacobinismos	jacobinismo+N+M+PL
jacobinismozinho	jacobinismo+N+DIM+M+SG
jacobinismozinhos	jacobinismo+N+DIM+M+PL
jacobina	jacobino+N+F+SG
jacobinas	jacobino+N+F+PL
jacobinazinha	jacobino+N+DIM+F+SG
jacobinazinhas	jacobino+N+DIM+F+PL
jacobininha	jacobino+N+DIM+F+SG
jacobininhas	jacobino+N+DIM+F+PL
jacobininho	jacobino+N+DIM+M+SG
jacobininhos	jacobino+N+DIM+M+PL
jacobino	jacobino+N+M+SG
jacobinos	jacobino+N+M+PL
jacobinozinho	jacobino+N+DIM+M+SG
jacobinozinhos	jacobino+N+DIM+M+PL
jacobita	jacobita+N+SG
jacobitas	jacobita+N+PL
jacobitazinha	jacobita+N+DIM+F+SG
jacobitazinhas	jacobita+N+DIM+F+PL
jacobitazinho	jacobita+N+DIM+M+SG
jacobitazinhos	jacobita+N+DIM+M+PL
jacobitinha	jacobita+N+DIM+SG
jacobitinhas	jacobita+N+DIM+PL
jacoralidade	jacoralidade+N+F+SG
jacoralidades	jacoralidade+N+F+PL
jacoralidadezinha	jacoralidade+N+DIM+F+SG
jacoralidadezinhas	jacoralidade+N+DIM+F+PL
jacoralidadinha	jacoralidade+N+DIM+F+SG
jacoralidadinhas	jacoralidade+N+DIM+F+PL
jacre	jacre+N+M+SG
jacres	jacre+N+M+PL
jacrezinho	jacre+N+DIM+M+SG
jacrezinhos	jacre+N+DIM+M+PL
jacrinho	jacre+N+DIM+M+SG
jacrinhos	jacre+N+DIM+M+PL
jactanciosidade	jactanciosidade+N+F+SG
jactanciosidades	jactanciosidade+N+F+PL
jactanciosidadezinha	jactanciosidade+N+DIM+F+SG
jactanciosidadezinhas	jactanciosidade+N+DIM+F+PL
jactanciosidadinha	jactanciosidade+N+DIM+F+SG
jactanciosidadinhas	jactanciosidade+N+DIM+F+PL
jactinho	jacto+N+DIM+M+SG
jactinhos	jacto+N+DIM+M+PL
jacto	jacto+N+M+SG
jactos	jacto+N+M+PL
jactozinho	jacto+N+DIM+M+SG
jactozinhos	jacto+N+DIM+M+PL
jactoplanador	jactoplanador+N+M+SG
jactoplanadores	jactoplanador+N+M+PL
jactoplanadorezinhos	jactoplanador+N+DIM+M+PL
jactoplanadorzinho	jactoplanador+N+DIM+M+SG
jactoplanadorzinhos	jactoplanador+N+DIM+M+PL
jactura	jactura+N+F+SG
jacturas	jactura+N+F+PL
jacturazinha	jactura+N+DIM+F+SG
jacturazinhas	jactura+N+DIM+F+PL
jacturinha	jactura+N+DIM+F+SG
jacturinhas	jactura+N+DIM+F+PL
jactanciazinha	jactância+N+DIM+F+SG
jactanciazinhas	jactância+N+DIM+F+PL
jactancinha	jactância+N+DIM+F+SG
jactancinhas	jactância+N+DIM+F+PL
jactância	jactância+N+F+SG
jactâncias	jactância+N+F+PL
jacu	jacu+N+M+SG
jacus	jacu+N+M+PL
jacuzinho	jacu+N+DIM+M+SG
jacuzinhos	jacu+N+DIM+M+PL
jacuacanga	jacuacanga+N+F+SG
jacuacangas	jacuacanga+N+F+PL
jacuacangazinha	jacuacanga+N+DIM+F+SG
jacuacangazinhas	jacuacanga+N+DIM+F+PL
jacuacanguinha	jacuacanga+N+DIM+F+SG
jacuacanguinhas	jacuacanga+N+DIM+F+PL
jacuba	jacuba+N+F+SG
jacubas	jacuba+N+F+PL
jacubazinha	jacuba+N+DIM+F+SG
jacubazinhas	jacuba+N+DIM+F+PL
jacubinha	jacuba+N+DIM+F+SG
jacubinhas	jacuba+N+DIM+F+PL
jaculatoriazinha	jaculatória+N+DIM+F+SG
jaculatoriazinhas	jaculatória+N+DIM+F+PL
jaculatorinha	jaculatória+N+DIM+F+SG
jaculatorinhas	jaculatória+N+DIM+F+PL
jaculatória	jaculatória+N+F+SG
jaculatórias	jaculatória+N+F+PL
jaculatoriazinha	jaculatório+N+DIM+F+SG
jaculatoriazinhas	jaculatório+N+DIM+F+PL
jaculatorinha	jaculatório+N+DIM+F+SG
jaculatorinhas	jaculatório+N+DIM+F+PL
jaculatorinho	jaculatório+N+DIM+M+SG
jaculatorinhos	jaculatório+N+DIM+M+PL
jaculatoriozinho	jaculatório+N+DIM+M+SG
jaculatoriozinhos	jaculatório+N+DIM+M+PL
jaculatória	jaculatório+N+F+SG
jaculatórias	jaculatório+N+F+PL
jaculatório	jaculatório+N+M+SG
jaculatórios	jaculatório+N+M+PL
jaculação	jaculação+N+F+SG
jaculaçãozinha	jaculação+N+DIM+F+SG
jaculações	jaculação+N+F+PL
jaculaçõezinhas	jaculação+N+DIM+F+PL
jacumã	jacumã+N+M+SG
jacumãs	jacumã+N+M+PL
jacumãzinho	jacumã+N+DIM+M+SG
jacumãzinhos	jacumã+N+DIM+M+PL
jacundazinho	jacundá+N+DIM+M+SG
jacundazinhos	jacundá+N+DIM+M+PL
jacundá	jacundá+N+M+SG
jacundás	jacundá+N+M+PL
jacupemba	jacupemba+N+SG
jacupembas	jacupemba+N+PL
jacupembazinha	jacupemba+N+DIM+F+SG
jacupembazinhas	jacupemba+N+DIM+F+PL
jacupembazinho	jacupemba+N+DIM+M+SG
jacupembazinhos	jacupemba+N+DIM+M+PL
jacupembinha	jacupemba+N+DIM+SG
jacupembinhas	jacupemba+N+DIM+PL
jacupiranguite	jacupiranguite+N+F+SG
jacupiranguites	jacupiranguite+N+F+PL
jacupiranguitezinha	jacupiranguite+N+DIM+F+SG
jacupiranguitezinhas	jacupiranguite+N+DIM+F+PL
jacupiranguitinha	jacupiranguite+N+DIM+F+SG
jacupiranguitinhas	jacupiranguite+N+DIM+F+PL
jacuru	jacuru+N+M+SG
jacurus	jacuru+N+M+PL
jacuruzinho	jacuru+N+DIM+M+SG
jacuruzinhos	jacuru+N+DIM+M+PL
jacuruaru	jacuruaru+N+M+SG
jacuruarus	jacuruaru+N+M+PL
jacuruaruzinho	jacuruaru+N+DIM+M+SG
jacuruaruzinhos	jacuruaru+N+DIM+M+PL
jacutinga	jacutinga+N+F+SG
jacutingas	jacutinga+N+F+PL
jacutingazinha	jacutinga+N+DIM+F+SG
jacutingazinhas	jacutinga+N+DIM+F+PL
jacutinguinha	jacutinga+N+DIM+F+SG
jacutinguinhas	jacutinga+N+DIM+F+PL
jacuibazinha	jacuíba+N+DIM+F+SG
jacuibazinhas	jacuíba+N+DIM+F+PL
jacuibinha	jacuíba+N+DIM+F+SG
jacuibinhas	jacuíba+N+DIM+F+PL
jacuíba	jacuíba+N+F+SG
jacuíbas	jacuíba+N+F+PL
jacazinho	jacá+N+DIM+M+SG
jacazinhos	jacá+N+DIM+M+PL
jacá	jacá+N+M+SG
jacás	jacá+N+M+PL
jade	jade+N+M+SG
jades	jade+N+M+PL
jadezinho	jade+N+DIM+M+SG
jadezinhos	jade+N+DIM+M+PL
jadinho	jade+N+DIM+M+SG
jadinhos	jade+N+DIM+M+PL
jadeitezinha	jadeíte+N+DIM+F+SG
jadeitezinhas	jadeíte+N+DIM+F+PL
jadeitinha	jadeíte+N+DIM+F+SG
jadeitinhas	jadeíte+N+DIM+F+PL
jadeíte	jadeíte+N+F+SG
jadeítes	jadeíte+N+F+PL
jaez	jaez+N+M+SG
jaezes	jaez+N+M+PL
jaezezinhos	jaez+N+DIM+M+PL
jaezinho	jaez+N+DIM+M+SG
jaezinhos	jaez+N+DIM+M+PL
jafeticidade	jafeticidade+N+F+SG
jafeticidades	jafeticidade+N+F+PL
jafeticidadezinha	jafeticidade+N+DIM+F+SG
jafeticidadezinhas	jafeticidade+N+DIM+F+PL
jafeticidadinha	jafeticidade+N+DIM+F+SG
jafeticidadinhas	jafeticidade+N+DIM+F+PL
jaga	jaga+N+M+SG
jagas	jaga+N+M+PL
jagazinho	jaga+N+DIM+M+SG
jagazinhos	jaga+N+DIM+M+PL
jaguinha	jaga+N+DIM+M+SG
jaguinhas	jaga+N+DIM+M+PL
jagodes	jagodes+N+M+SG
jagodesinho	jagodes+N+DIM+M+SG
jagodesinhos	jagodes+N+DIM+M+PL
jagodess	jagodes+N+M+PL
jagra	jagra+N+F+SG
jagras	jagra+N+F+PL
jagrazinha	jagra+N+DIM+F+SG
jagrazinhas	jagra+N+DIM+F+PL
jagrinha	jagra+N+DIM+F+SG
jagrinhas	jagra+N+DIM+F+PL
jagre	jagre+N+M+SG
jagres	jagre+N+M+PL
jagrezinho	jagre+N+DIM+M+SG
jagrezinhos	jagre+N+DIM+M+PL
jagrinho	jagre+N+DIM+M+SG
jagrinhos	jagre+N+DIM+M+PL
jaguacatiguaçu	jaguacatiguaçu+N+M+SG
jaguacatiguaçus	jaguacatiguaçu+N+M+PL
jaguacatiguaçuzinho	jaguacatiguaçu+N+DIM+M+SG
jaguacatiguaçuzinhos	jaguacatiguaçu+N+DIM+M+PL
jaguacinim	jaguacinim+N+M+SG
jaguacinins	jaguacinim+N+M+PL
jaguacininzinho	jaguacinim+N+DIM+M+SG
jaguacininzinhos	jaguacinim+N+DIM+M+PL
jaguanezinho	jaguané+N+DIM+M+SG
jaguanezinhos	jaguané+N+DIM+M+PL
jaguané	jaguané+N+M+SG
jaguanés	jaguané+N+M+PL
jaguapezinho	jaguapé+N+DIM+M+SG
jaguapezinhos	jaguapé+N+DIM+M+PL
jaguapé	jaguapé+N+M+SG
jaguapés	jaguapé+N+M+PL
jaguar	jaguar+N+M+SG
jaguares	jaguar+N+M+PL
jaguarezinhos	jaguar+N+DIM+M+PL
jaguarzinho	jaguar+N+DIM+M+SG
jaguarzinhos	jaguar+N+DIM+M+PL
jaguaracambezinho	jaguaracambé+N+DIM+M+SG
jaguaracambezinhos	jaguaracambé+N+DIM+M+PL
jaguaracambé	jaguaracambé+N+M+SG
jaguaracambés	jaguaracambé+N+M+PL
jaguarapinima	jaguarapinima+N+M+SG
jaguarapinimas	jaguarapinima+N+M+PL
jaguarapinimazinho	jaguarapinima+N+DIM+M+SG
jaguarapinimazinhos	jaguarapinima+N+DIM+M+PL
jaguarapiniminha	jaguarapinima+N+DIM+M+SG
jaguarapiniminhas	jaguarapinima+N+DIM+M+PL
jaguaretezinho	jaguaretê+N+DIM+M+SG
jaguaretezinhos	jaguaretê+N+DIM+M+PL
jaguaretê	jaguaretê+N+M+SG
jaguaretês	jaguaretê+N+M+PL
jaguaritaca	jaguaritaca+N+SG
jaguaritacas	jaguaritaca+N+PL
jaguaritacazinha	jaguaritaca+N+DIM+F+SG
jaguaritacazinhas	jaguaritaca+N+DIM+F+PL
jaguaritacazinho	jaguaritaca+N+DIM+M+SG
jaguaritacazinhos	jaguaritaca+N+DIM+M+PL
jaguaritaquinha	jaguaritaca+N+DIM+SG
jaguaritaquinhas	jaguaritaca+N+DIM+PL
jaguaruçazinho	jaguaruçá+N+DIM+M+SG
jaguaruçazinhos	jaguaruçá+N+DIM+M+PL
jaguaruçá	jaguaruçá+N+M+SG
jaguaruçás	jaguaruçá+N+M+PL
jaguarezinho	jaguaré+N+DIM+M+SG
jaguarezinhos	jaguaré+N+DIM+M+PL
jaguaré	jaguaré+N+M+SG
jaguarés	jaguaré+N+M+PL
jaguatirica	jaguatirica+N+F+SG
jaguatiricas	jaguatirica+N+F+PL
jaguatiricazinha	jaguatirica+N+DIM+F+SG
jaguatiricazinhas	jaguatirica+N+DIM+F+PL
jaguatiriquinha	jaguatirica+N+DIM+F+SG
jaguatiriquinhas	jaguatirica+N+DIM+F+PL
jagunçada	jagunçada+N+F+SG
jagunçadas	jagunçada+N+F+PL
jagunçadazinha	jagunçada+N+DIM+F+SG
jagunçadazinhas	jagunçada+N+DIM+F+PL
jagunçadinha	jagunçada+N+DIM+F+SG
jagunçadinhas	jagunçada+N+DIM+F+PL
jagunçaria	jagunçaria+N+F+SG
jagunçarias	jagunçaria+N+F+PL
jagunçariazinha	jagunçaria+N+DIM+F+SG
jagunçariazinhas	jagunçaria+N+DIM+F+PL
jagunçarinha	jagunçaria+N+DIM+F+SG
jagunçarinhas	jagunçaria+N+DIM+F+PL
jaguncinha	jagunço+N+DIM+F+SG
jaguncinhas	jagunço+N+DIM+F+PL
jaguncinho	jagunço+N+DIM+M+SG
jaguncinhos	jagunço+N+DIM+M+PL
jagunça	jagunço+N+F+SG
jagunças	jagunço+N+F+PL
jagunçazinha	jagunço+N+DIM+F+SG
jagunçazinhas	jagunço+N+DIM+F+PL
jagunço	jagunço+N+M+SG
jagunços	jagunço+N+M+PL
jagunçozinho	jagunço+N+DIM+M+SG
jagunçozinhos	jagunço+N+DIM+M+PL
jaguri	jaguri+N+M+SG
jaguris	jaguri+N+M+PL
jagurizinho	jaguri+N+DIM+M+SG
jagurizinhos	jaguri+N+DIM+M+PL
jalapa	jalapa+N+F+SG
jalapas	jalapa+N+F+PL
jalapazinha	jalapa+N+DIM+F+SG
jalapazinhas	jalapa+N+DIM+F+PL
jalapinha	jalapa+N+DIM+F+SG
jalapinhas	jalapa+N+DIM+F+PL
jalapina	jalapina+N+F+SG
jalapinas	jalapina+N+F+PL
jalapinazinha	jalapina+N+DIM+F+SG
jalapinazinhas	jalapina+N+DIM+F+PL
jalapininha	jalapina+N+DIM+F+SG
jalapininhas	jalapina+N+DIM+F+PL
jaleca	jaleca+N+F+SG
jalecas	jaleca+N+F+PL
jalecazinha	jaleca+N+DIM+F+SG
jalecazinhas	jaleca+N+DIM+F+PL
jalequinha	jaleca+N+DIM+F+SG
jalequinhas	jaleca+N+DIM+F+PL
jaleco	jaleco+N+M+SG
jalecos	jaleco+N+M+PL
jalecozinho	jaleco+N+DIM+M+SG
jalecozinhos	jaleco+N+DIM+M+PL
jalequinho	jaleco+N+DIM+M+SG
jalequinhos	jaleco+N+DIM+M+PL
jaleia	jaleia+N+F+SG
jaleias	jaleia+N+F+PL
jaleiazinha	jaleia+N+DIM+F+SG
jaleiazinhas	jaleia+N+DIM+F+PL
jaleinha	jaleia+N+DIM+F+SG
jaleinhas	jaleia+N+DIM+F+PL
jaleque	jaleque+N+M+SG
jaleques	jaleque+N+M+PL
jalequezinho	jaleque+N+DIM+M+SG
jalequezinhos	jaleque+N+DIM+M+PL
jalequinho	jaleque+N+DIM+M+SG
jalequinhos	jaleque+N+DIM+M+PL
jalofa	jalofo+N+F+SG
jalofas	jalofo+N+F+PL
jalofazinha	jalofo+N+DIM+F+SG
jalofazinhas	jalofo+N+DIM+F+PL
jalofinha	jalofo+N+DIM+F+SG
jalofinhas	jalofo+N+DIM+F+PL
jalofinho	jalofo+N+DIM+M+SG
jalofinhos	jalofo+N+DIM+M+PL
jalofo	jalofo+N+M+SG
jalofos	jalofo+N+M+PL
jalofozinho	jalofo+N+DIM+M+SG
jalofozinhos	jalofo+N+DIM+M+PL
jalutinho	jaluto+N+DIM+M+SG
jalutinhos	jaluto+N+DIM+M+PL
jaluto	jaluto+N+M+SG
jalutos	jaluto+N+M+PL
jalutozinho	jaluto+N+DIM+M+SG
jalutozinhos	jaluto+N+DIM+M+PL
jalão	jalão+N+M+SG
jalãozinho	jalão+N+DIM+M+SG
jalões	jalão+N+M+PL
jalõezinhos	jalão+N+DIM+M+PL
jamacaru	jamacaru+N+M+SG
jamacarus	jamacaru+N+M+PL
jamacaruzinho	jamacaru+N+DIM+M+SG
jamacaruzinhos	jamacaru+N+DIM+M+PL
jamanta	jamanta+N+SG
jamantas	jamanta+N+PL
jamantazinha	jamanta+N+DIM+F+SG
jamantazinhas	jamanta+N+DIM+F+PL
jamantazinho	jamanta+N+DIM+M+SG
jamantazinhos	jamanta+N+DIM+M+PL
jamantinha	jamanta+N+DIM+SG
jamantinhas	jamanta+N+DIM+PL
jamba	jamba+N+F+SG
jambas	jamba+N+F+PL
jambazinha	jamba+N+DIM+F+SG
jambazinhas	jamba+N+DIM+F+PL
jambinha	jamba+N+DIM+F+SG
jambinhas	jamba+N+DIM+F+PL
jambeirinho	jambeiro+N+DIM+M+SG
jambeirinhos	jambeiro+N+DIM+M+PL
jambeiro	jambeiro+N+M+SG
jambeiros	jambeiro+N+M+PL
jambeirozinho	jambeiro+N+DIM+M+SG
jambeirozinhos	jambeiro+N+DIM+M+PL
jambelegiacazinha	jambelegíaco+N+DIM+F+SG
jambelegiacazinhas	jambelegíaco+N+DIM+F+PL
jambelegiacozinho	jambelegíaco+N+DIM+M+SG
jambelegiacozinhos	jambelegíaco+N+DIM+M+PL
jambelegiaquinha	jambelegíaco+N+DIM+F+SG
jambelegiaquinhas	jambelegíaco+N+DIM+F+PL
jambelegiaquinho	jambelegíaco+N+DIM+M+SG
jambelegiaquinhos	jambelegíaco+N+DIM+M+PL
jambelegíaca	jambelegíaco+N+F+SG
jambelegíacas	jambelegíaco+N+F+PL
jambelegíaco	jambelegíaco+N+M+SG
jambelegíacos	jambelegíaco+N+M+PL
jambicidade	jambicidade+N+F+SG
jambicidades	jambicidade+N+F+PL
jambicidadezinha	jambicidade+N+DIM+F+SG
jambicidadezinhas	jambicidade+N+DIM+F+PL
jambicidadinha	jambicidade+N+DIM+F+SG
jambicidadinhas	jambicidade+N+DIM+F+PL
jambinho	jambo+N+DIM+M+SG
jambinhos	jambo+N+DIM+M+PL
jambo	jambo+N+M+SG
jambos	jambo+N+M+PL
jambozinho	jambo+N+DIM+M+SG
jambozinhos	jambo+N+DIM+M+PL
jamboeirinho	jamboeiro+N+DIM+M+SG
jamboeirinhos	jamboeiro+N+DIM+M+PL
jamboeiro	jamboeiro+N+M+SG
jamboeiros	jamboeiro+N+M+PL
jamboeirozinho	jamboeiro+N+DIM+M+SG
jamboeirozinhos	jamboeiro+N+DIM+M+PL
jamboizinhos	jambol+N+DIM+M+PL
jambol	jambol+N+M+SG
jambolzinho	jambol+N+DIM+M+SG
jambóis	jambol+N+M+PL
jambolaninho	jambolano+N+DIM+M+SG
jambolaninhos	jambolano+N+DIM+M+PL
jambolano	jambolano+N+M+SG
jambolanos	jambolano+N+M+PL
jambolanozinho	jambolano+N+DIM+M+SG
jambolanozinhos	jambolano+N+DIM+M+PL
jamboleirinho	jamboleiro+N+DIM+M+SG
jamboleirinhos	jamboleiro+N+DIM+M+PL
jamboleiro	jamboleiro+N+M+SG
jamboleiros	jamboleiro+N+M+PL
jamboleirozinho	jamboleiro+N+DIM+M+SG
jamboleirozinhos	jamboleiro+N+DIM+M+PL
jambolão	jambolão+N+M+SG
jambolãozinho	jambolão+N+DIM+M+SG
jambolões	jambolão+N+M+PL
jambolõezinhos	jambolão+N+DIM+M+PL
jamboree	jamboree+N+M+SG
jamborees	jamboree+N+M+PL
jamboreezinho	jamboree+N+DIM+M+SG
jamboreezinhos	jamboree+N+DIM+M+PL
jamboreinho	jamboree+N+DIM+M+SG
jamboreinhos	jamboree+N+DIM+M+PL
jambu	jambu+N+M+SG
jambus	jambu+N+M+PL
jambuzinho	jambu+N+DIM+M+SG
jambuzinhos	jambu+N+DIM+M+PL
jambuaçu	jambuaçu+N+M+SG
jambuaçus	jambuaçu+N+M+PL
jambuaçuzinho	jambuaçu+N+DIM+M+SG
jambuaçuzinhos	jambuaçu+N+DIM+M+PL
jambuis	jambul+N+PL
jambuizinhas	jambul+N+DIM+F+PL
jambuizinhos	jambul+N+DIM+M+PL
jambul	jambul+N+SG
jambulzinha	jambul+N+DIM+F+SG
jambulzinho	jambul+N+DIM+M+SG
jamegão	jamegão+N+M+SG
jamegãozinho	jamegão+N+DIM+M+SG
jamegões	jamegão+N+M+PL
jamegõezinhos	jamegão+N+DIM+M+PL
jamesoniazinha	jamesónia+N+DIM+F+SG
jamesoniazinhas	jamesónia+N+DIM+F+PL
jamesoninha	jamesónia+N+DIM+F+SG
jamesoninhas	jamesónia+N+DIM+F+PL
jamesónia	jamesónia+N+F+SG
jamesónias	jamesónia+N+F+PL
jamesoniazinha	jamesônia+N+DIM+F+SG
jamesoniazinhas	jamesônia+N+DIM+F+PL
jamesoninha	jamesônia+N+DIM+F+SG
jamesoninhas	jamesônia+N+DIM+F+PL
jamesônia	jamesônia+N+F+SG
jamesônias	jamesônia+N+F+PL
janambazinho	janambá+N+DIM+M+SG
janambazinhos	janambá+N+DIM+M+PL
janambá	janambá+N+M+SG
janambás	janambá+N+M+PL
janaubazinha	janaúba+N+DIM+F+SG
janaubazinhas	janaúba+N+DIM+F+PL
janaubinha	janaúba+N+DIM+F+SG
janaubinhas	janaúba+N+DIM+F+PL
janaúba	janaúba+N+F+SG
janaúbas	janaúba+N+F+PL
janda	janda+N+F+SG
jandas	janda+N+F+PL
jandazinha	janda+N+DIM+F+SG
jandazinhas	janda+N+DIM+F+PL
jandinha	janda+N+DIM+F+SG
jandinhas	janda+N+DIM+F+PL
jandaia	jandaia+N+F+SG
jandaias	jandaia+N+F+PL
jandaiazinha	jandaia+N+DIM+F+SG
jandaiazinhas	jandaia+N+DIM+F+PL
jandainha	jandaia+N+DIM+F+SG
jandainhas	jandaia+N+DIM+F+PL
jandairazinha	jandaíra+N+DIM+F+SG
jandairazinhas	jandaíra+N+DIM+F+PL
jandairinha	jandaíra+N+DIM+F+SG
jandairinhas	jandaíra+N+DIM+F+PL
jandaíra	jandaíra+N+F+SG
jandaíras	jandaíra+N+F+PL
jandiazinho	jandiá+N+DIM+M+SG
jandiazinhos	jandiá+N+DIM+M+PL
jandiá	jandiá+N+M+SG
jandiás	jandiá+N+M+PL
janeanes	janeanes+N+M
janeanesinhas	janeanes+N+DIM+F+PL
janeanesinho	janeanes+N+DIM+M+SG
janeanesinhos	janeanes+N+DIM+M+PL
janeirada	janeirada+N+F+SG
janeiradas	janeirada+N+F+PL
janeiradazinha	janeirada+N+DIM+F+SG
janeiradazinhas	janeirada+N+DIM+F+PL
janeiradinha	janeirada+N+DIM+F+SG
janeiradinhas	janeirada+N+DIM+F+PL
janeiras	janeiras+N+F+PL
janeireira	janeireiro+N+F+SG
janeireiras	janeireiro+N+F+PL
janeireirazinha	janeireiro+N+DIM+F+SG
janeireirazinhas	janeireiro+N+DIM+F+PL
janeireirinha	janeireiro+N+DIM+F+SG
janeireirinhas	janeireiro+N+DIM+F+PL
janeireirinho	janeireiro+N+DIM+M+SG
janeireirinhos	janeireiro+N+DIM+M+PL
janeireiro	janeireiro+N+M+SG
janeireiros	janeireiro+N+M+PL
janeireirozinho	janeireiro+N+DIM+M+SG
janeireirozinhos	janeireiro+N+DIM+M+PL
janeirinha	janeirinha+N+F+SG
janeirinhas	janeirinha+N+F+PL
janeirinhazinha	janeirinha+N+DIM+F+SG
janeirinhazinhas	janeirinha+N+DIM+F+PL
janeirinhinha	janeirinha+N+DIM+F+SG
janeirinhinhas	janeirinha+N+DIM+F+PL
Janeirinho	janeiro+N+DIM+M+SG
Janeirinhos	janeiro+N+DIM+M+PL
Janeiro	janeiro+N+M+SG
Janeiros	janeiro+N+M+PL
Janeirozinho	janeiro+N+DIM+M+SG
Janeirozinhos	janeiro+N+DIM+M+PL
janeira	janeiro+N+F+SG
janeiras	janeiro+N+F+PL
janeirazinha	janeiro+N+DIM+F+SG
janeirazinhas	janeiro+N+DIM+F+PL
janeirinha	janeiro+N+DIM+F+SG
janeirinhas	janeiro+N+DIM+F+PL
janeirinho	janeiro+N+DIM+M+SG
janeirinhos	janeiro+N+DIM+M+PL
janeiro	janeiro+N+M+SG
janeiros	janeiro+N+M+PL
janeirozinho	janeiro+N+DIM+M+SG
janeirozinhos	janeiro+N+DIM+M+PL
janela	janela+N+F+SG
janelas	janela+N+F+PL
janelazinha	janela+N+DIM+F+SG
janelazinhas	janela+N+DIM+F+PL
janelinha	janela+N+DIM+F+SG
janelinhas	janela+N+DIM+F+PL
janelita	janela+N+DIM+F+SG
janelitas	janela+N+DIM+F+PL
janeleira	janeleiro+N+F+SG
janeleiras	janeleiro+N+F+PL
janeleirazinha	janeleiro+N+DIM+F+SG
janeleirazinhas	janeleiro+N+DIM+F+PL
janeleirinha	janeleiro+N+DIM+F+SG
janeleirinhas	janeleiro+N+DIM+F+PL
janeleirinho	janeleiro+N+DIM+M+SG
janeleirinhos	janeleiro+N+DIM+M+PL
janeleiro	janeleiro+N+M+SG
janeleiros	janeleiro+N+M+PL
janeleirozinho	janeleiro+N+DIM+M+SG
janeleirozinhos	janeleiro+N+DIM+M+PL
janelinho	janelo+N+DIM+M+SG
janelinhos	janelo+N+DIM+M+PL
janelo	janelo+N+M+SG
janelos	janelo+N+M+PL
janelozinho	janelo+N+DIM+M+SG
janelozinhos	janelo+N+DIM+M+PL
janelão	janelão+N+M+SG
janelãozinho	janelão+N+DIM+M+SG
janelões	janelão+N+M+PL
janelõezinhos	janelão+N+DIM+M+PL
janga	janga+N+F+SG
jangas	janga+N+F+PL
jangazinha	janga+N+DIM+F+SG
jangazinhas	janga+N+DIM+F+PL
janguinha	janga+N+DIM+F+SG
janguinhas	janga+N+DIM+F+PL
jangada	jangada+N+F+SG
jangadas	jangada+N+F+PL
jangadazinha	jangada+N+DIM+F+SG
jangadazinhas	jangada+N+DIM+F+PL
jangadinha	jangada+N+DIM+F+SG
jangadinhas	jangada+N+DIM+F+PL
jangadeira	jangadeira+N+F+SG
jangadeiras	jangadeira+N+F+PL
jangadeirazinha	jangadeira+N+DIM+F+SG
jangadeirazinhas	jangadeira+N+DIM+F+PL
jangadeirinha	jangadeira+N+DIM+F+SG
jangadeirinhas	jangadeira+N+DIM+F+PL
jangadeira	jangadeiro+N+F+SG
jangadeiras	jangadeiro+N+F+PL
jangadeirazinha	jangadeiro+N+DIM+F+SG
jangadeirazinhas	jangadeiro+N+DIM+F+PL
jangadeirinha	jangadeiro+N+DIM+F+SG
jangadeirinhas	jangadeiro+N+DIM+F+PL
jangadeirinho	jangadeiro+N+DIM+M+SG
jangadeirinhos	jangadeiro+N+DIM+M+PL
jangadeiro	jangadeiro+N+M+SG
jangadeiros	jangadeiro+N+M+PL
jangadeirozinho	jangadeiro+N+DIM+M+SG
jangadeirozinhos	jangadeiro+N+DIM+M+PL
jangalamarte	jangalamarte+N+M+SG
jangalamartes	jangalamarte+N+M+PL
jangalamartezinho	jangalamarte+N+DIM+M+SG
jangalamartezinhos	jangalamarte+N+DIM+M+PL
jangalamartinho	jangalamarte+N+DIM+M+SG
jangalamartinhos	jangalamarte+N+DIM+M+PL
jangalamaste	jangalamaste+N+M+SG
jangalamastes	jangalamaste+N+M+PL
jangalamastezinho	jangalamaste+N+DIM+M+SG
jangalamastezinhos	jangalamaste+N+DIM+M+PL
jangalamastinho	jangalamaste+N+DIM+M+SG
jangalamastinhos	jangalamaste+N+DIM+M+PL
jangaz	jangaz+N+M+SG
jangazes	jangaz+N+M+PL
jangazezinhos	jangaz+N+DIM+M+PL
jangazinho	jangaz+N+DIM+M+SG
jangazinhos	jangaz+N+DIM+M+PL
jangazinha	jangá+N+DIM+F+SG
jangazinhas	jangá+N+DIM+F+PL
jangá	jangá+N+F+SG
jangás	jangá+N+F+PL
janicefalia	janicefalia+N+F+SG
janicefalias	janicefalia+N+F+PL
janicefaliazinha	janicefalia+N+DIM+F+SG
janicefaliazinhas	janicefalia+N+DIM+F+PL
janicefalinha	janicefalia+N+DIM+F+SG
janicefalinhas	janicefalia+N+DIM+F+PL
janicefalinho	janicéfalo+N+DIM+M+SG
janicefalinhos	janicéfalo+N+DIM+M+PL
janicefalozinho	janicéfalo+N+DIM+M+SG
janicefalozinhos	janicéfalo+N+DIM+M+PL
janicéfalo	janicéfalo+N+M+SG
janicéfalos	janicéfalo+N+M+PL
janicipitezinha	janicípite+N+DIM+F+SG
janicipitezinhas	janicípite+N+DIM+F+PL
janicipitezinho	janicípite+N+DIM+M+SG
janicipitezinhos	janicípite+N+DIM+M+PL
janicipitinha	janicípite+N+DIM+F+SG
janicipitinhas	janicípite+N+DIM+F+PL
janicipitinho	janicípite+N+DIM+M+SG
janicipitinhos	janicípite+N+DIM+M+PL
janicípite	janicípite+N+SG
janicípites	janicípite+N+PL
janira	janira+N+F+SG
janiras	janira+N+F+PL
janirazinha	janira+N+DIM+F+SG
janirazinhas	janira+N+DIM+F+PL
janirinha	janira+N+DIM+F+SG
janirinhas	janira+N+DIM+F+PL
janistroques	janistroques+N+M+SG
janistroqueses	janistroques+N+M+PL
janistroquesezinhos	janistroques+N+DIM+M+PL
janistroquesinho	janistroques+N+DIM+M+SG
janistroquesinhos	janistroques+N+DIM+M+PL
janota	janota+N+SG
janotas	janota+N+PL
janotazinha	janota+N+DIM+F+SG
janotazinhas	janota+N+DIM+F+PL
janotazinho	janota+N+DIM+M+SG
janotazinhos	janota+N+DIM+M+PL
janotinha	janota+N+DIM+SG
janotinhas	janota+N+DIM+PL
janotada	janotada+N+F+SG
janotadas	janotada+N+F+PL
janotadazinha	janotada+N+DIM+F+SG
janotadazinhas	janotada+N+DIM+F+PL
janotadinha	janotada+N+DIM+F+SG
janotadinhas	janotada+N+DIM+F+PL
janotaria	janotaria+N+F+SG
janotarias	janotaria+N+F+PL
janotariazinha	janotaria+N+DIM+F+SG
janotariazinhas	janotaria+N+DIM+F+PL
janotarinha	janotaria+N+DIM+F+SG
janotarinhas	janotaria+N+DIM+F+PL
janotice	janotice+N+F+SG
janotices	janotice+N+F+PL
janoticezinha	janotice+N+DIM+F+SG
janoticezinhas	janotice+N+DIM+F+PL
janoticinha	janotice+N+DIM+F+SG
janoticinhas	janotice+N+DIM+F+PL
janotisminho	janotismo+N+DIM+M+SG
janotisminhos	janotismo+N+DIM+M+PL
janotismo	janotismo+N+M+SG
janotismos	janotismo+N+M+PL
janotismozinho	janotismo+N+DIM+M+SG
janotismozinhos	janotismo+N+DIM+M+PL
jansenisminho	jansenismo+N+DIM+M+SG
jansenisminhos	jansenismo+N+DIM+M+PL
jansenismo	jansenismo+N+M+SG
jansenismos	jansenismo+N+M+PL
jansenismozinho	jansenismo+N+DIM+M+SG
jansenismozinhos	jansenismo+N+DIM+M+PL
jansenista	jansenista+N+SG
jansenistas	jansenista+N+PL
jansenistazinha	jansenista+N+DIM+F+SG
jansenistazinhas	jansenista+N+DIM+F+PL
jansenistazinho	jansenista+N+DIM+M+SG
jansenistazinhos	jansenista+N+DIM+M+PL
jansenistinha	jansenista+N+DIM+SG
jansenistinhas	jansenista+N+DIM+PL
jansoniazinha	jansónia+N+DIM+F+SG
jansoniazinhas	jansónia+N+DIM+F+PL
jansoninha	jansónia+N+DIM+F+SG
jansoninhas	jansónia+N+DIM+F+PL
jansónia	jansónia+N+F+SG
jansónias	jansónia+N+F+PL
jansoniazinha	jansônia+N+DIM+F+SG
jansoniazinhas	jansônia+N+DIM+F+PL
jansoninha	jansônia+N+DIM+F+SG
jansoninhas	jansônia+N+DIM+F+PL
jansônia	jansônia+N+F+SG
jansônias	jansônia+N+F+PL
janta	janta+N+F+SG
jantas	janta+N+F+PL
jantazinha	janta+N+DIM+F+SG
jantazinhas	janta+N+DIM+F+PL
jantinha	janta+N+DIM+F+SG
jantinhas	janta+N+DIM+F+PL
jantar	jantar+N+M+SG
jantares	jantar+N+M+PL
jantarezinhos	jantar+N+DIM+M+PL
jantarinho	jantar+N+DIM+M+SG
jantarinhos	jantar+N+DIM+M+PL
jantarito	jantar+N+DIM+M+SG
jantaritos	jantar+N+DIM+M+PL
jantarzinho	jantar+N+DIM+M+SG
jantarzinhos	jantar+N+DIM+M+PL
jantar-comicinho	jantar-comício+N+DIM+M+SG
jantar-comicinhos	jantar-comício+N+DIM+M+PL
jantar-comiciozinho	jantar-comício+N+DIM+M+SG
jantar-comício	jantar-comício+N+M+SG
jantares-comiciozinhos	jantar-comício+N+DIM+M+PL
jantares-comícios	jantar-comício+N+M+PL
jantar-conferenciazinho	jantar-conferência+N+DIM+M+SG
jantar-conferencinha	jantar-conferência+N+DIM+M+SG
jantar-conferencinhas	jantar-conferência+N+DIM+M+PL
jantar-conferência	jantar-conferência+N+M+SG
jantares-conferenciazinhos	jantar-conferência+N+DIM+M+PL
jantares-conferências	jantar-conferência+N+M+PL
jantar-convivinho	jantar-convívio+N+DIM+M+SG
jantar-convivinhos	jantar-convívio+N+DIM+M+PL
jantar-conviviozinho	jantar-convívio+N+DIM+M+SG
jantar-convívio	jantar-convívio+N+M+SG
jantares-conviviozinhos	jantar-convívio+N+DIM+M+PL
jantares-convívios	jantar-convívio+N+M+PL
jantar-debate	jantar-debate+N+M+SG
jantar-debatezinho	jantar-debate+N+DIM+M+SG
jantar-debatinho	jantar-debate+N+DIM+M+SG
jantar-debatinhos	jantar-debate+N+DIM+M+PL
jantares-debates	jantar-debate+N+M+PL
jantares-debatezinhos	jantar-debate+N+DIM+M+PL
jantarada	jantarada+N+F+SG
jantaradas	jantarada+N+F+PL
jantaradazinha	jantarada+N+DIM+F+SG
jantaradazinhas	jantarada+N+DIM+F+PL
jantaradinha	jantarada+N+DIM+F+SG
jantaradinhas	jantarada+N+DIM+F+PL
jantareta	jantareta+N+F+SG
jantaretas	jantareta+N+F+PL
jantaretazinha	jantareta+N+DIM+F+SG
jantaretazinhas	jantareta+N+DIM+F+PL
jantaretinha	jantareta+N+DIM+F+SG
jantaretinhas	jantareta+N+DIM+F+PL
jantarola	jantarola+N+F+SG
jantarolas	jantarola+N+F+PL
jantarolazinha	jantarola+N+DIM+F+SG
jantarolazinhas	jantarola+N+DIM+F+PL
jantarolinha	jantarola+N+DIM+F+SG
jantarolinhas	jantarola+N+DIM+F+PL
jantarão	jantarão+N+M+SG
jantarãozinho	jantarão+N+DIM+M+SG
jantarões	jantarão+N+M+PL
jantarõezinhos	jantarão+N+DIM+M+PL
jante	jante+N+F+SG
jantes	jante+N+F+PL
jantezinha	jante+N+DIM+F+SG
jantezinhas	jante+N+DIM+F+PL
jantinha	jante+N+DIM+F+SG
jantinhas	jante+N+DIM+F+PL
januairazinho	januaíra+N+DIM+M+SG
januairazinhos	januaíra+N+DIM+M+PL
januairinha	januaíra+N+DIM+M+SG
januairinhas	januaíra+N+DIM+M+PL
januaíra	januaíra+N+M+SG
januaíras	januaíra+N+M+PL
januarinho	januário+N+DIM+M+SG
januarinhos	januário+N+DIM+M+PL
januariozinho	januário+N+DIM+M+SG
januariozinhos	januário+N+DIM+M+PL
januário	januário+N+M+SG
januários	januário+N+M+PL
janicipezinho	janícipe+N+DIM+M+SG
janicipezinhos	janícipe+N+DIM+M+PL
janicipinho	janícipe+N+DIM+M+SG
janicipinhos	janícipe+N+DIM+M+PL
janícipe	janícipe+N+M+SG
janícipes	janícipe+N+M+PL
janizarinho	janízaro+N+DIM+M+SG
janizarinhos	janízaro+N+DIM+M+PL
janizarozinho	janízaro+N+DIM+M+SG
janizarozinhos	janízaro+N+DIM+M+PL
janízaro	janízaro+N+M+SG
janízaros	janízaro+N+M+PL
janiçarinho	janíçaro+N+DIM+M+SG
janiçarinhos	janíçaro+N+DIM+M+PL
janiçarozinho	janíçaro+N+DIM+M+SG
janiçarozinhos	janíçaro+N+DIM+M+PL
janíçaro	janíçaro+N+M+SG
janíçaros	janíçaro+N+M+PL
japa	japa+N+F+SG
japas	japa+N+F+PL
japazinha	japa+N+DIM+F+SG
japazinhas	japa+N+DIM+F+PL
japinha	japa+N+DIM+F+SG
japinhas	japa+N+DIM+F+PL
japacani	japacani+N+M+SG
japacanis	japacani+N+M+PL
japacanizinho	japacani+N+DIM+M+SG
japacanizinhos	japacani+N+DIM+M+PL
japacanim	japacanim+N+M+SG
japacanins	japacanim+N+M+PL
japacaninzinho	japacanim+N+DIM+M+SG
japacaninzinhos	japacanim+N+DIM+M+PL
japana	japana+N+F+SG
japanas	japana+N+F+PL
japanazinha	japana+N+DIM+F+SG
japanazinhas	japana+N+DIM+F+PL
japaninha	japana+N+DIM+F+SG
japaninhas	japana+N+DIM+F+PL
japaranduba	japaranduba+N+F+SG
japarandubas	japaranduba+N+F+PL
japarandubazinha	japaranduba+N+DIM+F+SG
japarandubazinhas	japaranduba+N+DIM+F+PL
japarandubinha	japaranduba+N+DIM+F+SG
japarandubinhas	japaranduba+N+DIM+F+PL
japi	japi+N+M+SG
japis	japi+N+M+PL
japizinho	japi+N+DIM+M+SG
japizinhos	japi+N+DIM+M+PL
japiaçoca	japiaçoca+N+F+SG
japiaçocas	japiaçoca+N+F+PL
japiaçocazinha	japiaçoca+N+DIM+F+SG
japiaçocazinhas	japiaçoca+N+DIM+F+PL
japiaçoquinha	japiaçoca+N+DIM+F+SG
japiaçoquinhas	japiaçoca+N+DIM+F+PL
japim	japim+N+M+SG
japins	japim+N+M+PL
japinzinho	japim+N+DIM+M+SG
japinzinhos	japim+N+DIM+M+PL
japinabeirinho	japinabeiro+N+DIM+M+SG
japinabeirinhos	japinabeiro+N+DIM+M+PL
japinabeiro	japinabeiro+N+M+SG
japinabeiros	japinabeiro+N+M+PL
japinabeirozinho	japinabeiro+N+DIM+M+SG
japinabeirozinhos	japinabeiro+N+DIM+M+PL
japona	japona+N+SG
japonas	japona+N+PL
japonazinha	japona+N+DIM+F+SG
japonazinhas	japona+N+DIM+F+PL
japonazinho	japona+N+DIM+M+SG
japonazinhos	japona+N+DIM+M+PL
japoninha	japona+N+DIM+SG
japoninhas	japona+N+DIM+PL
japoneira	japoneira+N+F+SG
japoneiras	japoneira+N+F+PL
japoneirazinha	japoneira+N+DIM+F+SG
japoneirazinhas	japoneira+N+DIM+F+PL
japoneirinha	japoneira+N+DIM+F+SG
japoneirinhas	japoneira+N+DIM+F+PL
japonense	japonense+N+SG
japonenses	japonense+N+PL
japonensezinha	japonense+N+DIM+F+SG
japonensezinhas	japonense+N+DIM+F+PL
japonensezinho	japonense+N+DIM+M+SG
japonensezinhos	japonense+N+DIM+M+PL
japonensinha	japonense+N+DIM+F+SG
japonensinhas	japonense+N+DIM+F+PL
japonensinho	japonense+N+DIM+M+SG
japonensinhos	japonense+N+DIM+M+PL
japonesa	japonesa+N+F+SG
japonesas	japonesa+N+F+PL
japonesazinha	japonesa+N+DIM+F+SG
japonesazinhas	japonesa+N+DIM+F+PL
japonesinha	japonesa+N+DIM+F+SG
japonesinhas	japonesa+N+DIM+F+PL
japonesabilidade	japonesabilidade+N+F+SG
japonesabilidades	japonesabilidade+N+F+PL
japonesabilidadezinha	japonesabilidade+N+DIM+F+SG
japonesabilidadezinhas	japonesabilidade+N+DIM+F+PL
japonesabilidadinha	japonesabilidade+N+DIM+F+SG
japonesabilidadinhas	japonesabilidade+N+DIM+F+PL
japonesisminho	japonesismo+N+DIM+M+SG
japonesisminhos	japonesismo+N+DIM+M+PL
japonesismo	japonesismo+N+M+SG
japonesismos	japonesismo+N+M+PL
japonesismozinho	japonesismo+N+DIM+M+SG
japonesismozinhos	japonesismo+N+DIM+M+PL
japonesista	japonesista+N+SG
japonesistas	japonesista+N+PL
japonesistazinha	japonesista+N+DIM+F+SG
japonesistazinhas	japonesista+N+DIM+F+PL
japonesistazinho	japonesista+N+DIM+M+SG
japonesistazinhos	japonesista+N+DIM+M+PL
japonesistinha	japonesista+N+DIM+SG
japonesistinhas	japonesista+N+DIM+PL
japonicidade	japonicidade+N+F+SG
japonicidades	japonicidade+N+F+PL
japonicidadezinha	japonicidade+N+DIM+F+SG
japonicidadezinhas	japonicidade+N+DIM+F+PL
japonicidadinha	japonicidade+N+DIM+F+SG
japonicidadinhas	japonicidade+N+DIM+F+PL
japonisminho	japonismo+N+DIM+M+SG
japonisminhos	japonismo+N+DIM+M+PL
japonismo	japonismo+N+M+SG
japonismos	japonismo+N+M+PL
japonismozinho	japonismo+N+DIM+M+SG
japonismozinhos	japonismo+N+DIM+M+PL
japonizabilidade	japonizabilidade+N+F+SG
japonizabilidades	japonizabilidade+N+F+PL
japonizabilidadezinha	japonizabilidade+N+DIM+F+SG
japonizabilidadezinhas	japonizabilidade+N+DIM+F+PL
japonizabilidadinha	japonizabilidade+N+DIM+F+SG
japonizabilidadinhas	japonizabilidade+N+DIM+F+PL
japonesa	japonês+N+F+SG
japonesas	japonês+N+F+PL
japonesazinha	japonês+N+DIM+F+SG
japonesazinhas	japonês+N+DIM+F+PL
japoneses	japonês+N+M+PL
japonesezinhos	japonês+N+DIM+M+PL
japonesinha	japonês+N+DIM+F+SG
japonesinhas	japonês+N+DIM+F+PL
japonesinho	japonês+N+DIM+M+SG
japonesinhos	japonês+N+DIM+M+PL
japonês	japonês+N+M+SG
japonesa-portuguesa	japonês-português+N+F+SG
japonesa-portuguesazinha	japonês-português+N+DIM+F+SG
japonesa-portuguesinha	japonês-português+N+DIM+F+SG
japonesa-portuguesinhas	japonês-português+N+DIM+F+PL
japonesas-portuguesas	japonês-português+N+F+PL
japonesas-portuguesazinhas	japonês-português+N+DIM+F+PL
japoneses-portugueses	japonês-português+N+M+PL
japoneses-portuguesezinhos	japonês-português+N+DIM+M+PL
japoneses-portuguesinhos	japonês-português+N+DIM+M+PL
japonês-portuguesinho	japonês-português+N+DIM+M+SG
japonês-português	japonês-português+N+M+SG
japu	japu+N+M+SG
japus	japu+N+M+PL
japuzinho	japu+N+DIM+M+SG
japuzinhos	japu+N+DIM+M+PL
japuanga	japuanga+N+F+SG
japuangas	japuanga+N+F+PL
japuangazinha	japuanga+N+DIM+F+SG
japuangazinhas	japuanga+N+DIM+F+PL
japuanguinha	japuanga+N+DIM+F+SG
japuanguinhas	japuanga+N+DIM+F+PL
japuezinho	japué+N+DIM+M+SG
japuezinhos	japué+N+DIM+M+PL
japué	japué+N+M+SG
japués	japué+N+M+PL
japuezinho	japuê+N+DIM+M+SG
japuezinhos	japuê+N+DIM+M+PL
japuê	japuê+N+M+SG
japuês	japuê+N+M+PL
japuizinho	japuí+N+DIM+M+SG
japuizinhos	japuí+N+DIM+M+PL
japuí	japuí+N+M+SG
japuís	japuí+N+M+PL
japuirazinho	japuíra+N+DIM+M+SG
japuirazinhos	japuíra+N+DIM+M+PL
japuirinha	japuíra+N+DIM+M+SG
japuirinhas	japuíra+N+DIM+M+PL
japuíra	japuíra+N+M+SG
japuíras	japuíra+N+M+PL
japão	japão+N+M+SG
japãozinho	japão+N+DIM+M+SG
japões	japão+N+M+PL
japõezinhos	japão+N+DIM+M+PL
jaque	jaque+N+M+SG
jaques	jaque+N+M+PL
jaquezinho	jaque+N+DIM+M+SG
jaquezinhos	jaque+N+DIM+M+PL
jaquinho	jaque+N+DIM+M+SG
jaquinhos	jaque+N+DIM+M+PL
jaqueira	jaqueira+N+F+SG
jaqueiras	jaqueira+N+F+PL
jaqueirazinha	jaqueira+N+DIM+F+SG
jaqueirazinhas	jaqueira+N+DIM+F+PL
jaqueirinha	jaqueira+N+DIM+F+SG
jaqueirinhas	jaqueira+N+DIM+F+PL
jaqueirais	jaqueiral+N+M+PL
jaqueiraizinhos	jaqueiral+N+DIM+M+PL
jaqueiral	jaqueiral+N+M+SG
jaqueiralzinho	jaqueiral+N+DIM+M+SG
jaquejaque	jaquejaque+N+M+SG
jaquejaques	jaquejaque+N+M+PL
jaquejaquezinho	jaquejaque+N+DIM+M+SG
jaquejaquezinhos	jaquejaque+N+DIM+M+PL
jaquejaquinho	jaquejaque+N+DIM+M+SG
jaquejaquinhos	jaquejaque+N+DIM+M+PL
jaqueta	jaqueta+N+SG
jaquetas	jaqueta+N+PL
jaquetazinha	jaqueta+N+DIM+F+SG
jaquetazinhas	jaqueta+N+DIM+F+PL
jaquetazinho	jaqueta+N+DIM+M+SG
jaquetazinhos	jaqueta+N+DIM+M+PL
jaquetinha	jaqueta+N+DIM+SG
jaquetinhas	jaqueta+N+DIM+PL
jaquetão	jaqueta+N+AUG+M+SG
jaquetãozinho	jaqueta+N+AUG+DIM+M+SG
jaquetões	jaqueta+N+AUG+M+PL
jaquetõezinhos	jaqueta+N+AUG+DIM+M+PL
jaquetão	jaquetão+N+M+SG
jaquetãozinho	jaquetão+N+DIM+M+SG
jaquetões	jaquetão+N+M+PL
jaquetõezinhos	jaquetão+N+DIM+M+PL
jaquinzinhinho	jaquinzinho+N+DIM+M+SG
jaquinzinhinhos	jaquinzinho+N+DIM+M+PL
jaquinzinho	jaquinzinho+N+M+SG
jaquinzinhos	jaquinzinho+N+M+PL
jaquinzinhozinho	jaquinzinho+N+DIM+M+SG
jaquinzinhozinhos	jaquinzinho+N+DIM+M+PL
jaquiranaboia	jaquiranaboia+N+F+SG
jaquiranaboias	jaquiranaboia+N+F+PL
jaquiranaboiazinha	jaquiranaboia+N+DIM+F+SG
jaquiranaboiazinhas	jaquiranaboia+N+DIM+F+PL
jaquiranaboinha	jaquiranaboia+N+DIM+F+SG
jaquiranaboinhas	jaquiranaboia+N+DIM+F+PL
jaquiranaboiazinha	jaquiranabóia+N+DIM+F+SG
jaquiranaboiazinhas	jaquiranabóia+N+DIM+F+PL
jaquiranaboinha	jaquiranabóia+N+DIM+F+SG
jaquiranaboinhas	jaquiranabóia+N+DIM+F+PL
jaquiranabóia	jaquiranabóia+N+F+SG
jaquiranabóias	jaquiranabóia+N+F+PL
jaquezinho	jaqué+N+DIM+M+SG
jaquezinhos	jaqué+N+DIM+M+PL
jaqué	jaqué+N+M+SG
jaqués	jaqué+N+M+PL
jaracatiazinho	jaracatiá+N+DIM+M+SG
jaracatiazinhos	jaracatiá+N+DIM+M+PL
jaracatiá	jaracatiá+N+M+SG
jaracatiás	jaracatiá+N+M+PL
jaracuçu	jaracuçu+N+F+SG
jaracuçus	jaracuçu+N+F+PL
jaracuçuzinha	jaracuçu+N+DIM+F+SG
jaracuçuzinhas	jaracuçu+N+DIM+F+PL
jaramataia	jaramataia+N+F+SG
jaramataias	jaramataia+N+F+PL
jaramataiazinha	jaramataia+N+DIM+F+SG
jaramataiazinhas	jaramataia+N+DIM+F+PL
jaramatainha	jaramataia+N+DIM+F+SG
jaramatainhas	jaramataia+N+DIM+F+PL
jarapezinho	jarapé+N+DIM+M+SG
jarapezinhos	jarapé+N+DIM+M+PL
jarapé	jarapé+N+M+SG
jarapés	jarapé+N+M+PL
jaraqui	jaraqui+N+M+SG
jaraquis	jaraqui+N+M+PL
jaraquizinho	jaraqui+N+DIM+M+SG
jaraquizinhos	jaraqui+N+DIM+M+PL
jararaca	jararaca+N+F+SG
jararacas	jararaca+N+F+PL
jararacazinha	jararaca+N+DIM+F+SG
jararacazinhas	jararaca+N+DIM+F+PL
jararaquinha	jararaca+N+DIM+F+SG
jararaquinhas	jararaca+N+DIM+F+PL
jararacambeva	jararacambeva+N+F+SG
jararacambevas	jararacambeva+N+F+PL
jararacambevazinha	jararacambeva+N+DIM+F+SG
jararacambevazinhas	jararacambeva+N+DIM+F+PL
jararacambevinha	jararacambeva+N+DIM+F+SG
jararacambevinhas	jararacambeva+N+DIM+F+PL
jararacuçu	jararacuçu+N+SG
jararacuçus	jararacuçu+N+PL
jararacuçuzinha	jararacuçu+N+DIM+F+SG
jararacuçuzinhas	jararacuçu+N+DIM+F+PL
jararacuçuzinho	jararacuçu+N+DIM+M+SG
jararacuçuzinhos	jararacuçu+N+DIM+M+PL
jaratataca	jaratataca+N+F+SG
jaratatacas	jaratataca+N+F+PL
jaratatacazinha	jaratataca+N+DIM+F+SG
jaratatacazinhas	jaratataca+N+DIM+F+PL
jaratataquinha	jaratataca+N+DIM+F+SG
jaratataquinhas	jaratataca+N+DIM+F+PL
jarda	jarda+N+F+SG
jardas	jarda+N+F+PL
jardazinha	jarda+N+DIM+F+SG
jardazinhas	jarda+N+DIM+F+PL
jardinha	jarda+N+DIM+F+SG
jardinhas	jarda+N+DIM+F+PL
jardim	jardim+N+M+SG
jardins	jardim+N+M+PL
jardinzinho	jardim+N+DIM+M+SG
jardinzinhos	jardim+N+DIM+M+PL
jardinzito	jardim+N+DIM+M+SG
jardinzitos	jardim+N+DIM+M+PL
jardim-de-infanciazinho	jardim-de-infância+N+DIM+M+SG
jardim-de-infancinha	jardim-de-infância+N+DIM+M+SG
jardim-de-infancinhas	jardim-de-infância+N+DIM+M+PL
jardim-de-infância	jardim-de-infância+N+M+SG
jardins-de-infanciazinhos	jardim-de-infância+N+DIM+M+PL
jardins-de-infância	jardim-de-infância+N+M+PL
jardim-de-inverninho	jardim-de-inverno+N+DIM+M+SG
jardim-de-inverninhos	jardim-de-inverno+N+DIM+M+PL
jardim-de-inverno	jardim-de-inverno+N+M+SG
jardim-de-invernozinho	jardim-de-inverno+N+DIM+M+SG
jardins-de-inverno	jardim-de-inverno+N+M+PL
jardins-de-invernozinhos	jardim-de-inverno+N+DIM+M+PL
jardim-escola	jardim-escola+N+M+SG
jardim-escolazinho	jardim-escola+N+DIM+M+SG
jardim-escolinha	jardim-escola+N+DIM+M+SG
jardim-escolinhas	jardim-escola+N+DIM+M+PL
jardins-escola	jardim-escola+N+M+PL
jardins-escolazinhos	jardim-escola+N+DIM+M+PL
jardim-infantil	jardim-infantil+N+M+SG
jardim-infantilzinho	jardim-infantil+N+DIM+M+SG
jardins-infantis	jardim-infantil+N+M+PL
jardins-infantizinhos	jardim-infantil+N+DIM+M+PL
jardim-parque	jardim-parque+N+M+SG
jardim-parquezinho	jardim-parque+N+DIM+M+SG
jardim-parquinho	jardim-parque+N+DIM+M+SG
jardim-parquinhos	jardim-parque+N+DIM+M+PL
jardins-parque	jardim-parque+N+M+PL
jardins-parquezinhos	jardim-parque+N+DIM+M+PL
jardinabilidade	jardinabilidade+N+F+SG
jardinabilidades	jardinabilidade+N+F+PL
jardinabilidadezinha	jardinabilidade+N+DIM+F+SG
jardinabilidadezinhas	jardinabilidade+N+DIM+F+PL
jardinabilidadinha	jardinabilidade+N+DIM+F+SG
jardinabilidadinhas	jardinabilidade+N+DIM+F+PL
jardinagem	jardinagem+N+F+SG
jardinagens	jardinagem+N+F+PL
jardinagenzinha	jardinagem+N+DIM+F+SG
jardinagenzinhas	jardinagem+N+DIM+F+PL
jardineira	jardineira+N+F+SG
jardineiras	jardineira+N+F+PL
jardineirazinha	jardineira+N+DIM+F+SG
jardineirazinhas	jardineira+N+DIM+F+PL
jardineirinha	jardineira+N+DIM+F+SG
jardineirinhas	jardineira+N+DIM+F+PL
jardineira	jardineiro+N+F+SG
jardineiras	jardineiro+N+F+PL
jardineirazinha	jardineiro+N+DIM+F+SG
jardineirazinhas	jardineiro+N+DIM+F+PL
jardineirinha	jardineiro+N+DIM+F+SG
jardineirinhas	jardineiro+N+DIM+F+PL
jardineirinho	jardineiro+N+DIM+M+SG
jardineirinhos	jardineiro+N+DIM+M+PL
jardineiro	jardineiro+N+M+SG
jardineiros	jardineiro+N+M+PL
jardineirozinha	jardineiro+N+DIM+F+SG
jardineirozinhas	jardineiro+N+DIM+F+PL
jardineirozinho	jardineiro+N+DIM+M+SG
jardineirozinhos	jardineiro+N+DIM+M+PL
jardinete	jardinete+N+M+SG
jardinetes	jardinete+N+M+PL
jardinetezinho	jardinete+N+DIM+M+SG
jardinetezinhos	jardinete+N+DIM+M+PL
jardinetinho	jardinete+N+DIM+M+SG
jardinetinhos	jardinete+N+DIM+M+PL
jardinista	jardinista+N+SG
jardinistas	jardinista+N+PL
jardinistazinha	jardinista+N+DIM+F+SG
jardinistazinhas	jardinista+N+DIM+F+PL
jardinistazinho	jardinista+N+DIM+M+SG
jardinistazinhos	jardinista+N+DIM+M+PL
jardinistinha	jardinista+N+DIM+SG
jardinistinhas	jardinista+N+DIM+PL
jarerezinho	jareré+N+DIM+M+SG
jarerezinhos	jareré+N+DIM+M+PL
jareré	jareré+N+M+SG
jarerés	jareré+N+M+PL
jargão	jargão+N+M+SG
jargãozinho	jargão+N+DIM+M+SG
jargões	jargão+N+M+PL
jargõezinhos	jargão+N+DIM+M+PL
jarina	jarina+N+F+SG
jarinas	jarina+N+F+PL
jarinazinha	jarina+N+DIM+F+SG
jarinazinhas	jarina+N+DIM+F+PL
jarininha	jarina+N+DIM+F+SG
jarininhas	jarina+N+DIM+F+PL
jaritacaca	jaritacaca+N+F+SG
jaritacacas	jaritacaca+N+F+PL
jaritacacazinha	jaritacaca+N+DIM+F+SG
jaritacacazinhas	jaritacaca+N+DIM+F+PL
jaritacaquinha	jaritacaca+N+DIM+F+SG
jaritacaquinhas	jaritacaca+N+DIM+F+PL
jaritataca	jaritataca+N+F+SG
jaritatacas	jaritataca+N+F+PL
jaritatacazinha	jaritataca+N+DIM+F+SG
jaritatacazinhas	jaritataca+N+DIM+F+PL
jaritataquinha	jaritataca+N+DIM+F+SG
jaritataquinhas	jaritataca+N+DIM+F+PL
jarivazinha	jarivá+N+DIM+F+SG
jarivazinhas	jarivá+N+DIM+F+PL
jarivazinho	jarivá+N+DIM+M+SG
jarivazinhos	jarivá+N+DIM+M+PL
jarivá	jarivá+N+SG
jarivás	jarivá+N+PL
jarinho	jaro+N+DIM+M+SG
jarinhos	jaro+N+DIM+M+PL
jaro	jaro+N+M+SG
jaros	jaro+N+M+PL
jarozinho	jaro+N+DIM+M+SG
jarozinhos	jaro+N+DIM+M+PL
jarra	jarra+N+F+SG
jarras	jarra+N+F+PL
jarrazinha	jarra+N+DIM+F+SG
jarrazinhas	jarra+N+DIM+F+PL
jarrinha	jarra+N+DIM+F+SG
jarrinhas	jarra+N+DIM+F+PL
jarrita	jarra+N+DIM+F+SG
jarritas	jarra+N+DIM+F+PL
jarrão	jarra+N+AUG+M+SG
jarrãozinho	jarra+N+AUG+DIM+M+SG
jarrões	jarra+N+AUG+M+PL
jarrõezinhos	jarra+N+AUG+DIM+M+PL
jarrafa	jarrafa+N+F+SG
jarrafas	jarrafa+N+F+PL
jarrafazinha	jarrafa+N+DIM+F+SG
jarrafazinhas	jarrafa+N+DIM+F+PL
jarrafinha	jarrafa+N+DIM+F+SG
jarrafinhas	jarrafa+N+DIM+F+PL
jarreta	jarreta+N+SG
jarretas	jarreta+N+PL
jarretazinha	jarreta+N+DIM+F+SG
jarretazinhas	jarreta+N+DIM+F+PL
jarretazinho	jarreta+N+DIM+M+SG
jarretazinhos	jarreta+N+DIM+M+PL
jarretinha	jarreta+N+DIM+SG
jarretinhas	jarreta+N+DIM+PL
jarrete	jarrete+N+M+SG
jarretes	jarrete+N+M+PL
jarretezinho	jarrete+N+DIM+M+SG
jarretezinhos	jarrete+N+DIM+M+PL
jarretinho	jarrete+N+DIM+M+SG
jarretinhos	jarrete+N+DIM+M+PL
jarreteira	jarreteira+N+F+SG
jarreteiras	jarreteira+N+F+PL
jarreteirazinha	jarreteira+N+DIM+F+SG
jarreteirazinhas	jarreteira+N+DIM+F+PL
jarreteirinha	jarreteira+N+DIM+F+SG
jarreteirinhas	jarreteira+N+DIM+F+PL
jarretice	jarretice+N+F+SG
jarretices	jarretice+N+F+PL
jarreticezinha	jarretice+N+DIM+F+SG
jarreticezinhas	jarretice+N+DIM+F+PL
jarreticinha	jarretice+N+DIM+F+SG
jarreticinhas	jarretice+N+DIM+F+PL
jarrilhinho	jarrilho+N+DIM+M+SG
jarrilhinhos	jarrilho+N+DIM+M+PL
jarrilho	jarrilho+N+M+SG
jarrilhos	jarrilho+N+M+PL
jarrilhozinho	jarrilho+N+DIM+M+SG
jarrilhozinhos	jarrilho+N+DIM+M+PL
jarrinha	jarrinha+N+F+SG
jarrinhas	jarrinha+N+F+PL
jarrinhazinha	jarrinha+N+DIM+F+SG
jarrinhazinhas	jarrinha+N+DIM+F+PL
jarrinhinha	jarrinha+N+DIM+F+SG
jarrinhinhas	jarrinha+N+DIM+F+PL
jarrinho	jarro+N+DIM+M+SG
jarrinhos	jarro+N+DIM+M+PL
jarrito	jarro+N+DIM+M+SG
jarritos	jarro+N+DIM+M+PL
jarro	jarro+N+M+SG
jarros	jarro+N+M+PL
jarrozinho	jarro+N+DIM+M+SG
jarrozinhos	jarro+N+DIM+M+PL
jarrão	jarrão+N+M+SG
jarrãozinho	jarrão+N+DIM+M+SG
jarrões	jarrão+N+M+PL
jarrõezinhos	jarrão+N+DIM+M+PL
jarazinha	jará+N+DIM+F+SG
jarazinhas	jará+N+DIM+F+PL
jará	jará+N+F+SG
jarás	jará+N+F+PL
jarezinho	jarê+N+DIM+M+SG
jarezinhos	jarê+N+DIM+M+PL
jarê	jarê+N+M+SG
jarês	jarê+N+M+PL
jasmim	jasmim+N+M+SG
jasmins	jasmim+N+M+PL
jasminzinho	jasmim+N+DIM+M+SG
jasminzinhos	jasmim+N+DIM+M+PL
jasmineirinho	jasmineiro+N+DIM+M+SG
jasmineirinhos	jasmineiro+N+DIM+M+PL
jasmineiro	jasmineiro+N+M+SG
jasmineiros	jasmineiro+N+M+PL
jasmineirozinho	jasmineiro+N+DIM+M+SG
jasmineirozinhos	jasmineiro+N+DIM+M+PL
jasminaceazinha	jasminácea+N+DIM+F+SG
jasminaceazinhas	jasminácea+N+DIM+F+PL
jasminaceinha	jasminácea+N+DIM+F+SG
jasminaceinhas	jasminácea+N+DIM+F+PL
jasminácea	jasminácea+N+F+SG
jasmináceas	jasminácea+N+F+PL
jasminaceazinha	jasmináceo+N+DIM+F+SG
jasminaceazinhas	jasmináceo+N+DIM+F+PL
jasminaceinha	jasmináceo+N+DIM+F+SG
jasminaceinhas	jasmináceo+N+DIM+F+PL
jasminaceinho	jasmináceo+N+DIM+M+SG
jasminaceinhos	jasmináceo+N+DIM+M+PL
jasminaceozinho	jasmináceo+N+DIM+M+SG
jasminaceozinhos	jasmináceo+N+DIM+M+PL
jasminácea	jasmináceo+N+F+SG
jasmináceas	jasmináceo+N+F+PL
jasmináceo	jasmináceo+N+M+SG
jasmináceos	jasmináceo+N+M+PL
jaspe	jaspe+N+M+SG
jaspes	jaspe+N+M+PL
jaspezinho	jaspe+N+DIM+M+SG
jaspezinhos	jaspe+N+DIM+M+PL
jaspinho	jaspe+N+DIM+M+SG
jaspinhos	jaspe+N+DIM+M+PL
jaspeador	jaspeador+N+M+SG
jaspeadora	jaspeador+N+F+SG
jaspeadoras	jaspeador+N+F+PL
jaspeadorazinha	jaspeador+N+DIM+F+SG
jaspeadorazinhas	jaspeador+N+DIM+F+PL
jaspeadores	jaspeador+N+M+PL
jaspeadorezinhos	jaspeador+N+DIM+M+PL
jaspeadorinha	jaspeador+N+DIM+F+SG
jaspeadorinhas	jaspeador+N+DIM+F+PL
jaspeadorzinho	jaspeador+N+DIM+M+SG
jaspeadorzinhos	jaspeador+N+DIM+M+PL
jassaizinho	jassaí+N+DIM+M+SG
jassaizinhos	jassaí+N+DIM+M+PL
jassaí	jassaí+N+M+SG
jassaís	jassaí+N+M+PL
jasoniazinha	jasónia+N+DIM+F+SG
jasoniazinhas	jasónia+N+DIM+F+PL
jasoninha	jasónia+N+DIM+F+SG
jasoninhas	jasónia+N+DIM+F+PL
jasónia	jasónia+N+F+SG
jasónias	jasónia+N+F+PL
jasoniazinha	jasônia+N+DIM+F+SG
jasoniazinhas	jasônia+N+DIM+F+PL
jasoninha	jasônia+N+DIM+F+SG
jasoninhas	jasônia+N+DIM+F+PL
jasônia	jasônia+N+F+SG
jasônias	jasônia+N+F+PL
jatanciosidade	jatanciosidade+N+F+SG
jatanciosidades	jatanciosidade+N+F+PL
jatanciosidadezinha	jatanciosidade+N+DIM+F+SG
jatanciosidadezinhas	jatanciosidade+N+DIM+F+PL
jatanciosidadinha	jatanciosidade+N+DIM+F+SG
jatanciosidadinhas	jatanciosidade+N+DIM+F+PL
jataizinha	jataí+N+DIM+F+SG
jataizinhas	jataí+N+DIM+F+PL
jataizinho	jataí+N+DIM+M+SG
jataizinhos	jataí+N+DIM+M+PL
jataí	jataí+N+SG
jataís	jataí+N+PL
jataibazinha	jataíba+N+DIM+F+SG
jataibazinhas	jataíba+N+DIM+F+PL
jataibinha	jataíba+N+DIM+F+SG
jataibinhas	jataíba+N+DIM+F+PL
jataíba	jataíba+N+F+SG
jataíbas	jataíba+N+F+PL
jataubazinha	jataúba+N+DIM+F+SG
jataubazinhas	jataúba+N+DIM+F+PL
jataubinha	jataúba+N+DIM+F+SG
jataubinhas	jataúba+N+DIM+F+PL
jataúba	jataúba+N+F+SG
jataúbas	jataúba+N+F+PL
jati	jati+N+F+SG
jatis	jati+N+F+PL
jatizinha	jati+N+DIM+F+SG
jatizinhas	jati+N+DIM+F+PL
jatinho	jato+N+DIM+M+SG
jatinhos	jato+N+DIM+M+PL
jato	jato+N+M+SG
jatos	jato+N+M+PL
jatozinho	jato+N+DIM+M+SG
jatozinhos	jato+N+DIM+M+PL
jatobazinho	jatobá+N+DIM+M+SG
jatobazinhos	jatobá+N+DIM+M+PL
jatobá	jatobá+N+M+SG
jatobás	jatobá+N+M+PL
jatobA§-mirinzinho	jatobá-mirim+N+DIM+M+SG
jatobA§s-mirinzinhos	jatobá-mirim+N+DIM+M+PL
jatobá-mirim	jatobá-mirim+N+M+SG
jatobás-mirins	jatobá-mirim+N+M+PL
jatoplanador	jatoplanador+N+M+SG
jatoplanadores	jatoplanador+N+M+PL
jatoplanadorezinhos	jatoplanador+N+DIM+M+PL
jatoplanadorzinho	jatoplanador+N+DIM+M+SG
jatoplanadorzinhos	jatoplanador+N+DIM+M+PL
jatura	jatura+N+F+SG
jaturas	jatura+N+F+PL
jaturazinha	jatura+N+DIM+F+SG
jaturazinhas	jatura+N+DIM+F+PL
jaturinha	jatura+N+DIM+F+SG
jaturinhas	jatura+N+DIM+F+PL
jatanciazinha	jatância+N+DIM+F+SG
jatanciazinhas	jatância+N+DIM+F+PL
jatancinha	jatância+N+DIM+F+SG
jatancinhas	jatância+N+DIM+F+PL
jatância	jatância+N+F+SG
jatâncias	jatância+N+F+PL
jau	jau+N+SG
jaus	jau+N+PL
jauzinha	jau+N+DIM+F+SG
jauzinhas	jau+N+DIM+F+PL
jauzinho	jau+N+DIM+M+SG
jauzinhos	jau+N+DIM+M+PL
jaula	jaula+N+F+SG
jaulas	jaula+N+F+PL
jaulazinha	jaula+N+DIM+F+SG
jaulazinhas	jaula+N+DIM+F+PL
jaulinha	jaula+N+DIM+F+SG
jaulinhas	jaula+N+DIM+F+PL
jaulapiti	jaulapiti+N+SG
jaulapitis	jaulapiti+N+PL
jaulapitizinha	jaulapiti+N+DIM+F+SG
jaulapitizinhas	jaulapiti+N+DIM+F+PL
jaulapitizinho	jaulapiti+N+DIM+M+SG
jaulapitizinhos	jaulapiti+N+DIM+M+PL
javali	javali+N+M+SG
javalina	javali+N+F+SG
javalinas	javali+N+F+PL
javalinazinha	javali+N+DIM+F+SG
javalinazinhas	javali+N+DIM+F+PL
javalininha	javali+N+DIM+F+SG
javalininhas	javali+N+DIM+F+PL
javalis	javali+N+M+PL
javalizinho	javali+N+DIM+M+SG
javalizinhos	javali+N+DIM+M+PL
javalina	javalina+N+F+SG
javalinas	javalina+N+F+PL
javalinazinha	javalina+N+DIM+F+SG
javalinazinhas	javalina+N+DIM+F+PL
javalininha	javalina+N+DIM+F+SG
javalininhas	javalina+N+DIM+F+PL
javanca	javanco+N+F+SG
javancas	javanco+N+F+PL
javancazinha	javanco+N+DIM+F+SG
javancazinhas	javanco+N+DIM+F+PL
javanco	javanco+N+M+SG
javancos	javanco+N+M+PL
javancozinho	javanco+N+DIM+M+SG
javancozinhos	javanco+N+DIM+M+PL
javanquinha	javanco+N+DIM+F+SG
javanquinhas	javanco+N+DIM+F+PL
javanquinho	javanco+N+DIM+M+SG
javanquinhos	javanco+N+DIM+M+PL
javanesa	javanês+N+F+SG
javanesas	javanês+N+F+PL
javanesazinha	javanês+N+DIM+F+SG
javanesazinhas	javanês+N+DIM+F+PL
javaneses	javanês+N+M+PL
javanesezinhos	javanês+N+DIM+M+PL
javanesinha	javanês+N+DIM+F+SG
javanesinhas	javanês+N+DIM+F+PL
javanesinho	javanês+N+DIM+M+SG
javanesinhos	javanês+N+DIM+M+PL
javanês	javanês+N+M+SG
javardice	javardice+N+F+SG
javardices	javardice+N+F+PL
javardicezinha	javardice+N+DIM+F+SG
javardicezinhas	javardice+N+DIM+F+PL
javardicinha	javardice+N+DIM+F+SG
javardicinhas	javardice+N+DIM+F+PL
javarda	javardo+N+F+SG
javardas	javardo+N+F+PL
javardazinha	javardo+N+DIM+F+SG
javardazinhas	javardo+N+DIM+F+PL
javardinha	javardo+N+DIM+F+SG
javardinhas	javardo+N+DIM+F+PL
javardinho	javardo+N+DIM+M+SG
javardinhos	javardo+N+DIM+M+PL
javardo	javardo+N+M+SG
javardos	javardo+N+M+PL
javardozinho	javardo+N+DIM+M+SG
javardozinhos	javardo+N+DIM+M+PL
javari	javari+N+M+SG
javaris	javari+N+M+PL
javarizinho	javari+N+DIM+M+SG
javarizinhos	javari+N+DIM+M+PL
javaezinha	javaé+N+DIM+F+SG
javaezinhas	javaé+N+DIM+F+PL
javaezinho	javaé+N+DIM+M+SG
javaezinhos	javaé+N+DIM+M+PL
javaé	javaé+N+SG
javaés	javaé+N+PL
javradeira	javradeira+N+F+SG
javradeiras	javradeira+N+F+PL
javradeirazinha	javradeira+N+DIM+F+SG
javradeirazinhas	javradeira+N+DIM+F+PL
javradeirinha	javradeira+N+DIM+F+SG
javradeirinhas	javradeira+N+DIM+F+PL
javre	javre+N+M+SG
javres	javre+N+M+PL
javrezinho	javre+N+DIM+M+SG
javrezinhos	javre+N+DIM+M+PL
javrinho	javre+N+DIM+M+SG
javrinhos	javre+N+DIM+M+PL
javezinho	javé+N+DIM+M+SG
javezinhos	javé+N+DIM+M+PL
javé	javé+N+M+SG
javés	javé+N+M+PL
jazerina	jazerina+N+F+SG
jazerinas	jazerina+N+F+PL
jazerinazinha	jazerina+N+DIM+F+SG
jazerinazinhas	jazerina+N+DIM+F+PL
jazerininha	jazerina+N+DIM+F+SG
jazerininhas	jazerina+N+DIM+F+PL
jazerão	jazerão+N+M+SG
jazerãozinho	jazerão+N+DIM+M+SG
jazerões	jazerão+N+M+PL
jazerõezinhos	jazerão+N+DIM+M+PL
jazida	jazida+N+F+SG
jazidas	jazida+N+F+PL
jazidazinha	jazida+N+DIM+F+SG
jazidazinhas	jazida+N+DIM+F+PL
jazidinha	jazida+N+DIM+F+SG
jazidinhas	jazida+N+DIM+F+PL
jazigo	jazigo+N+M+SG
jazigos	jazigo+N+M+PL
jazigozinho	jazigo+N+DIM+M+SG
jazigozinhos	jazigo+N+DIM+M+PL
jaziguinho	jazigo+N+DIM+M+SG
jaziguinhos	jazigo+N+DIM+M+PL
jazimentinho	jazimento+N+DIM+M+SG
jazimentinhos	jazimento+N+DIM+M+PL
jazimento	jazimento+N+M+SG
jazimentos	jazimento+N+M+PL
jazimentozinho	jazimento+N+DIM+M+SG
jazimentozinhos	jazimento+N+DIM+M+PL
jazitura	jazitura+N+M+SG
jazituras	jazitura+N+M+PL
jaziturazinho	jazitura+N+DIM+M+SG
jaziturazinhos	jazitura+N+DIM+M+PL
jaziturinha	jazitura+N+DIM+M+SG
jaziturinhas	jazitura+N+DIM+M+PL
jazz	jazz+N+M+SG
jazzes	jazz+N+M+PL
jazzezinhos	jazz+N+DIM+M+PL
jazzinho	jazz+N+DIM+M+SG
jazzinhos	jazz+N+DIM+M+PL
jazz-band	jazz-band+N+M+SG
jazz-bandzinho	jazz-band+N+DIM+M+SG
jazz-funk	jazz-funk+N+M+SG
jazz-funkzinho	jazz-funk+N+DIM+M+SG
jazz-rock	jazz-rock+N+M+SG
jazz-rockzinho	jazz-rock+N+DIM+M+SG
jazzista	jazzista+N+SG
jazzistas	jazzista+N+PL
jazzistazinha	jazzista+N+DIM+F+SG
jazzistazinhas	jazzista+N+DIM+F+PL
jazzistazinho	jazzista+N+DIM+M+SG
jazzistazinhos	jazzista+N+DIM+M+PL
jazzistinha	jazzista+N+DIM+SG
jazzistinhas	jazzista+N+DIM+PL
jazzisticidade	jazzisticidade+N+F+SG
jazzisticidades	jazzisticidade+N+F+PL
jazzisticidadezinha	jazzisticidade+N+DIM+F+SG
jazzisticidadezinhas	jazzisticidade+N+DIM+F+PL
jazzisticidadinha	jazzisticidade+N+DIM+F+SG
jazzisticidadinhas	jazzisticidade+N+DIM+F+PL
jacinha	jaça+N+DIM+F+SG
jacinhas	jaça+N+DIM+F+PL
jaça	jaça+N+F+SG
jaças	jaça+N+F+PL
jaçazinha	jaça+N+DIM+F+SG
jaçazinhas	jaça+N+DIM+F+PL
jaçanã	jaçanã+N+F+SG
jaçanãs	jaçanã+N+F+PL
jaçanãzinha	jaçanã+N+DIM+F+SG
jaçanãzinhas	jaçanã+N+DIM+F+PL
jauzinho	jaú+N+DIM+M+SG
jauzinhos	jaú+N+DIM+M+PL
jaú	jaú+N+M+SG
jaús	jaú+N+M+PL
jeans	jeans+N
jeansinha	jeans+N+DIM+F+SG
jeansinhas	jeans+N+DIM+F+PL
jeansinho	jeans+N+DIM+M+SG
jeansinhos	jeans+N+DIM+M+PL
jeca-tatu	jeca-tatu+N+M+SG
jeca-tatuzinho	jeca-tatu+N+DIM+M+SG
jecas-tatus	jeca-tatu+N+M+PL
jecas-tatuzinhos	jeca-tatu+N+DIM+M+PL
jecoralidade	jecoralidade+N+F+SG
jecoralidades	jecoralidade+N+F+PL
jecoralidadezinha	jecoralidade+N+DIM+F+SG
jecoralidadezinhas	jecoralidade+N+DIM+F+PL
jecoralidadinha	jecoralidade+N+DIM+F+SG
jecoralidadinhas	jecoralidade+N+DIM+F+PL
jeep	jeep+N+M+SG
jeeps	jeep+N+M+PL
jeepzinho	jeep+N+DIM+M+SG
jeepzinhos	jeep+N+DIM+M+PL
jeffersoniazinha	jeffersónia+N+DIM+F+SG
jeffersoniazinhas	jeffersónia+N+DIM+F+PL
jeffersoninha	jeffersónia+N+DIM+F+SG
jeffersoninhas	jeffersónia+N+DIM+F+PL
jeffersónia	jeffersónia+N+F+SG
jeffersónias	jeffersónia+N+F+PL
jeffersoniazinha	jeffersônia+N+DIM+F+SG
jeffersoniazinhas	jeffersônia+N+DIM+F+PL
jeffersoninha	jeffersônia+N+DIM+F+SG
jeffersoninhas	jeffersônia+N+DIM+F+PL
jeffersônia	jeffersônia+N+F+SG
jeffersônias	jeffersônia+N+F+PL
jegue	jegue+N+M+SG
jegues	jegue+N+M+PL
jeguezinho	jegue+N+DIM+M+SG
jeguezinhos	jegue+N+DIM+M+PL
jeguinho	jegue+N+DIM+M+SG
jeguinhos	jegue+N+DIM+M+PL
jeira	jeira+N+F+SG
jeiras	jeira+N+F+PL
jeirazinha	jeira+N+DIM+F+SG
jeirazinhas	jeira+N+DIM+F+PL
jeirinha	jeira+N+DIM+F+SG
jeirinhas	jeira+N+DIM+F+PL
jeirão	jeirão+N+M+SG
jeirãozinho	jeirão+N+DIM+M+SG
jeirões	jeirão+N+M+PL
jeirõezinhos	jeirão+N+DIM+M+PL
jeitacinho	jeitaço+N+DIM+M+SG
jeitacinhos	jeitaço+N+DIM+M+PL
jeitaço	jeitaço+N+M+SG
jeitaços	jeitaço+N+M+PL
jeitaçozinho	jeitaço+N+DIM+M+SG
jeitaçozinhos	jeitaço+N+DIM+M+PL
jeiteira	jeiteira+N+F+SG
jeiteiras	jeiteira+N+F+PL
jeiteirazinha	jeiteira+N+DIM+F+SG
jeiteirazinhas	jeiteira+N+DIM+F+PL
jeiteirinha	jeiteira+N+DIM+F+SG
jeiteirinhas	jeiteira+N+DIM+F+PL
jeitinho	jeito+N+DIM+M+SG
jeitinhos	jeito+N+DIM+M+PL
jeitito	jeito+N+DIM+M+SG
jeititos	jeito+N+DIM+M+PL
jeito	jeito+N+M+SG
jeitos	jeito+N+M+PL
jeitozinho	jeito+N+DIM+M+SG
jeitozinhos	jeito+N+DIM+M+PL
jeitosidade	jeitosidade+N+F+SG
jeitosidades	jeitosidade+N+F+PL
jeitosidadezinha	jeitosidade+N+DIM+F+SG
jeitosidadezinhas	jeitosidade+N+DIM+F+PL
jeitosidadinha	jeitosidade+N+DIM+F+SG
jeitosidadinhas	jeitosidade+N+DIM+F+PL
jeitão	jeitão+N+M+SG
jeitãozinho	jeitão+N+DIM+M+SG
jeitões	jeitão+N+M+PL
jeitõezinhos	jeitão+N+DIM+M+PL
jeju	jeju+N+M+SG
jejus	jeju+N+M+PL
jejuzinho	jeju+N+DIM+M+SG
jejuzinhos	jeju+N+DIM+M+PL
jejuador	jejuador+N+M+SG
jejuadora	jejuador+N+F+SG
jejuadoras	jejuador+N+F+PL
jejuadorazinha	jejuador+N+DIM+F+SG
jejuadorazinhas	jejuador+N+DIM+F+PL
jejuadores	jejuador+N+M+PL
jejuadorezinhos	jejuador+N+DIM+M+PL
jejuadorinha	jejuador+N+DIM+F+SG
jejuadorinhas	jejuador+N+DIM+F+PL
jejuadorzinho	jejuador+N+DIM+M+SG
jejuadorzinhos	jejuador+N+DIM+M+PL
jejum	jejum+N+M+SG
jejuns	jejum+N+M+PL
jejunzinho	jejum+N+DIM+M+SG
jejunzinhos	jejum+N+DIM+M+PL
jejunalidade	jejunalidade+N+F+SG
jejunalidades	jejunalidade+N+F+PL
jejunalidadezinha	jejunalidade+N+DIM+F+SG
jejunalidadezinhas	jejunalidade+N+DIM+F+PL
jejunalidadinha	jejunalidade+N+DIM+F+SG
jejunalidadinhas	jejunalidade+N+DIM+F+PL
jejuna	jejuno+N+F+SG
jejunas	jejuno+N+F+PL
jejunazinha	jejuno+N+DIM+F+SG
jejunazinhas	jejuno+N+DIM+F+PL
jejuninha	jejuno+N+DIM+F+SG
jejuninhas	jejuno+N+DIM+F+PL
jejuninho	jejuno+N+DIM+M+SG
jejuninhos	jejuno+N+DIM+M+PL
jejuno	jejuno+N+M+SG
jejunos	jejuno+N+M+PL
jejunozinho	jejuno+N+DIM+M+SG
jejunozinhos	jejuno+N+DIM+M+PL
jejunostomicidade	jejunostomicidade+N+F+SG
jejunostomicidades	jejunostomicidade+N+F+PL
jejunostomicidadezinha	jejunostomicidade+N+DIM+F+SG
jejunostomicidadezinhas	jejunostomicidade+N+DIM+F+PL
jejunostomicidadinha	jejunostomicidade+N+DIM+F+SG
jejunostomicidadinhas	jejunostomicidade+N+DIM+F+PL
jenipapada	jenipapada+N+F+SG
jenipapadas	jenipapada+N+F+PL
jenipapadazinha	jenipapada+N+DIM+F+SG
jenipapadazinhas	jenipapada+N+DIM+F+PL
jenipapadinha	jenipapada+N+DIM+F+SG
jenipapadinhas	jenipapada+N+DIM+F+PL
jenipaparana	jenipaparana+N+F+SG
jenipaparanas	jenipaparana+N+F+PL
jenipaparanazinha	jenipaparana+N+DIM+F+SG
jenipaparanazinhas	jenipaparana+N+DIM+F+PL
jenipaparaninha	jenipaparana+N+DIM+F+SG
jenipaparaninhas	jenipaparana+N+DIM+F+PL
jenipapeirinho	jenipapeiro+N+DIM+M+SG
jenipapeirinhos	jenipapeiro+N+DIM+M+PL
jenipapeiro	jenipapeiro+N+M+SG
jenipapeiros	jenipapeiro+N+M+PL
jenipapeirozinho	jenipapeiro+N+DIM+M+SG
jenipapeirozinhos	jenipapeiro+N+DIM+M+PL
jenipapinho	jenipapo+N+DIM+M+SG
jenipapinhos	jenipapo+N+DIM+M+PL
jenipapo	jenipapo+N+M+SG
jenipapos	jenipapo+N+M+PL
jenipapozinho	jenipapo+N+DIM+M+SG
jenipapozinhos	jenipapo+N+DIM+M+PL
jenolim	jenolim+N+M+SG
jenolins	jenolim+N+M+PL
jenolinzinho	jenolim+N+DIM+M+SG
jenolinzinhos	jenolim+N+DIM+M+PL
jeovisminho	jeovismo+N+DIM+M+SG
jeovisminhos	jeovismo+N+DIM+M+PL
jeovismo	jeovismo+N+M+SG
jeovismos	jeovismo+N+M+PL
jeovismozinho	jeovismo+N+DIM+M+SG
jeovismozinhos	jeovismo+N+DIM+M+PL
jeovista	jeovista+N+SG
jeovistas	jeovista+N+PL
jeovistazinha	jeovista+N+DIM+F+SG
jeovistazinhas	jeovista+N+DIM+F+PL
jeovistazinho	jeovista+N+DIM+M+SG
jeovistazinhos	jeovista+N+DIM+M+PL
jeovistinha	jeovista+N+DIM+SG
jeovistinhas	jeovista+N+DIM+PL
jeovazinho	jeová+N+DIM+M+SG
jeovazinhos	jeová+N+DIM+M+PL
jeová	jeová+N+M+SG
jeovás	jeová+N+M+PL
jequiri	jequiri+N+M+SG
jequiris	jequiri+N+M+PL
jequirizinho	jequiri+N+DIM+M+SG
jequirizinhos	jequiri+N+DIM+M+PL
jequirioba	jequirioba+N+SG
jequiriobas	jequirioba+N+PL
jequiriobazinha	jequirioba+N+DIM+F+SG
jequiriobazinhas	jequirioba+N+DIM+F+PL
jequiriobazinho	jequirioba+N+DIM+M+SG
jequiriobazinhos	jequirioba+N+DIM+M+PL
jequiriobinha	jequirioba+N+DIM+SG
jequiriobinhas	jequirioba+N+DIM+PL
jequiriti	jequiriti+N+M+SG
jequiritis	jequiriti+N+M+PL
jequiritizinho	jequiriti+N+DIM+M+SG
jequiritizinhos	jequiriti+N+DIM+M+PL
jequiritina	jequiritina+N+F+SG
jequiritinas	jequiritina+N+F+PL
jequiritinazinha	jequiritina+N+DIM+F+SG
jequiritinazinhas	jequiritina+N+DIM+F+PL
jequiritininha	jequiritina+N+DIM+F+SG
jequiritininhas	jequiritina+N+DIM+F+PL
jequitibazinho	jequitibá+N+DIM+M+SG
jequitibazinhos	jequitibá+N+DIM+M+PL
jequitibá	jequitibá+N+M+SG
jequitibás	jequitibá+N+M+PL
jequitiranaboia	jequitiranaboia+N+F+SG
jequitiranaboias	jequitiranaboia+N+F+PL
jequitiranaboiazinha	jequitiranaboia+N+DIM+F+SG
jequitiranaboiazinhas	jequitiranaboia+N+DIM+F+PL
jequitiranaboinha	jequitiranaboia+N+DIM+F+SG
jequitiranaboinhas	jequitiranaboia+N+DIM+F+PL
jequitiranaboiazinha	jequitiranabóia+N+DIM+F+SG
jequitiranaboiazinhas	jequitiranabóia+N+DIM+F+PL
jequitiranaboinha	jequitiranabóia+N+DIM+F+SG
jequitiranaboinhas	jequitiranabóia+N+DIM+F+PL
jequitiranabóia	jequitiranabóia+N+F+SG
jequitiranabóias	jequitiranabóia+N+F+PL
jeraqui	jeraqui+N+M+SG
jeraquis	jeraqui+N+M+PL
jeraquizinho	jeraqui+N+DIM+M+SG
jeraquizinhos	jeraqui+N+DIM+M+PL
jerarca	jerarca+N+SG
jerarcas	jerarca+N+PL
jerarcazinha	jerarca+N+DIM+F+SG
jerarcazinhas	jerarca+N+DIM+F+PL
jerarcazinho	jerarca+N+DIM+M+SG
jerarcazinhos	jerarca+N+DIM+M+PL
jerarquinha	jerarca+N+DIM+SG
jerarquinhas	jerarca+N+DIM+PL
jerarquia	jerarquia+N+F+SG
jerarquias	jerarquia+N+F+PL
jerarquiazinha	jerarquia+N+DIM+F+SG
jerarquiazinhas	jerarquia+N+DIM+F+PL
jerarquinha	jerarquia+N+DIM+F+SG
jerarquinhas	jerarquia+N+DIM+F+PL
jerarquicidade	jerarquicidade+N+F+SG
jerarquicidades	jerarquicidade+N+F+PL
jerarquicidadezinha	jerarquicidade+N+DIM+F+SG
jerarquicidadezinhas	jerarquicidade+N+DIM+F+PL
jerarquicidadinha	jerarquicidade+N+DIM+F+SG
jerarquicidadinhas	jerarquicidade+N+DIM+F+PL
jerdoniazinha	jerdónia+N+DIM+F+SG
jerdoniazinhas	jerdónia+N+DIM+F+PL
jerdoninha	jerdónia+N+DIM+F+SG
jerdoninhas	jerdónia+N+DIM+F+PL
jerdónia	jerdónia+N+F+SG
jerdónias	jerdónia+N+F+PL
jerdoniazinha	jerdônia+N+DIM+F+SG
jerdoniazinhas	jerdônia+N+DIM+F+PL
jerdoninha	jerdônia+N+DIM+F+SG
jerdoninhas	jerdônia+N+DIM+F+PL
jerdônia	jerdônia+N+F+SG
jerdônias	jerdônia+N+F+PL
jereba	jereba+N+SG
jerebas	jereba+N+PL
jerebazinha	jereba+N+DIM+F+SG
jerebazinhas	jereba+N+DIM+F+PL
jerebazinho	jereba+N+DIM+M+SG
jerebazinhos	jereba+N+DIM+M+PL
jerebinha	jereba+N+DIM+SG
jerebinhas	jereba+N+DIM+PL
jeremiada	jeremiada+N+F+SG
jeremiadas	jeremiada+N+F+PL
jeremiadazinha	jeremiada+N+DIM+F+SG
jeremiadazinhas	jeremiada+N+DIM+F+PL
jeremiadinha	jeremiada+N+DIM+F+SG
jeremiadinhas	jeremiada+N+DIM+F+PL
jeremias	jeremias+N
jeremiasinha	jeremias+N+DIM+F+SG
jeremiasinhas	jeremias+N+DIM+F+PL
jeremiasinho	jeremias+N+DIM+M+SG
jeremiasinhos	jeremias+N+DIM+M+PL
jererezinho	jereré+N+DIM+M+SG
jererezinhos	jereré+N+DIM+M+PL
jereré	jereré+N+M+SG
jererés	jereré+N+M+PL
jererezinho	jererê+N+DIM+M+SG
jererezinhos	jererê+N+DIM+M+PL
jererê	jererê+N+M+SG
jererês	jererê+N+M+PL
jeribazeirinho	jeribazeiro+N+DIM+M+SG
jeribazeirinhos	jeribazeiro+N+DIM+M+PL
jeribazeiro	jeribazeiro+N+M+SG
jeribazeiros	jeribazeiro+N+M+PL
jeribazeirozinho	jeribazeiro+N+DIM+M+SG
jeribazeirozinhos	jeribazeiro+N+DIM+M+PL
jeribita	jeribita+N+F+SG
jeribitas	jeribita+N+F+PL
jeribitazinha	jeribita+N+DIM+F+SG
jeribitazinhas	jeribita+N+DIM+F+PL
jeribitinha	jeribita+N+DIM+F+SG
jeribitinhas	jeribita+N+DIM+F+PL
jeribazinha	jeribá+N+DIM+F+SG
jeribazinhas	jeribá+N+DIM+F+PL
jeribazinho	jeribá+N+DIM+M+SG
jeribazinhos	jeribá+N+DIM+M+PL
jeribá	jeribá+N+SG
jeribás	jeribá+N+PL
jericada	jericada+N+F+SG
jericadas	jericada+N+F+PL
jericadazinha	jericada+N+DIM+F+SG
jericadazinhas	jericada+N+DIM+F+PL
jericadinha	jericada+N+DIM+F+SG
jericadinhas	jericada+N+DIM+F+PL
jericalidade	jericalidade+N+F+SG
jericalidades	jericalidade+N+F+PL
jericalidadezinha	jericalidade+N+DIM+F+SG
jericalidadezinhas	jericalidade+N+DIM+F+PL
jericalidadinha	jericalidade+N+DIM+F+SG
jericalidadinhas	jericalidade+N+DIM+F+PL
jerica	jerico+N+F+SG
jericas	jerico+N+F+PL
jericazinha	jerico+N+DIM+F+SG
jericazinhas	jerico+N+DIM+F+PL
jerico	jerico+N+M+SG
jericos	jerico+N+M+PL
jericozinho	jerico+N+DIM+M+SG
jericozinhos	jerico+N+DIM+M+PL
jeriquinha	jerico+N+DIM+F+SG
jeriquinhas	jerico+N+DIM+F+PL
jeriquinho	jerico+N+DIM+M+SG
jeriquinhos	jerico+N+DIM+M+PL
jerimu	jerimu+N+M+SG
jerimus	jerimu+N+M+PL
jerimuzinho	jerimu+N+DIM+M+SG
jerimuzinhos	jerimu+N+DIM+M+PL
jerimum	jerimum+N+M+SG
jerimuns	jerimum+N+M+PL
jerimunzinho	jerimum+N+DIM+M+SG
jerimunzinhos	jerimum+N+DIM+M+PL
jerimunzeirinho	jerimunzeiro+N+DIM+M+SG
jerimunzeirinhos	jerimunzeiro+N+DIM+M+PL
jerimunzeiro	jerimunzeiro+N+M+SG
jerimunzeiros	jerimunzeiro+N+M+PL
jerimunzeirozinho	jerimunzeiro+N+DIM+M+SG
jerimunzeirozinhos	jerimunzeiro+N+DIM+M+PL
jeripiti	jeripiti+N+M+SG
jeripitis	jeripiti+N+M+PL
jeripitizinho	jeripiti+N+DIM+M+SG
jeripitizinhos	jeripiti+N+DIM+M+PL
jeritacaca	jeritacaca+N+F+SG
jeritacacas	jeritacaca+N+F+PL
jeritacacazinha	jeritacaca+N+DIM+F+SG
jeritacacazinhas	jeritacaca+N+DIM+F+PL
jeritacaquinha	jeritacaca+N+DIM+F+SG
jeritacaquinhas	jeritacaca+N+DIM+F+PL
jerivazais	jerivazal+N+M+PL
jerivazaizinhos	jerivazal+N+DIM+M+PL
jerivazal	jerivazal+N+M+SG
jerivazalzinho	jerivazal+N+DIM+M+SG
jerivazeirinho	jerivazeiro+N+DIM+M+SG
jerivazeirinhos	jerivazeiro+N+DIM+M+PL
jerivazeiro	jerivazeiro+N+M+SG
jerivazeiros	jerivazeiro+N+M+PL
jerivazeirozinho	jerivazeiro+N+DIM+M+SG
jerivazeirozinhos	jerivazeiro+N+DIM+M+PL
jerivazinha	jerivá+N+DIM+F+SG
jerivazinhas	jerivá+N+DIM+F+PL
jerivazinho	jerivá+N+DIM+M+SG
jerivazinhos	jerivá+N+DIM+M+PL
jerivá	jerivá+N+SG
jerivás	jerivá+N+PL
jeriza	jeriza+N+F+SG
jerizas	jeriza+N+F+PL
jerizazinha	jeriza+N+DIM+F+SG
jerizazinhas	jeriza+N+DIM+F+PL
jerizinha	jeriza+N+DIM+F+SG
jerizinhas	jeriza+N+DIM+F+PL
jeroglificidade	jeroglificidade+N+F+SG
jeroglificidades	jeroglificidade+N+F+PL
jeroglificidadezinha	jeroglificidade+N+DIM+F+SG
jeroglificidadezinhas	jeroglificidade+N+DIM+F+PL
jeroglificidadinha	jeroglificidade+N+DIM+F+SG
jeroglificidadinhas	jeroglificidade+N+DIM+F+PL
jeronimita	jeronimita+N+SG
jeronimitas	jeronimita+N+PL
jeronimitazinha	jeronimita+N+DIM+F+SG
jeronimitazinhas	jeronimita+N+DIM+F+PL
jeronimitazinho	jeronimita+N+DIM+M+SG
jeronimitazinhos	jeronimita+N+DIM+M+PL
jeronimitinha	jeronimita+N+DIM+SG
jeronimitinhas	jeronimita+N+DIM+PL
jeropiga	jeropiga+N+F+SG
jeropigas	jeropiga+N+F+PL
jeropigazinha	jeropiga+N+DIM+F+SG
jeropigazinhas	jeropiga+N+DIM+F+PL
jeropiguinha	jeropiga+N+DIM+F+SG
jeropiguinhas	jeropiga+N+DIM+F+PL
jerosolimitaninho	jerosolimitano+N+DIM+M+SG
jerosolimitaninhos	jerosolimitano+N+DIM+M+PL
jerosolimitano	jerosolimitano+N+M+SG
jerosolimitanos	jerosolimitano+N+M+PL
jerosolimitanozinho	jerosolimitano+N+DIM+M+SG
jerosolimitanozinhos	jerosolimitano+N+DIM+M+PL
jeruva	jeruva+N+F+SG
jeruvas	jeruva+N+F+PL
jeruvazinha	jeruva+N+DIM+F+SG
jeruvazinhas	jeruva+N+DIM+F+PL
jeruvinha	jeruva+N+DIM+F+SG
jeruvinhas	jeruva+N+DIM+F+PL
jeroglifinho	jeróglifo+N+DIM+M+SG
jeroglifinhos	jeróglifo+N+DIM+M+PL
jeroglifozinho	jeróglifo+N+DIM+M+SG
jeroglifozinhos	jeróglifo+N+DIM+M+PL
jeróglifo	jeróglifo+N+M+SG
jeróglifos	jeróglifo+N+M+PL
jeronimazinha	jerónimo+N+DIM+F+SG
jeronimazinhas	jerónimo+N+DIM+F+PL
jeroniminha	jerónimo+N+DIM+F+SG
jeroniminhas	jerónimo+N+DIM+F+PL
jeroniminho	jerónimo+N+DIM+M+SG
jeroniminhos	jerónimo+N+DIM+M+PL
jeronimozinho	jerónimo+N+DIM+M+SG
jeronimozinhos	jerónimo+N+DIM+M+PL
jerónima	jerónimo+N+F+SG
jerónimas	jerónimo+N+F+PL
jerónimo	jerónimo+N+M+SG
jerónimos	jerónimo+N+M+PL
jeroniminho	jerônimo+N+DIM+M+SG
jeroniminhos	jerônimo+N+DIM+M+PL
jeronimozinho	jerônimo+N+DIM+M+SG
jeronimozinhos	jerônimo+N+DIM+M+PL
jerônimo	jerônimo+N+M+SG
jerônimos	jerônimo+N+M+PL
jessaizinho	jessaí+N+DIM+M+SG
jessaizinhos	jessaí+N+DIM+M+PL
jessaí	jessaí+N+M+SG
jessaís	jessaí+N+M+PL
jesuitada	jesuitada+N+F+SG
jesuitadas	jesuitada+N+F+PL
jesuitadazinha	jesuitada+N+DIM+F+SG
jesuitadazinhas	jesuitada+N+DIM+F+PL
jesuitadinha	jesuitada+N+DIM+F+SG
jesuitadinhas	jesuitada+N+DIM+F+PL
jesuitice	jesuitice+N+F+SG
jesuitices	jesuitice+N+F+PL
jesuiticezinha	jesuitice+N+DIM+F+SG
jesuiticezinhas	jesuitice+N+DIM+F+PL
jesuiticinha	jesuitice+N+DIM+F+SG
jesuiticinhas	jesuitice+N+DIM+F+PL
jesuiticidade	jesuiticidade+N+F+SG
jesuiticidades	jesuiticidade+N+F+PL
jesuiticidadezinha	jesuiticidade+N+DIM+F+SG
jesuiticidadezinhas	jesuiticidade+N+DIM+F+PL
jesuiticidadinha	jesuiticidade+N+DIM+F+SG
jesuiticidadinhas	jesuiticidade+N+DIM+F+PL
jesuitisminho	jesuitismo+N+DIM+M+SG
jesuitisminhos	jesuitismo+N+DIM+M+PL
jesuitismo	jesuitismo+N+M+SG
jesuitismos	jesuitismo+N+M+PL
jesuitismozinho	jesuitismo+N+DIM+M+SG
jesuitismozinhos	jesuitismo+N+DIM+M+PL
jesuitofobia	jesuitofobia+N+F+SG
jesuitofobias	jesuitofobia+N+F+PL
jesuitofobiazinha	jesuitofobia+N+DIM+F+SG
jesuitofobiazinhas	jesuitofobia+N+DIM+F+PL
jesuitofobinha	jesuitofobia+N+DIM+F+SG
jesuitofobinhas	jesuitofobia+N+DIM+F+PL
jesus	jesus+N+M+SG
jesusinho	jesus+N+DIM+M+SG
jesusinhos	jesus+N+DIM+M+PL
jesuss	jesus+N+M+PL
jesus-meu-deus	jesus-meu-deus+N+M
jesus-meu-deusinhas	jesus-meu-deus+N+DIM+F+PL
jesus-meu-deusinho	jesus-meu-deus+N+DIM+M+SG
jesus-meu-deusinhos	jesus-meu-deus+N+DIM+M+PL
jesuitazinho	jesuíta+N+DIM+M+SG
jesuitazinhos	jesuíta+N+DIM+M+PL
jesuitinha	jesuíta+N+DIM+M+SG
jesuitinhas	jesuíta+N+DIM+M+PL
jesuíta	jesuíta+N+M+SG
jesuítas	jesuíta+N+M+PL
jet-foil	jet-foil+N+M+SG
jet-foils	jet-foil+N+M+PL
jet-foilzinho	jet-foil+N+DIM+M+SG
jet-foilzinhos	jet-foil+N+DIM+M+PL
jet-lag	jet-lag+N
jet-lagzinha	jet-lag+N+DIM+F+SG
jet-lagzinhas	jet-lag+N+DIM+F+PL
jet-lagzinho	jet-lag+N+DIM+M+SG
jet-lagzinhos	jet-lag+N+DIM+M+PL
jet-set	jet-set+N
jet-setzinha	jet-set+N+DIM+F+SG
jet-setzinhas	jet-set+N+DIM+F+PL
jet-setzinho	jet-set+N+DIM+M+SG
jet-setzinhos	jet-set+N+DIM+M+PL
jetaizinho	jetaí+N+DIM+M+SG
jetaizinhos	jetaí+N+DIM+M+PL
jetaí	jetaí+N+M+SG
jetaís	jetaí+N+M+PL
jetaibazinha	jetaíba+N+DIM+F+SG
jetaibazinhas	jetaíba+N+DIM+F+PL
jetaibinha	jetaíba+N+DIM+F+SG
jetaibinhas	jetaíba+N+DIM+F+PL
jetaíba	jetaíba+N+F+SG
jetaíbas	jetaíba+N+F+PL
jetica	jetica+N+F+SG
jeticas	jetica+N+F+PL
jeticazinha	jetica+N+DIM+F+SG
jeticazinhas	jetica+N+DIM+F+PL
jetiquinha	jetica+N+DIM+F+SG
jetiquinhas	jetica+N+DIM+F+PL
jetski	jetski+N+M+SG
jetskizinho	jetski+N+DIM+M+SG
ji	ji+N+M+SG
jis	ji+N+M+PL
jizinho	ji+N+DIM+M+SG
jizinhos	ji+N+DIM+M+PL
jia	jia+N+F+SG
jias	jia+N+F+PL
jiazinha	jia+N+DIM+F+SG
jiazinhas	jia+N+DIM+F+PL
jinha	jia+N+DIM+F+SG
jinhas	jia+N+DIM+F+PL
jiba	jiba+N+F+SG
jibas	jiba+N+F+PL
jibazinha	jiba+N+DIM+F+SG
jibazinhas	jiba+N+DIM+F+PL
jibinha	jiba+N+DIM+F+SG
jibinhas	jiba+N+DIM+F+PL
jiboia	jiboia+N+F+SG
jiboias	jiboia+N+F+PL
jiboiazinha	jiboia+N+DIM+F+SG
jiboiazinhas	jiboia+N+DIM+F+PL
jiboinha	jiboia+N+DIM+F+SG
jiboinhas	jiboia+N+DIM+F+PL
jiboiazinha	jibóia+N+DIM+F+SG
jiboiazinhas	jibóia+N+DIM+F+PL
jiboinha	jibóia+N+DIM+F+SG
jiboinhas	jibóia+N+DIM+F+PL
jibóia	jibóia+N+F+SG
jibóias	jibóia+N+F+PL
jicara	jicara+N+F+SG
jicaras	jicara+N+F+PL
jicarazinha	jicara+N+DIM+F+SG
jicarazinhas	jicara+N+DIM+F+PL
jicarinha	jicara+N+DIM+F+SG
jicarinhas	jicara+N+DIM+F+PL
jidong	jidong+N+M+SG
jidongzinho	jidong+N+DIM+M+SG
jifingo	jifingo+N+M+SG
jifingos	jifingo+N+M+PL
jifingozinho	jifingo+N+DIM+M+SG
jifingozinhos	jifingo+N+DIM+M+PL
jifinguinho	jifingo+N+DIM+M+SG
jifinguinhos	jifingo+N+DIM+M+PL
jiga	jiga+N+F+SG
jigas	jiga+N+F+PL
jigazinha	jiga+N+DIM+F+SG
jigazinhas	jiga+N+DIM+F+PL
jiguinha	jiga+N+DIM+F+SG
jiguinhas	jiga+N+DIM+F+PL
jigajoga	jigajoga+N+F+SG
jigajogas	jigajoga+N+F+PL
jigajogazinha	jigajoga+N+DIM+F+SG
jigajogazinhas	jigajoga+N+DIM+F+PL
jigajoguinha	jigajoga+N+DIM+F+SG
jigajoguinhas	jigajoga+N+DIM+F+PL
jiju	jiju+N+M+SG
jijus	jiju+N+M+PL
jijuzinho	jiju+N+DIM+M+SG
jijuzinhos	jiju+N+DIM+M+PL
jilaba	jilaba+N+F+SG
jilabas	jilaba+N+F+PL
jilabazinha	jilaba+N+DIM+F+SG
jilabazinhas	jilaba+N+DIM+F+PL
jilabinha	jilaba+N+DIM+F+SG
jilabinhas	jilaba+N+DIM+F+PL
jiloeirinho	jiloeiro+N+DIM+M+SG
jiloeirinhos	jiloeiro+N+DIM+M+PL
jiloeiro	jiloeiro+N+M+SG
jiloeiros	jiloeiro+N+M+PL
jiloeirozinho	jiloeiro+N+DIM+M+SG
jiloeirozinhos	jiloeiro+N+DIM+M+PL
jilozinho	jiló+N+DIM+M+SG
jilozinhos	jiló+N+DIM+M+PL
jiló	jiló+N+M+SG
jilós	jiló+N+M+PL
jimbinho	jimbo+N+DIM+M+SG
jimbinhos	jimbo+N+DIM+M+PL
jimbo	jimbo+N+M+SG
jimbos	jimbo+N+M+PL
jimbozinho	jimbo+N+DIM+M+SG
jimbozinhos	jimbo+N+DIM+M+PL
jimbolamentinho	jimbolamento+N+DIM+M+SG
jimbolamentinhos	jimbolamento+N+DIM+M+PL
jimbolamento	jimbolamento+N+M+SG
jimbolamentos	jimbolamento+N+M+PL
jimbolamentozinho	jimbolamento+N+DIM+M+SG
jimbolamentozinhos	jimbolamento+N+DIM+M+PL
jimbolinho	jimbolo+N+DIM+M+SG
jimbolinhos	jimbolo+N+DIM+M+PL
jimbolo	jimbolo+N+M+SG
jimbolos	jimbolo+N+M+PL
jimbolozinho	jimbolo+N+DIM+M+SG
jimbolozinhos	jimbolo+N+DIM+M+PL
jimbongo	jimbongo+N+M+SG
jimbongos	jimbongo+N+M+PL
jimbongozinho	jimbongo+N+DIM+M+SG
jimbongozinhos	jimbongo+N+DIM+M+PL
jimbonguinho	jimbongo+N+DIM+M+SG
jimbonguinhos	jimbongo+N+DIM+M+PL
jimbuia	jimbuia+N+F+SG
jimbuias	jimbuia+N+F+PL
jimbuiazinha	jimbuia+N+DIM+F+SG
jimbuiazinhas	jimbuia+N+DIM+F+PL
jimbuinha	jimbuia+N+DIM+F+SG
jimbuinhas	jimbuia+N+DIM+F+PL
jinga	jinga+N+SG
jingas	jinga+N+PL
jingazinha	jinga+N+DIM+F+SG
jingazinhas	jinga+N+DIM+F+PL
jingazinho	jinga+N+DIM+M+SG
jingazinhos	jinga+N+DIM+M+PL
jinguinha	jinga+N+DIM+SG
jinguinhas	jinga+N+DIM+PL
jingle	jingle+N+M+SG
jingles	jingle+N+M+PL
jinglezinho	jingle+N+DIM+M+SG
jinglezinhos	jingle+N+DIM+M+PL
jinglinho	jingle+N+DIM+M+SG
jinglinhos	jingle+N+DIM+M+PL
jinga	jingo+N+F+SG
jingas	jingo+N+F+PL
jingazinha	jingo+N+DIM+F+SG
jingazinhas	jingo+N+DIM+F+PL
jingo	jingo+N+M+SG
jingos	jingo+N+M+PL
jingozinho	jingo+N+DIM+M+SG
jingozinhos	jingo+N+DIM+M+PL
jinguinha	jingo+N+DIM+F+SG
jinguinhas	jingo+N+DIM+F+PL
jinguinho	jingo+N+DIM+M+SG
jinguinhos	jingo+N+DIM+M+PL
jingoisminho	jingoísmo+N+DIM+M+SG
jingoisminhos	jingoísmo+N+DIM+M+PL
jingoismozinho	jingoísmo+N+DIM+M+SG
jingoismozinhos	jingoísmo+N+DIM+M+PL
jingoísmo	jingoísmo+N+M+SG
jingoísmos	jingoísmo+N+M+PL
jingoistazinha	jingoísta+N+DIM+F+SG
jingoistazinhas	jingoísta+N+DIM+F+PL
jingoistazinho	jingoísta+N+DIM+M+SG
jingoistazinhos	jingoísta+N+DIM+M+PL
jingoistinha	jingoísta+N+DIM+SG
jingoistinhas	jingoísta+N+DIM+PL
jingoísta	jingoísta+N+SG
jingoístas	jingoísta+N+PL
jinguba	jinguba+N+F+SG
jingubas	jinguba+N+F+PL
jingubazinha	jinguba+N+DIM+F+SG
jingubazinhas	jinguba+N+DIM+F+PL
jingubinha	jinguba+N+DIM+F+SG
jingubinhas	jinguba+N+DIM+F+PL
jiparanazinho	jiparaná+N+DIM+M+SG
jiparaná	jiparaná+N+M+SG
jipe	jipe+N+M+SG
jipes	jipe+N+M+PL
jipezinho	jipe+N+DIM+M+SG
jipezinhos	jipe+N+DIM+M+PL
jipinho	jipe+N+DIM+M+SG
jipinhos	jipe+N+DIM+M+PL
jipão	jipe+N+AUG+M+SG
jipãozinho	jipe+N+AUG+DIM+M+SG
jipões	jipe+N+AUG+M+PL
jipõezinhos	jipe+N+AUG+DIM+M+PL
jipoubazinha	jipoúba+N+DIM+F+SG
jipoubazinhas	jipoúba+N+DIM+F+PL
jipoubinha	jipoúba+N+DIM+F+SG
jipoubinhas	jipoúba+N+DIM+F+PL
jipoúba	jipoúba+N+F+SG
jipoúbas	jipoúba+N+F+PL
jiquirioba	jiquirioba+N+F+SG
jiquiriobas	jiquirioba+N+F+PL
jiquiriobazinha	jiquirioba+N+DIM+F+SG
jiquiriobazinhas	jiquirioba+N+DIM+F+PL
jiquiriobinha	jiquirioba+N+DIM+F+SG
jiquiriobinhas	jiquirioba+N+DIM+F+PL
jiquiriti	jiquiriti+N+M+SG
jiquiritis	jiquiriti+N+M+PL
jiquiritizinho	jiquiriti+N+DIM+M+SG
jiquiritizinhos	jiquiriti+N+DIM+M+PL
jiquirozinho	jiquiró+N+DIM+M+SG
jiquirozinhos	jiquiró+N+DIM+M+PL
jiquiró	jiquiró+N+M+SG
jiquirós	jiquiró+N+M+PL
jiquitaia	jiquitaia+N+F+SG
jiquitaias	jiquitaia+N+F+PL
jiquitaiazinha	jiquitaia+N+DIM+F+SG
jiquitaiazinhas	jiquitaia+N+DIM+F+PL
jiquitainha	jiquitaia+N+DIM+F+SG
jiquitainhas	jiquitaia+N+DIM+F+PL
jirau	jirau+N+M+SG
jiraus	jirau+N+M+PL
jirauzinho	jirau+N+DIM+M+SG
jirauzinhos	jirau+N+DIM+M+PL
jirimu	jirimu+N+M+SG
jirimus	jirimu+N+M+PL
jirimuzinho	jirimu+N+DIM+M+SG
jirimuzinhos	jirimu+N+DIM+M+PL
jirimum	jirimum+N+M+SG
jirimuns	jirimum+N+M+PL
jirimunzinho	jirimum+N+DIM+M+SG
jirimunzinhos	jirimum+N+DIM+M+PL
jiripiti	jiripiti+N+M+SG
jiripitis	jiripiti+N+M+PL
jiripitizinho	jiripiti+N+DIM+M+SG
jiripitizinhos	jiripiti+N+DIM+M+PL
jiriti	jiriti+N+M+SG
jiritis	jiriti+N+M+PL
jiritizinho	jiriti+N+DIM+M+SG
jiritizinhos	jiriti+N+DIM+M+PL
jitica	jitica+N+F+SG
jiticas	jitica+N+F+PL
jiticazinha	jitica+N+DIM+F+SG
jiticazinhas	jitica+N+DIM+F+PL
jitiquinha	jitica+N+DIM+F+SG
jitiquinhas	jitica+N+DIM+F+PL
jitirana	jitirana+N+F+SG
jitiranas	jitirana+N+F+PL
jitiranazinha	jitirana+N+DIM+F+SG
jitiranazinhas	jitirana+N+DIM+F+PL
jitiraninha	jitirana+N+DIM+F+SG
jitiraninhas	jitirana+N+DIM+F+PL
jitiranaboia	jitiranaboia+N+F+SG
jitiranaboias	jitiranaboia+N+F+PL
jitiranaboiazinha	jitiranaboia+N+DIM+F+SG
jitiranaboiazinhas	jitiranaboia+N+DIM+F+PL
jitiranaboinha	jitiranaboia+N+DIM+F+SG
jitiranaboinhas	jitiranaboia+N+DIM+F+PL
jitinho	jito+N+DIM+M+SG
jitinhos	jito+N+DIM+M+PL
jito	jito+N+M+SG
jitos	jito+N+M+PL
jitozinho	jito+N+DIM+M+SG
jitozinhos	jito+N+DIM+M+PL
jitozinho	jitó+N+DIM+M+SG
jitozinhos	jitó+N+DIM+M+PL
jitó	jitó+N+M+SG
jitós	jitó+N+M+PL
jiu-jitsu	jiu-jitsu+N+M+SG
jiu-jitsuzinho	jiu-jitsu+N+DIM+M+SG
jiujutsu	jiujutsu+N+M+SG
jiujutsus	jiujutsu+N+M+PL
jiujutsuzinho	jiujutsu+N+DIM+M+SG
jiujutsuzinhos	jiujutsu+N+DIM+M+PL
jiçara	jiçara+N+F+SG
jiçaras	jiçara+N+F+PL
jiçarazinha	jiçara+N+DIM+F+SG
jiçarazinhas	jiçara+N+DIM+F+PL
jiçarinha	jiçara+N+DIM+F+SG
jiçarinhas	jiçara+N+DIM+F+PL
joalharia	joalharia+N+F+SG
joalharias	joalharia+N+F+PL
joalhariazinha	joalharia+N+DIM+F+SG
joalhariazinhas	joalharia+N+DIM+F+PL
joalharinha	joalharia+N+DIM+F+SG
joalharinhas	joalharia+N+DIM+F+PL
joalheira	joalheiro+N+F+SG
joalheiras	joalheiro+N+F+PL
joalheirazinha	joalheiro+N+DIM+F+SG
joalheirazinhas	joalheiro+N+DIM+F+PL
joalheirinha	joalheiro+N+DIM+F+SG
joalheirinhas	joalheiro+N+DIM+F+PL
joalheirinho	joalheiro+N+DIM+M+SG
joalheirinhos	joalheiro+N+DIM+M+PL
joalheiro	joalheiro+N+M+SG
joalheiros	joalheiro+N+M+PL
joalheirozinho	joalheiro+N+DIM+M+SG
joalheirozinhos	joalheiro+N+DIM+M+PL
joalheria	joalheria+N+F+SG
joalherias	joalheria+N+F+PL
joalheriazinha	joalheria+N+DIM+F+SG
joalheriazinhas	joalheria+N+DIM+F+PL
joalherinha	joalheria+N+DIM+F+SG
joalherinhas	joalheria+N+DIM+F+PL
joanete	joanete+N+M+SG
joanetes	joanete+N+M+PL
joanetezinho	joanete+N+DIM+M+SG
joanetezinhos	joanete+N+DIM+M+PL
joanetinho	joanete+N+DIM+M+SG
joanetinhos	joanete+N+DIM+M+PL
joanica	joanico+N+F+SG
joanicas	joanico+N+F+PL
joanicazinha	joanico+N+DIM+F+SG
joanicazinhas	joanico+N+DIM+F+PL
joanico	joanico+N+M+SG
joanicos	joanico+N+M+PL
joanicozinho	joanico+N+DIM+M+SG
joanicozinhos	joanico+N+DIM+M+PL
joaniquinha	joanico+N+DIM+F+SG
joaniquinhas	joanico+N+DIM+F+PL
joaniquinho	joanico+N+DIM+M+SG
joaniquinhos	joanico+N+DIM+M+PL
joaninha	joaninha+N+F+SG
joaninhas	joaninha+N+F+PL
joaninhazinha	joaninha+N+DIM+F+SG
joaninhazinhas	joaninha+N+DIM+F+PL
joaninhinha	joaninha+N+DIM+F+SG
joaninhinhas	joaninha+N+DIM+F+PL
job	job+N+M+SG
jobes	job+N+M+PL
jobezinhos	job+N+DIM+M+PL
jobzinho	job+N+DIM+M+SG
jocos	jocos+N+M+PL
jocosinhas	jocos+N+DIM+F+PL
jocosinhos	jocos+N+DIM+M+PL
jocosidade	jocosidade+N+F+SG
jocosidades	jocosidade+N+F+PL
jocosidadezinha	jocosidade+N+DIM+F+SG
jocosidadezinhas	jocosidade+N+DIM+F+PL
jocosidadinha	jocosidade+N+DIM+F+SG
jocosidadinhas	jocosidade+N+DIM+F+PL
jocozinho	jocó+N+DIM+M+SG
jocozinhos	jocó+N+DIM+M+PL
jocó	jocó+N+M+SG
jocós	jocó+N+M+PL
joeira	joeira+N+F+SG
joeiras	joeira+N+F+PL
joeirazinha	joeira+N+DIM+F+SG
joeirazinhas	joeira+N+DIM+F+PL
joeirinha	joeira+N+DIM+F+SG
joeirinhas	joeira+N+DIM+F+PL
joeiramentinho	joeiramento+N+DIM+M+SG
joeiramentinhos	joeiramento+N+DIM+M+PL
joeiramento	joeiramento+N+M+SG
joeiramentos	joeiramento+N+M+PL
joeiramentozinho	joeiramento+N+DIM+M+SG
joeiramentozinhos	joeiramento+N+DIM+M+PL
joeireira	joeireiro+N+F+SG
joeireiras	joeireiro+N+F+PL
joeireirazinha	joeireiro+N+DIM+F+SG
joeireirazinhas	joeireiro+N+DIM+F+PL
joeireirinha	joeireiro+N+DIM+F+SG
joeireirinhas	joeireiro+N+DIM+F+PL
joeireirinho	joeireiro+N+DIM+M+SG
joeireirinhos	joeireiro+N+DIM+M+PL
joeireiro	joeireiro+N+M+SG
joeireiros	joeireiro+N+M+PL
joeireirozinho	joeireiro+N+DIM+M+SG
joeireirozinhos	joeireiro+N+DIM+M+PL
joeirinho	joeiro+N+DIM+M+SG
joeirinhos	joeiro+N+DIM+M+PL
joeiro	joeiro+N+M+SG
joeiros	joeiro+N+M+PL
joeirozinho	joeiro+N+DIM+M+SG
joeirozinhos	joeiro+N+DIM+M+PL
joelhada	joelhada+N+F+SG
joelhadas	joelhada+N+F+PL
joelhadazinha	joelhada+N+DIM+F+SG
joelhadazinhas	joelhada+N+DIM+F+PL
joelhadinha	joelhada+N+DIM+F+SG
joelhadinhas	joelhada+N+DIM+F+PL
joelhacinho	joelhaço+N+DIM+F+SG
joelhacinhos	joelhaço+N+DIM+F+PL
joelhaço	joelhaço+N+F+SG
joelhaços	joelhaço+N+F+PL
joelhaçozinha	joelhaço+N+DIM+F+SG
joelhaçozinhas	joelhaço+N+DIM+F+PL
joelheira	joelheira+N+F+SG
joelheiras	joelheira+N+F+PL
joelheirazinha	joelheira+N+DIM+F+SG
joelheirazinhas	joelheira+N+DIM+F+PL
joelheirinha	joelheira+N+DIM+F+SG
joelheirinhas	joelheira+N+DIM+F+PL
joelheira	joelheiro+N+F+SG
joelheiras	joelheiro+N+F+PL
joelheirazinha	joelheiro+N+DIM+F+SG
joelheirazinhas	joelheiro+N+DIM+F+PL
joelheirinha	joelheiro+N+DIM+F+SG
joelheirinhas	joelheiro+N+DIM+F+PL
joelheirinho	joelheiro+N+DIM+M+SG
joelheirinhos	joelheiro+N+DIM+M+PL
joelheiro	joelheiro+N+M+SG
joelheiros	joelheiro+N+M+PL
joelheirozinho	joelheiro+N+DIM+M+SG
joelheirozinhos	joelheiro+N+DIM+M+PL
joelhinho	joelho+N+DIM+M+SG
joelhinhos	joelho+N+DIM+M+PL
joelho	joelho+N+M+SG
joelhos	joelho+N+M+PL
joelhozinho	joelho+N+DIM+M+SG
joelhozinhos	joelho+N+DIM+M+PL
joga	joga+N+F+SG
jogas	joga+N+F+PL
jogazinha	joga+N+DIM+F+SG
jogazinhas	joga+N+DIM+F+PL
joguinha	joga+N+DIM+F+SG
joguinhas	joga+N+DIM+F+PL
jogabilidade	jogabilidade+N+F+SG
jogabilidades	jogabilidade+N+F+PL
jogabilidadezinha	jogabilidade+N+DIM+F+SG
jogabilidadezinhas	jogabilidade+N+DIM+F+PL
jogabilidadinha	jogabilidade+N+DIM+F+SG
jogabilidadinhas	jogabilidade+N+DIM+F+PL
jogada	jogada+N+F+SG
jogadas	jogada+N+F+PL
jogadazinha	jogada+N+DIM+F+SG
jogadazinhas	jogada+N+DIM+F+PL
jogadinha	jogada+N+DIM+F+SG
jogadinhas	jogada+N+DIM+F+PL
jogadita	jogada+N+DIM+F+SG
jogaditas	jogada+N+DIM+F+PL
jogadinho	jogado+N+DIM+M+SG
jogadinhos	jogado+N+DIM+M+PL
jogado	jogado+N+M+SG
jogados	jogado+N+M+PL
jogadozinho	jogado+N+DIM+M+SG
jogadozinhos	jogado+N+DIM+M+PL
jogadoirinho	jogadoiro+N+DIM+M+SG
jogadoirinhos	jogadoiro+N+DIM+M+PL
jogadoiro	jogadoiro+N+M+SG
jogadoiros	jogadoiro+N+M+PL
jogadoirozinho	jogadoiro+N+DIM+M+SG
jogadoirozinhos	jogadoiro+N+DIM+M+PL
jogador	jogador+N+M+SG
jogadora	jogador+N+F+SG
jogadoras	jogador+N+F+PL
jogadorazinha	jogador+N+DIM+F+SG
jogadorazinhas	jogador+N+DIM+F+PL
jogadores	jogador+N+M+PL
jogadorezinhos	jogador+N+DIM+M+PL
jogadorinha	jogador+N+DIM+F+SG
jogadorinhas	jogador+N+DIM+F+PL
jogadorzinho	jogador+N+DIM+M+SG
jogadorzinhos	jogador+N+DIM+M+PL
jogador-treinador	jogador-treinador+N+M+SG
jogador-treinadorzinho	jogador-treinador+N+DIM+M+SG
jogadora-treinadora	jogador-treinador+N+F+SG
jogadora-treinadorazinha	jogador-treinador+N+DIM+F+SG
jogadora-treinadorinha	jogador-treinador+N+DIM+F+SG
jogadora-treinadorinhas	jogador-treinador+N+DIM+F+PL
jogadoras-treinadoras	jogador-treinador+N+F+PL
jogadoras-treinadorazinhas	jogador-treinador+N+DIM+F+PL
jogadores-treinadores	jogador-treinador+N+M+PL
jogadores-treinadorezinhos	jogador-treinador+N+DIM+M+PL
jogadores-treinadorzinhos	jogador-treinador+N+DIM+M+PL
jogadourinho	jogadouro+N+DIM+M+SG
jogadourinhos	jogadouro+N+DIM+M+PL
jogadouro	jogadouro+N+M+SG
jogadouros	jogadouro+N+M+PL
jogadourozinho	jogadouro+N+DIM+M+SG
jogadourozinhos	jogadouro+N+DIM+M+PL
jogata	jogata+N+F+SG
jogatas	jogata+N+F+PL
jogatazinha	jogata+N+DIM+F+SG
jogatazinhas	jogata+N+DIM+F+PL
jogatinha	jogata+N+DIM+F+SG
jogatinhas	jogata+N+DIM+F+PL
jogatana	jogatana+N+F+SG
jogatanas	jogatana+N+F+PL
jogatanazinha	jogatana+N+DIM+F+SG
jogatanazinhas	jogatana+N+DIM+F+PL
jogataninha	jogatana+N+DIM+F+SG
jogataninhas	jogatana+N+DIM+F+PL
jogatina	jogatina+N+F+SG
jogatinas	jogatina+N+F+PL
jogatinazinha	jogatina+N+DIM+F+SG
jogatinazinhas	jogatina+N+DIM+F+PL
jogatininha	jogatina+N+DIM+F+SG
jogatininhas	jogatina+N+DIM+F+PL
jogging	jogging+N+M+SG
joggings	jogging+N+M+PL
joggingzinho	jogging+N+DIM+M+SG
joggingzinhos	jogging+N+DIM+M+PL
jogo	jogo+N+M+SG
jogos	jogo+N+M+PL
jogozinho	jogo+N+DIM+M+SG
jogozinhos	jogo+N+DIM+M+PL
joguinho	jogo+N+DIM+M+SG
joguinhos	jogo+N+DIM+M+PL
joguito	jogo+N+DIM+M+SG
joguitos	jogo+N+DIM+M+PL
jogo-chave	jogo-chave+N+M+SG
jogo-chavezinho	jogo-chave+N+DIM+M+SG
jogo-chavinho	jogo-chave+N+DIM+M+SG
jogo-chavinhos	jogo-chave+N+DIM+M+PL
jogos-chave	jogo-chave+N+M+PL
jogos-chavezinhos	jogo-chave+N+DIM+M+PL
jogo-da-velha	jogo-da-velha+N+M+SG
jogo-da-velhazinho	jogo-da-velha+N+DIM+M+SG
jogo-da-velhinha	jogo-da-velha+N+DIM+M+SG
jogo-da-velhinhas	jogo-da-velha+N+DIM+M+PL
jogos-da-velha	jogo-da-velha+N+M+PL
jogos-da-velhazinhos	jogo-da-velha+N+DIM+M+PL
jogo-exibição	jogo-exibição+N+M+SG
jogo-exibiçãozinho	jogo-exibição+N+DIM+M+SG
jogos-exibição	jogo-exibição+N+M+PL
jogos-exibiçãozinhos	jogo-exibição+N+DIM+M+PL
jogo-teste	jogo-teste+N+M+SG
jogo-testezinho	jogo-teste+N+DIM+M+SG
jogo-testinho	jogo-teste+N+DIM+M+SG
jogo-testinhos	jogo-teste+N+DIM+M+PL
jogos-teste	jogo-teste+N+M+PL
jogos-testezinhos	jogo-teste+N+DIM+M+PL
jogo-treininho	jogo-treino+N+DIM+M+SG
jogo-treininhos	jogo-treino+N+DIM+M+PL
jogo-treino	jogo-treino+N+M+SG
jogo-treinozinho	jogo-treino+N+DIM+M+SG
jogos-treino	jogo-treino+N+M+PL
jogos-treinozinhos	jogo-treino+N+DIM+M+PL
jograis	jogral+N+M+PL
jograizinhos	jogral+N+DIM+M+PL
jogral	jogral+N+M+SG
jogralesa	jogral+N+F+SG
jogralesas	jogral+N+F+PL
jogralesazinha	jogral+N+DIM+F+SG
jogralesazinhas	jogral+N+DIM+F+PL
jogralesinha	jogral+N+DIM+F+SG
jogralesinhas	jogral+N+DIM+F+PL
jogralzinho	jogral+N+DIM+M+SG
jogralesa	jogralesa+N+F+SG
jogralesas	jogralesa+N+F+PL
jogralesazinha	jogralesa+N+DIM+F+SG
jogralesazinhas	jogralesa+N+DIM+F+PL
jogralesinha	jogralesa+N+DIM+F+SG
jogralesinhas	jogralesa+N+DIM+F+PL
jogralesca	jogralesca+N+F+SG
jogralescas	jogralesca+N+F+PL
jogralescazinha	jogralesca+N+DIM+F+SG
jogralescazinhas	jogralesca+N+DIM+F+PL
jogralesquinha	jogralesca+N+DIM+F+SG
jogralesquinhas	jogralesca+N+DIM+F+PL
jogralice	jogralice+N+F+SG
jogralices	jogralice+N+F+PL
jogralicezinha	jogralice+N+DIM+F+SG
jogralicezinhas	jogralice+N+DIM+F+PL
jogralicinha	jogralice+N+DIM+F+SG
jogralicinhas	jogralice+N+DIM+F+PL
jogralidade	jogralidade+N+F+SG
jogralidades	jogralidade+N+F+PL
jogralidadezinha	jogralidade+N+DIM+F+SG
jogralidadezinhas	jogralidade+N+DIM+F+PL
jogralidadinha	jogralidade+N+DIM+F+SG
jogralidadinhas	jogralidade+N+DIM+F+PL
jogue	jogue+N+M+SG
jogues	jogue+N+M+PL
joguezinho	jogue+N+DIM+M+SG
joguezinhos	jogue+N+DIM+M+PL
joguinho	jogue+N+DIM+M+SG
joguinhos	jogue+N+DIM+M+PL
joguete	joguete+N+M+SG
joguetes	joguete+N+M+PL
joguetezinho	joguete+N+DIM+M+SG
joguetezinhos	joguete+N+DIM+M+PL
joguetinho	joguete+N+DIM+M+SG
joguetinhos	joguete+N+DIM+M+PL
jogão	jogão+N+M+SG
jogãozinho	jogão+N+DIM+M+SG
jogões	jogão+N+M+PL
jogõezinhos	jogão+N+DIM+M+PL
joia	joia+N+F+SG
joias	joia+N+F+PL
joiazinha	joia+N+DIM+F+SG
joiazinhas	joia+N+DIM+F+PL
joinha	joia+N+DIM+F+SG
joinhas	joia+N+DIM+F+PL
joina	joina+N+F+SG
joinas	joina+N+F+PL
joinazinha	joina+N+DIM+F+SG
joinazinhas	joina+N+DIM+F+PL
joininha	joina+N+DIM+F+SG
joininhas	joina+N+DIM+F+PL
joint-venture	joint-venture+N+F+SG
joint-ventures	joint-venture+N+F+PL
joint-venturezinha	joint-venture+N+DIM+F+SG
joint-venturezinhas	joint-venture+N+DIM+F+PL
joint-venturinha	joint-venture+N+DIM+F+SG
joint-venturinhas	joint-venture+N+DIM+F+PL
joint-venturzinhas	joint-venture+N+DIM+F+PL
joinho	joio+N+DIM+M+SG
joinhos	joio+N+DIM+M+PL
joio	joio+N+M+SG
joios	joio+N+M+PL
joiozinho	joio+N+DIM+M+SG
joiozinhos	joio+N+DIM+M+PL
joker	joker+N+M+SG
jokers	joker+N+M+PL
jokerzinho	joker+N+DIM+M+SG
jokerzinhos	joker+N+DIM+M+PL
jolda	jolda+N+F+SG
joldas	jolda+N+F+PL
joldazinha	jolda+N+DIM+F+SG
joldazinhas	jolda+N+DIM+F+PL
joldinha	jolda+N+DIM+F+SG
joldinhas	jolda+N+DIM+F+PL
joldra	joldra+N+F+SG
joldras	joldra+N+F+PL
joldrazinha	joldra+N+DIM+F+SG
joldrazinhas	joldra+N+DIM+F+PL
joldrinha	joldra+N+DIM+F+SG
joldrinhas	joldra+N+DIM+F+PL
jongo	jongo+N+M+SG
jongos	jongo+N+M+PL
jongozinho	jongo+N+DIM+M+SG
jongozinhos	jongo+N+DIM+M+PL
jonguinho	jongo+N+DIM+M+SG
jonguinhos	jongo+N+DIM+M+PL
jongueirinho	jongueiro+N+DIM+M+SG
jongueirinhos	jongueiro+N+DIM+M+PL
jongueiro	jongueiro+N+M+SG
jongueiros	jongueiro+N+M+PL
jongueirozinho	jongueiro+N+DIM+M+SG
jongueirozinhos	jongueiro+N+DIM+M+PL
jonicidade	jonicidade+N+F+SG
jonicidades	jonicidade+N+F+PL
jonicidadezinha	jonicidade+N+DIM+F+SG
jonicidadezinhas	jonicidade+N+DIM+F+PL
jonicidadinha	jonicidade+N+DIM+F+SG
jonicidadinhas	jonicidade+N+DIM+F+PL
jordana	jordano+N+F+SG
jordanas	jordano+N+F+PL
jordanazinha	jordano+N+DIM+F+SG
jordanazinhas	jordano+N+DIM+F+PL
jordaninha	jordano+N+DIM+F+SG
jordaninhas	jordano+N+DIM+F+PL
jordaninho	jordano+N+DIM+M+SG
jordaninhos	jordano+N+DIM+M+PL
jordano	jordano+N+M+SG
jordanos	jordano+N+M+PL
jordanozinho	jordano+N+DIM+M+SG
jordanozinhos	jordano+N+DIM+M+PL
jordano-palestiniana	jordano-palestiniano+N+F+SG
jordano-palestinianas	jordano-palestiniano+N+F+PL
jordano-palestinianazinha	jordano-palestiniano+N+DIM+F+SG
jordano-palestinianazinhas	jordano-palestiniano+N+DIM+F+PL
jordano-palestinianinha	jordano-palestiniano+N+DIM+F+SG
jordano-palestinianinhas	jordano-palestiniano+N+DIM+F+PL
jordano-palestinianinho	jordano-palestiniano+N+DIM+M+SG
jordano-palestinianinhos	jordano-palestiniano+N+DIM+M+PL
jordano-palestiniano	jordano-palestiniano+N+M+SG
jordano-palestinianos	jordano-palestiniano+N+M+PL
jordano-palestinianozinho	jordano-palestiniano+N+DIM+M+SG
jordano-palestinianozinhos	jordano-palestiniano+N+DIM+M+PL
jorna	jorna+N+F+SG
jornas	jorna+N+F+PL
jornazinha	jorna+N+DIM+F+SG
jornazinhas	jorna+N+DIM+F+PL
jorninha	jorna+N+DIM+F+SG
jorninhas	jorna+N+DIM+F+PL
jornada	jornada+N+F+SG
jornadas	jornada+N+F+PL
jornadazinha	jornada+N+DIM+F+SG
jornadazinhas	jornada+N+DIM+F+PL
jornadinha	jornada+N+DIM+F+SG
jornadinhas	jornada+N+DIM+F+PL
jornais	jornal+N+M+PL
jornaizinhos	jornal+N+DIM+M+PL
jornaizitos	jornal+N+DIM+M+PL
jornal	jornal+N+M+SG
jornalinho	jornal+N+DIM+M+SG
jornalinhos	jornal+N+DIM+M+PL
jornalito	jornal+N+DIM+M+SG
jornalitos	jornal+N+DIM+M+PL
jornalzinho	jornal+N+DIM+M+SG
jornalzito	jornal+N+DIM+M+SG
jornalada	jornalada+N+F+SG
jornaladas	jornalada+N+F+PL
jornaladazinha	jornalada+N+DIM+F+SG
jornaladazinhas	jornalada+N+DIM+F+PL
jornaladinha	jornalada+N+DIM+F+SG
jornaladinhas	jornalada+N+DIM+F+PL
jornaleco	jornaleco+N+M+SG
jornalecos	jornaleco+N+M+PL
jornalecozinho	jornaleco+N+DIM+M+SG
jornalecozinhos	jornaleco+N+DIM+M+PL
jornalequinho	jornaleco+N+DIM+M+SG
jornalequinhos	jornaleco+N+DIM+M+PL
jornaleira	jornaleiro+N+F+SG
jornaleiras	jornaleiro+N+F+PL
jornaleirazinha	jornaleiro+N+DIM+F+SG
jornaleirazinhas	jornaleiro+N+DIM+F+PL
jornaleirinha	jornaleiro+N+DIM+F+SG
jornaleirinhas	jornaleiro+N+DIM+F+PL
jornaleirinho	jornaleiro+N+DIM+M+SG
jornaleirinhos	jornaleiro+N+DIM+M+PL
jornaleiro	jornaleiro+N+M+SG
jornaleiros	jornaleiro+N+M+PL
jornaleirozinho	jornaleiro+N+DIM+M+SG
jornaleirozinhos	jornaleiro+N+DIM+M+PL
jornalisminho	jornalismo+N+DIM+M+SG
jornalisminhos	jornalismo+N+DIM+M+PL
jornalismo	jornalismo+N+M+SG
jornalismos	jornalismo+N+M+PL
jornalismozinho	jornalismo+N+DIM+M+SG
jornalismozinhos	jornalismo+N+DIM+M+PL
jornalista	jornalista+N+SG
jornalistas	jornalista+N+PL
jornalistazinha	jornalista+N+DIM+F+SG
jornalistazinhas	jornalista+N+DIM+F+PL
jornalistazinho	jornalista+N+DIM+M+SG
jornalistazinhos	jornalista+N+DIM+M+PL
jornalistinha	jornalista+N+DIM+SG
jornalistinhas	jornalista+N+DIM+PL
jornalisticidade	jornalisticidade+N+F+SG
jornalisticidades	jornalisticidade+N+F+PL
jornalisticidadezinha	jornalisticidade+N+DIM+F+SG
jornalisticidadezinhas	jornalisticidade+N+DIM+F+PL
jornalisticidadinha	jornalisticidade+N+DIM+F+SG
jornalisticidadinhas	jornalisticidade+N+DIM+F+PL
jorneia	jorneia+N+F+SG
jorneias	jorneia+N+F+PL
jorneiazinha	jorneia+N+DIM+F+SG
jorneiazinhas	jorneia+N+DIM+F+PL
jorneinha	jorneia+N+DIM+F+SG
jorneinhas	jorneia+N+DIM+F+PL
jorra	jorra+N+F+SG
jorras	jorra+N+F+PL
jorrazinha	jorra+N+DIM+F+SG
jorrazinhas	jorra+N+DIM+F+PL
jorrinha	jorra+N+DIM+F+SG
jorrinhas	jorra+N+DIM+F+PL
jorramentinho	jorramento+N+DIM+M+SG
jorramentinhos	jorramento+N+DIM+M+PL
jorramento	jorramento+N+M+SG
jorramentos	jorramento+N+M+PL
jorramentozinho	jorramento+N+DIM+M+SG
jorramentozinhos	jorramento+N+DIM+M+PL
jorrinho	jorro+N+DIM+M+SG
jorrinhos	jorro+N+DIM+M+PL
jorro	jorro+N+M+SG
jorros	jorro+N+M+PL
jorrozinho	jorro+N+DIM+M+SG
jorrozinhos	jorro+N+DIM+M+PL
jorrão	jorrão+N+M+SG
jorrãozinho	jorrão+N+DIM+M+SG
jorrões	jorrão+N+M+PL
jorrõezinhos	jorrão+N+DIM+M+PL
josefina	josefino+N+F+SG
josefinas	josefino+N+F+PL
josefinazinha	josefino+N+DIM+F+SG
josefinazinhas	josefino+N+DIM+F+PL
josefininha	josefino+N+DIM+F+SG
josefininhas	josefino+N+DIM+F+PL
josefininho	josefino+N+DIM+M+SG
josefininhos	josefino+N+DIM+M+PL
josefino	josefino+N+M+SG
josefinos	josefino+N+M+PL
josefinozinho	josefino+N+DIM+M+SG
josefinozinhos	josefino+N+DIM+M+PL
josezinhinho	josezinho+N+DIM+M+SG
josezinhinhos	josezinho+N+DIM+M+PL
josezinho	josezinho+N+M+SG
josezinhos	josezinho+N+M+PL
josezinhozinho	josezinho+N+DIM+M+SG
josezinhozinhos	josezinho+N+DIM+M+PL
jota	jota+N+M+SG
jotas	jota+N+M+PL
jotazinho	jota+N+DIM+M+SG
jotazinhos	jota+N+DIM+M+PL
jotinha	jota+N+DIM+M+SG
jotinhas	jota+N+DIM+M+PL
jotnianinho	jotniano+N+DIM+M+SG
jotnianinhos	jotniano+N+DIM+M+PL
jotniano	jotniano+N+M+SG
jotnianos	jotniano+N+M+PL
jotnianozinho	jotniano+N+DIM+M+SG
jotnianozinhos	jotniano+N+DIM+M+PL
joule	joule+N+M+SG
joules	joule+N+M+PL
joulezinho	joule+N+DIM+M+SG
joulezinhos	joule+N+DIM+M+PL
joulinho	joule+N+DIM+M+SG
joulinhos	joule+N+DIM+M+PL
jovem	jovem+N+SG
jovens	jovem+N+PL
jovenzinha	jovem+N+DIM+F+SG
jovenzinhas	jovem+N+DIM+F+PL
jovenzinho	jovem+N+DIM+M+SG
jovenzinhos	jovem+N+DIM+M+PL
jovialidade	jovialidade+N+F+SG
jovialidades	jovialidade+N+F+PL
jovialidadezinha	jovialidade+N+DIM+F+SG
jovialidadezinhas	jovialidade+N+DIM+F+PL
jovialidadinha	jovialidade+N+DIM+F+SG
jovialidadinhas	jovialidade+N+DIM+F+PL
joão-bobinho	joão-bobo+N+DIM+M+SG
joão-bobinhos	joão-bobo+N+DIM+M+PL
joão-bobo	joão-bobo+N+M+SG
joão-bobozinho	joão-bobo+N+DIM+M+SG
joões-bobos	joão-bobo+N+M+PL
joões-bobozinhos	joão-bobo+N+DIM+M+PL
joão-de-barrinho	joão-de-barro+N+DIM+M+SG
joão-de-barrinhos	joão-de-barro+N+DIM+M+PL
joão-de-barro	joão-de-barro+N+M+SG
joão-de-barrozinho	joão-de-barro+N+DIM+M+SG
joões-de-barro	joão-de-barro+N+M+PL
joões-de-barrozinhos	joão-de-barro+N+DIM+M+PL
joão-ninguenzinho	joão-ninguém+N+DIM+M+SG
joão-ninguém	joão-ninguém+N+M+SG
joões-ninguenzinhos	joão-ninguém+N+DIM+M+PL
joões-ninguém	joão-ninguém+N+M+PL
joão-pestana	joão-pestana+N+M+SG
joão-pestanas	joão-pestana+N+M+PL
joão-pestanazinho	joão-pestana+N+DIM+M+SG
joão-pestanazinhos	joão-pestana+N+DIM+M+PL
joão-pestaninha	joão-pestana+N+DIM+M+SG
joão-pestaninhas	joão-pestana+N+DIM+M+PL
joões-pestanas	joão-pestana+N+M+PL
joões-pestanazinhos	joão-pestana+N+DIM+M+PL
joão-teimosinho	joão-teimoso+N+DIM+M+SG
joão-teimosinhos	joão-teimoso+N+DIM+M+PL
joão-teimoso	joão-teimoso+N+M+SG
joão-teimosozinho	joão-teimoso+N+DIM+M+SG
joões-teimosos	joão-teimoso+N+M+PL
joões-teimosozinhos	joão-teimoso+N+DIM+M+PL
jocinha	joça+N+DIM+F+SG
jocinhas	joça+N+DIM+F+PL
joça	joça+N+F+SG
joças	joça+N+F+PL
joçazinha	joça+N+DIM+F+SG
joçazinhas	joça+N+DIM+F+PL
juazeirinho	juazeiro+N+DIM+M+SG
juazeirinhos	juazeiro+N+DIM+M+PL
juazeiro	juazeiro+N+M+SG
juazeiros	juazeiro+N+M+PL
juazeirozinho	juazeiro+N+DIM+M+SG
juazeirozinhos	juazeiro+N+DIM+M+PL
juba	juba+N+F+SG
jubas	juba+N+F+PL
jubazinha	juba+N+DIM+F+SG
jubazinhas	juba+N+DIM+F+PL
jubinha	juba+N+DIM+F+SG
jubinhas	juba+N+DIM+F+PL
jubanete	jubanete+N+M+SG
jubanetes	jubanete+N+M+PL
jubanetezinho	jubanete+N+DIM+M+SG
jubanetezinhos	jubanete+N+DIM+M+PL
jubanetinho	jubanete+N+DIM+M+SG
jubanetinhos	jubanete+N+DIM+M+PL
jubeba	jubeba+N+F+SG
jubebas	jubeba+N+F+PL
jubebazinha	jubeba+N+DIM+F+SG
jubebazinhas	jubeba+N+DIM+F+PL
jubebinha	jubeba+N+DIM+F+SG
jubebinhas	jubeba+N+DIM+F+PL
jubeia	jubeia+N+F+SG
jubeias	jubeia+N+F+PL
jubeiazinha	jubeia+N+DIM+F+SG
jubeiazinhas	jubeia+N+DIM+F+PL
jubeinha	jubeia+N+DIM+F+SG
jubeinhas	jubeia+N+DIM+F+PL
jubeta	jubeta+N+F+SG
jubetas	jubeta+N+F+PL
jubetazinha	jubeta+N+DIM+F+SG
jubetazinhas	jubeta+N+DIM+F+PL
jubetinha	jubeta+N+DIM+F+SG
jubetinhas	jubeta+N+DIM+F+PL
jubilabilidade	jubilabilidade+N+F+SG
jubilabilidades	jubilabilidade+N+F+PL
jubilabilidadezinha	jubilabilidade+N+DIM+F+SG
jubilabilidadezinhas	jubilabilidade+N+DIM+F+PL
jubilabilidadinha	jubilabilidade+N+DIM+F+SG
jubilabilidadinhas	jubilabilidade+N+DIM+F+PL
jubilada	jubilado+N+F+SG
jubiladas	jubilado+N+F+PL
jubiladazinha	jubilado+N+DIM+F+SG
jubiladazinhas	jubilado+N+DIM+F+PL
jubiladinha	jubilado+N+DIM+F+SG
jubiladinhas	jubilado+N+DIM+F+PL
jubiladinho	jubilado+N+DIM+M+SG
jubiladinhos	jubilado+N+DIM+M+PL
jubilado	jubilado+N+M+SG
jubilados	jubilado+N+M+PL
jubiladozinho	jubilado+N+DIM+M+SG
jubiladozinhos	jubilado+N+DIM+M+PL
jubilaridade	jubilaridade+N+F+SG
jubilaridades	jubilaridade+N+F+PL
jubilaridadezinha	jubilaridade+N+DIM+F+SG
jubilaridadezinhas	jubilaridade+N+DIM+F+PL
jubilaridadinha	jubilaridade+N+DIM+F+SG
jubilaridadinhas	jubilaridade+N+DIM+F+PL
jubilação	jubilação+N+F+SG
jubilaçãozinha	jubilação+N+DIM+F+SG
jubilações	jubilação+N+F+PL
jubilaçõezinhas	jubilação+N+DIM+F+PL
jubileu	jubileu+N+M+SG
jubileus	jubileu+N+M+PL
jubileuzinho	jubileu+N+DIM+M+SG
jubileuzinhos	jubileu+N+DIM+M+PL
jubilosidade	jubilosidade+N+F+SG
jubilosidades	jubilosidade+N+F+PL
jubilosidadezinha	jubilosidade+N+DIM+F+SG
jubilosidadezinhas	jubilosidade+N+DIM+F+PL
jubilosidadinha	jubilosidade+N+DIM+F+SG
jubilosidadinhas	jubilosidade+N+DIM+F+PL
juciri	juciri+N+M+SG
juciris	juciri+N+M+PL
jucirizinho	juciri+N+DIM+M+SG
jucirizinhos	juciri+N+DIM+M+PL
jucubaubazinho	jucubaúba+N+DIM+M+SG
jucubaubazinhos	jucubaúba+N+DIM+M+PL
jucubaubinha	jucubaúba+N+DIM+M+SG
jucubaubinhas	jucubaúba+N+DIM+M+PL
jucubaúba	jucubaúba+N+M+SG
jucubaúbas	jucubaúba+N+M+PL
jucundidade	jucundidade+N+F+SG
jucundidades	jucundidade+N+F+PL
jucundidadezinha	jucundidade+N+DIM+F+SG
jucundidadezinhas	jucundidade+N+DIM+F+PL
jucundidadinha	jucundidade+N+DIM+F+SG
jucundidadinhas	jucundidade+N+DIM+F+PL
jucuru	jucuru+N+M+SG
jucurus	jucuru+N+M+PL
jucuruzinho	jucuru+N+DIM+M+SG
jucuruzinhos	jucuru+N+DIM+M+PL
jucurutu	jucurutu+N+M+SG
jucurutus	jucurutu+N+M+PL
jucurutuzinho	jucurutu+N+DIM+M+SG
jucurutuzinhos	jucurutu+N+DIM+M+PL
jucazinha	jucá+N+DIM+F+SG
jucazinhas	jucá+N+DIM+F+PL
jucazinho	jucá+N+DIM+M+SG
jucazinhos	jucá+N+DIM+M+PL
jucá	jucá+N+SG
jucás	jucá+N+PL
judaizabilidade	judaizabilidade+N+F+SG
judaizabilidades	judaizabilidade+N+F+PL
judaizabilidadezinha	judaizabilidade+N+DIM+F+SG
judaizabilidadezinhas	judaizabilidade+N+DIM+F+PL
judaizabilidadinha	judaizabilidade+N+DIM+F+SG
judaizabilidadinhas	judaizabilidade+N+DIM+F+PL
judaizante	judaizante+N+SG
judaizantes	judaizante+N+PL
judaizantezinha	judaizante+N+DIM+F+SG
judaizantezinhas	judaizante+N+DIM+F+PL
judaizantezinho	judaizante+N+DIM+M+SG
judaizantezinhos	judaizante+N+DIM+M+PL
judaizantinha	judaizante+N+DIM+F+SG
judaizantinhas	judaizante+N+DIM+F+PL
judaizantinho	judaizante+N+DIM+M+SG
judaizantinhos	judaizante+N+DIM+M+PL
judas	judas+N
judasinha	judas+N+DIM+F+SG
judasinhas	judas+N+DIM+F+PL
judasinho	judas+N+DIM+M+SG
judasinhos	judas+N+DIM+M+PL
judaisminho	judaísmo+N+DIM+M+SG
judaisminhos	judaísmo+N+DIM+M+PL
judaismozinho	judaísmo+N+DIM+M+SG
judaismozinhos	judaísmo+N+DIM+M+PL
judaísmo	judaísmo+N+M+SG
judaísmos	judaísmo+N+M+PL
judaistazinha	judaísta+N+DIM+F+SG
judaistazinhas	judaísta+N+DIM+F+PL
judaistazinho	judaísta+N+DIM+M+SG
judaistazinhos	judaísta+N+DIM+M+PL
judaistinha	judaísta+N+DIM+SG
judaistinhas	judaísta+N+DIM+PL
judaísta	judaísta+N+SG
judaístas	judaísta+N+PL
judenga	judenga+N+F+SG
judengas	judenga+N+F+PL
judengazinha	judenga+N+DIM+F+SG
judengazinhas	judenga+N+DIM+F+PL
judenguinha	judenga+N+DIM+F+SG
judenguinhas	judenga+N+DIM+F+PL
judeu	judeu+N+M+SG
judeus	judeu+N+M+PL
judeuzinho	judeu+N+DIM+M+SG
judeuzinhos	judeu+N+DIM+M+PL
judia	judeu+N+F+SG
judias	judeu+N+F+PL
judiazinha	judeu+N+DIM+F+SG
judiazinhas	judeu+N+DIM+F+PL
judinha	judeu+N+DIM+F+SG
judinhas	judeu+N+DIM+F+PL
judeu-cristianisminho	judeu-cristianismo+N+DIM+M+SG
judeu-cristianisminhos	judeu-cristianismo+N+DIM+M+PL
judeu-cristianismo	judeu-cristianismo+N+M+SG
judeu-cristianismos	judeu-cristianismo+N+M+PL
judeu-cristianismozinho	judeu-cristianismo+N+DIM+M+SG
judeu-cristianismozinhos	judeu-cristianismo+N+DIM+M+PL
judeu-cristã	judeu-cristão+N+F+SG
judeu-cristão	judeu-cristão+N+M+SG
judeu-cristãos	judeu-cristão+N+M+PL
judeu-cristãozinho	judeu-cristão+N+DIM+M+SG
judeu-cristãozinhos	judeu-cristão+N+DIM+M+PL
judeu-cristãs	judeu-cristão+N+F+PL
judeu-cristãzinha	judeu-cristão+N+DIM+F+SG
judeu-cristãzinhas	judeu-cristão+N+DIM+F+PL
judia	judia+N+F+SG
judias	judia+N+F+PL
judiazinha	judia+N+DIM+F+SG
judiazinhas	judia+N+DIM+F+PL
judinha	judia+N+DIM+F+SG
judinhas	judia+N+DIM+F+PL
judiaria	judiaria+N+F+SG
judiarias	judiaria+N+F+PL
judiariazinha	judiaria+N+DIM+F+SG
judiariazinhas	judiaria+N+DIM+F+PL
judiarinha	judiaria+N+DIM+F+SG
judiarinhas	judiaria+N+DIM+F+PL
judiação	judiação+N+F+SG
judiaçãozinha	judiação+N+DIM+F+SG
judiações	judiação+N+F+PL
judiaçõezinhas	judiação+N+DIM+F+PL
judicatividade	judicatividade+N+F+SG
judicatividades	judicatividade+N+F+PL
judicatividadezinha	judicatividade+N+DIM+F+SG
judicatividadezinhas	judicatividade+N+DIM+F+PL
judicatividadinha	judicatividade+N+DIM+F+SG
judicatividadinhas	judicatividade+N+DIM+F+PL
judicatura	judicatura+N+F+SG
judicaturas	judicatura+N+F+PL
judicaturazinha	judicatura+N+DIM+F+SG
judicaturazinhas	judicatura+N+DIM+F+PL
judicaturinha	judicatura+N+DIM+F+SG
judicaturinhas	judicatura+N+DIM+F+PL
judicialidade	judicialidade+N+F+SG
judicialidades	judicialidade+N+F+PL
judicialidadezinha	judicialidade+N+DIM+F+SG
judicialidadezinhas	judicialidade+N+DIM+F+PL
judicialidadinha	judicialidade+N+DIM+F+SG
judicialidadinhas	judicialidade+N+DIM+F+PL
judiciosidade	judiciosidade+N+F+SG
judiciosidades	judiciosidade+N+F+PL
judiciosidadezinha	judiciosidade+N+DIM+F+SG
judiciosidadezinhas	judiciosidade+N+DIM+F+PL
judiciosidadinha	judiciosidade+N+DIM+F+SG
judiciosidadinhas	judiciosidade+N+DIM+F+PL
judinho	judo+N+DIM+M+SG
judinhos	judo+N+DIM+M+PL
judo	judo+N+M+SG
judos	judo+N+M+PL
judozinho	judo+N+DIM+M+SG
judozinhos	judo+N+DIM+M+PL
judoca	judoca+N+SG
judocas	judoca+N+PL
judocazinha	judoca+N+DIM+F+SG
judocazinhas	judoca+N+DIM+F+PL
judocazinho	judoca+N+DIM+M+SG
judocazinhos	judoca+N+DIM+M+PL
judoquinha	judoca+N+DIM+SG
judoquinhas	judoca+N+DIM+PL
judozinho	judô+N+DIM+M+SG
judozinhos	judô+N+DIM+M+PL
judô	judô+N+M+SG
judôs	judô+N+M+PL
juga	juga+N+F+SG
jugas	juga+N+F+PL
jugazinha	juga+N+DIM+F+SG
jugazinhas	juga+N+DIM+F+PL
juguinha	juga+N+DIM+F+SG
juguinhas	juga+N+DIM+F+PL
jugada	jugada+N+F+SG
jugadas	jugada+N+F+PL
jugadazinha	jugada+N+DIM+F+SG
jugadazinhas	jugada+N+DIM+F+PL
jugadinha	jugada+N+DIM+F+SG
jugadinhas	jugada+N+DIM+F+PL
jugadeira	jugadeiro+N+F+SG
jugadeiras	jugadeiro+N+F+PL
jugadeirazinha	jugadeiro+N+DIM+F+SG
jugadeirazinhas	jugadeiro+N+DIM+F+PL
jugadeirinha	jugadeiro+N+DIM+F+SG
jugadeirinhas	jugadeiro+N+DIM+F+PL
jugadeirinho	jugadeiro+N+DIM+M+SG
jugadeirinhos	jugadeiro+N+DIM+M+PL
jugadeiro	jugadeiro+N+M+SG
jugadeiros	jugadeiro+N+M+PL
jugadeirozinho	jugadeiro+N+DIM+M+SG
jugadeirozinhos	jugadeiro+N+DIM+M+PL
jugador	jugador+N+M+SG
jugadores	jugador+N+M+PL
jugadorezinhos	jugador+N+DIM+M+PL
jugadorzinho	jugador+N+DIM+M+SG
jugadorzinhos	jugador+N+DIM+M+PL
jugalidade	jugalidade+N+F+SG
jugalidades	jugalidade+N+F+PL
jugalidadezinha	jugalidade+N+DIM+F+SG
jugalidadezinhas	jugalidade+N+DIM+F+PL
jugalidadinha	jugalidade+N+DIM+F+SG
jugalidadinhas	jugalidade+N+DIM+F+PL
jugaria	jugaria+N+F+SG
jugarias	jugaria+N+F+PL
jugariazinha	jugaria+N+DIM+F+SG
jugariazinhas	jugaria+N+DIM+F+PL
jugarinha	jugaria+N+DIM+F+SG
jugarinhas	jugaria+N+DIM+F+PL
juglandale	juglandale+N+F+SG
juglandales	juglandale+N+F+PL
juglandalezinha	juglandale+N+DIM+F+SG
juglandalezinhas	juglandale+N+DIM+F+PL
juglandalinha	juglandale+N+DIM+F+SG
juglandalinhas	juglandale+N+DIM+F+PL
juglandina	juglandina+N+F+SG
juglandinas	juglandina+N+F+PL
juglandinazinha	juglandina+N+DIM+F+SG
juglandinazinhas	juglandina+N+DIM+F+PL
juglandininha	juglandina+N+DIM+F+SG
juglandininhas	juglandina+N+DIM+F+PL
juglandaceazinha	juglandácea+N+DIM+F+SG
juglandaceazinhas	juglandácea+N+DIM+F+PL
juglandaceinha	juglandácea+N+DIM+F+SG
juglandaceinhas	juglandácea+N+DIM+F+PL
juglandácea	juglandácea+N+F+SG
juglandáceas	juglandácea+N+F+PL
juglandaceazinha	juglandáceo+N+DIM+F+SG
juglandaceazinhas	juglandáceo+N+DIM+F+PL
juglandaceinha	juglandáceo+N+DIM+F+SG
juglandaceinhas	juglandáceo+N+DIM+F+PL
juglandaceinho	juglandáceo+N+DIM+M+SG
juglandaceinhos	juglandáceo+N+DIM+M+PL
juglandaceozinho	juglandáceo+N+DIM+M+SG
juglandaceozinhos	juglandáceo+N+DIM+M+PL
juglandácea	juglandáceo+N+F+SG
juglandáceas	juglandáceo+N+F+PL
juglandáceo	juglandáceo+N+M+SG
juglandáceos	juglandáceo+N+M+PL
jugo	jugo+N+M+SG
jugos	jugo+N+M+PL
jugozinho	jugo+N+DIM+M+SG
jugozinhos	jugo+N+DIM+M+PL
juguinho	jugo+N+DIM+M+SG
juguinhos	jugo+N+DIM+M+PL
jugoslava	jugoslavo+N+F+SG
jugoslavas	jugoslavo+N+F+PL
jugoslavazinha	jugoslavo+N+DIM+F+SG
jugoslavazinhas	jugoslavo+N+DIM+F+PL
jugoslavinha	jugoslavo+N+DIM+F+SG
jugoslavinhas	jugoslavo+N+DIM+F+PL
jugoslavinho	jugoslavo+N+DIM+M+SG
jugoslavinhos	jugoslavo+N+DIM+M+PL
jugoslavo	jugoslavo+N+M+SG
jugoslavos	jugoslavo+N+M+PL
jugoslavozinho	jugoslavo+N+DIM+M+SG
jugoslavozinhos	jugoslavo+N+DIM+M+PL
jugueira	jugueira+N+F+SG
jugueiras	jugueira+N+F+PL
jugueirazinha	jugueira+N+DIM+F+SG
jugueirazinhas	jugueira+N+DIM+F+PL
jugueirinha	jugueira+N+DIM+F+SG
jugueirinhas	jugueira+N+DIM+F+PL
jugueira	jugueiro+N+F+SG
jugueiras	jugueiro+N+F+PL
jugueirazinha	jugueiro+N+DIM+F+SG
jugueirazinhas	jugueiro+N+DIM+F+PL
jugueirinha	jugueiro+N+DIM+F+SG
jugueirinhas	jugueiro+N+DIM+F+PL
jugueirinho	jugueiro+N+DIM+M+SG
jugueirinhos	jugueiro+N+DIM+M+PL
jugueiro	jugueiro+N+M+SG
jugueiros	jugueiro+N+M+PL
jugueirozinho	jugueiro+N+DIM+M+SG
jugueirozinhos	jugueiro+N+DIM+M+PL
jugular	jugular+N+SG
jugulares	jugular+N+PL
jugularezinhas	jugular+N+DIM+F+PL
jugularezinhos	jugular+N+DIM+M+PL
jugularzinha	jugular+N+DIM+F+SG
jugularzinhas	jugular+N+DIM+F+PL
jugularzinho	jugular+N+DIM+M+SG
jugularzinhos	jugular+N+DIM+M+PL
jugularidade	jugularidade+N+F+SG
jugularidades	jugularidade+N+F+PL
jugularidadezinha	jugularidade+N+DIM+F+SG
jugularidadezinhas	jugularidade+N+DIM+F+PL
jugularidadinha	jugularidade+N+DIM+F+SG
jugularidadinhas	jugularidade+N+DIM+F+PL
jugulação	jugulação+N+F+SG
jugulaçãozinha	jugulação+N+DIM+F+SG
jugulações	jugulação+N+F+PL
jugulaçõezinhas	jugulação+N+DIM+F+PL
juguleira	juguleira+N+F+SG
juguleiras	juguleira+N+F+PL
juguleirazinha	juguleira+N+DIM+F+SG
juguleirazinhas	juguleira+N+DIM+F+PL
juguleirinha	juguleira+N+DIM+F+SG
juguleirinhas	juguleira+N+DIM+F+PL
juiz	juiz+N+M+SG
juiza	juiz+N+F+SG
juizazinha	juiz+N+DIM+F+SG
juizazinhas	juiz+N+DIM+F+PL
juizezinhos	juiz+N+DIM+M+PL
juizinha	juiz+N+DIM+F+SG
juizinhas	juiz+N+DIM+F+PL
juizinho	juiz+N+DIM+M+SG
juizinhos	juiz+N+DIM+M+PL
juíza	juiz+N+F+SG
juízas	juiz+N+F+PL
juízes	juiz+N+M+PL
juiz-conselheirinho	juiz-conselheiro+N+DIM+M+SG
juiz-conselheirinhos	juiz-conselheiro+N+DIM+M+PL
juiz-conselheiro	juiz-conselheiro+N+M+SG
juiz-conselheirozinho	juiz-conselheiro+N+DIM+M+SG
juiza-conselheira	juiz-conselheiro+N+F+SG
juiza-conselheirazinha	juiz-conselheiro+N+DIM+F+SG
juiza-conselheirinha	juiz-conselheiro+N+DIM+F+SG
juiza-conselheirinhas	juiz-conselheiro+N+DIM+F+PL
juizas-conselheiras	juiz-conselheiro+N+F+PL
juizas-conselheirazinhas	juiz-conselheiro+N+DIM+F+PL
juizes-conselheiros	juiz-conselheiro+N+M+PL
juizes-conselheirozinhos	juiz-conselheiro+N+DIM+M+PL
juiz-de-linha	juiz-de-linha+N+M+SG
juiz-de-linhazinho	juiz-de-linha+N+DIM+M+SG
juiz-de-linhinha	juiz-de-linha+N+DIM+M+SG
juiz-de-linhinhas	juiz-de-linha+N+DIM+M+PL
juiza-de-linha	juiz-de-linha+N+F+SG
juiza-de-linhazinha	juiz-de-linha+N+DIM+F+SG
juiza-de-linhinha	juiz-de-linha+N+DIM+F+SG
juiza-de-linhinhas	juiz-de-linha+N+DIM+F+PL
juizas-de-linha	juiz-de-linha+N+F+PL
juizas-de-linhazinhas	juiz-de-linha+N+DIM+F+PL
juizes-de-linha	juiz-de-linha+N+M+PL
juizes-de-linhazinhos	juiz-de-linha+N+DIM+M+PL
juiz-desembargador	juiz-desembargador+N+M+SG
juiz-desembargadorzinho	juiz-desembargador+N+DIM+M+SG
juiza-desembargadora	juiz-desembargador+N+F+SG
juiza-desembargadorazinha	juiz-desembargador+N+DIM+F+SG
juiza-desembargadorinha	juiz-desembargador+N+DIM+F+SG
juiza-desembargadorinhas	juiz-desembargador+N+DIM+F+PL
juizas-desembargadoras	juiz-desembargador+N+F+PL
juizas-desembargadorazinhas	juiz-desembargador+N+DIM+F+PL
juizes-desembargadores	juiz-desembargador+N+M+PL
juizes-desembargadorezinhos	juiz-desembargador+N+DIM+M+PL
juizes-desembargadorzinhos	juiz-desembargador+N+DIM+M+PL
juiz-presidente	juiz-presidente+N+M+SG
juiz-presidentezinho	juiz-presidente+N+DIM+M+SG
juiz-presidentinho	juiz-presidente+N+DIM+M+SG
juiz-presidentinhos	juiz-presidente+N+DIM+M+PL
juiza-presidenta	juiz-presidente+N+F+SG
juiza-presidentazinha	juiz-presidente+N+DIM+F+SG
juiza-presidente	juiz-presidente+N+F+SG
juiza-presidentezinha	juiz-presidente+N+DIM+F+SG
juiza-presidentinha	juiz-presidente+N+DIM+F+SG
juiza-presidentinhas	juiz-presidente+N+DIM+F+PL
juizas-presidentas	juiz-presidente+N+F+PL
juizas-presidentazinhas	juiz-presidente+N+DIM+F+PL
juizes-presidentes	juiz-presidente+N+M+PL
juizes-presidentezinhos	juiz-presidente+N+DIM+M+PL
juiz-secretarinho	juiz-secretário+N+DIM+M+SG
juiz-secretarinhos	juiz-secretário+N+DIM+M+PL
juiz-secretariozinho	juiz-secretário+N+DIM+M+SG
juiz-secretário	juiz-secretário+N+M+SG
juiza-secretariazinha	juiz-secretário+N+DIM+F+SG
juiza-secretarinha	juiz-secretário+N+DIM+F+SG
juiza-secretarinhas	juiz-secretário+N+DIM+F+PL
juiza-secretária	juiz-secretário+N+F+SG
juizas-secretariazinhas	juiz-secretário+N+DIM+F+PL
juizas-secretárias	juiz-secretário+N+F+PL
juizes-secretariozinhos	juiz-secretário+N+DIM+M+PL
juizes-secretários	juiz-secretário+N+M+PL
juiz-arbitrinho	juiz-árbitro+N+DIM+M+SG
juiz-arbitrinhos	juiz-árbitro+N+DIM+M+PL
juiz-arbitrozinho	juiz-árbitro+N+DIM+M+SG
juiz-árbitro	juiz-árbitro+N+M+SG
juiza-arbitrinho	juiz-árbitro+N+DIM+F+SG
juiza-arbitrinhos	juiz-árbitro+N+DIM+F+PL
juiza-arbitrozinha	juiz-árbitro+N+DIM+F+SG
juiza-árbitro	juiz-árbitro+N+F+SG
juizas-arbitrozinhas	juiz-árbitro+N+DIM+F+PL
juizas-árbitro	juiz-árbitro+N+F+PL
juizes-arbitrozinhos	juiz-árbitro+N+DIM+M+PL
juizes-árbitro	juiz-árbitro+N+M+PL
juizadinho	juizado+N+DIM+M+SG
juizadinhos	juizado+N+DIM+M+PL
juizado	juizado+N+M+SG
juizados	juizado+N+M+PL
juizadozinho	juizado+N+DIM+M+SG
juizadozinhos	juizado+N+DIM+M+PL
jujuba	jujuba+N+F+SG
jujubas	jujuba+N+F+PL
jujubazinha	jujuba+N+DIM+F+SG
jujubazinhas	jujuba+N+DIM+F+PL
jujubinha	jujuba+N+DIM+F+SG
jujubinhas	jujuba+N+DIM+F+PL
jujubeira	jujubeira+N+F+SG
jujubeiras	jujubeira+N+F+PL
jujubeirazinha	jujubeira+N+DIM+F+SG
jujubeirazinhas	jujubeira+N+DIM+F+PL
jujubeirinha	jujubeira+N+DIM+F+SG
jujubeirinhas	jujubeira+N+DIM+F+PL
juke-box	juke-box+N+F+SG
juke-boxzinha	juke-box+N+DIM+F+SG
julaventinho	julavento+N+DIM+M+SG
julaventinhos	julavento+N+DIM+M+PL
julavento	julavento+N+M+SG
julaventos	julavento+N+M+PL
julaventozinho	julavento+N+DIM+M+SG
julaventozinhos	julavento+N+DIM+M+PL
julgabilidade	julgabilidade+N+F+SG
julgabilidades	julgabilidade+N+F+PL
julgabilidadezinha	julgabilidade+N+DIM+F+SG
julgabilidadezinhas	julgabilidade+N+DIM+F+PL
julgabilidadinha	julgabilidade+N+DIM+F+SG
julgabilidadinhas	julgabilidade+N+DIM+F+PL
julgada	julgado+N+F+SG
julgadas	julgado+N+F+PL
julgadazinha	julgado+N+DIM+F+SG
julgadazinhas	julgado+N+DIM+F+PL
julgadinha	julgado+N+DIM+F+SG
julgadinhas	julgado+N+DIM+F+PL
julgadinho	julgado+N+DIM+M+SG
julgadinhos	julgado+N+DIM+M+PL
julgado	julgado+N+M+SG
julgados	julgado+N+M+PL
julgadozinho	julgado+N+DIM+M+SG
julgadozinhos	julgado+N+DIM+M+PL
julgador	julgador+N+M+SG
julgadora	julgador+N+F+SG
julgadoras	julgador+N+F+PL
julgadorazinha	julgador+N+DIM+F+SG
julgadorazinhas	julgador+N+DIM+F+PL
julgadores	julgador+N+M+PL
julgadorezinhos	julgador+N+DIM+M+PL
julgadorinha	julgador+N+DIM+F+SG
julgadorinhas	julgador+N+DIM+F+PL
julgadorzinho	julgador+N+DIM+M+SG
julgadorzinhos	julgador+N+DIM+M+PL
julgamentinho	julgamento+N+DIM+M+SG
julgamentinhos	julgamento+N+DIM+M+PL
julgamento	julgamento+N+M+SG
julgamentos	julgamento+N+M+PL
julgamentozinho	julgamento+N+DIM+M+SG
julgamentozinhos	julgamento+N+DIM+M+PL
Julhinho	julho+N+DIM+M+SG
Julhinhos	julho+N+DIM+M+PL
Julho	julho+N+M+SG
Julhos	julho+N+M+PL
Julhozinho	julho+N+DIM+M+SG
Julhozinhos	julho+N+DIM+M+PL
julhinho	julho+N+DIM+M+SG
julhinhos	julho+N+DIM+M+PL
julho	julho+N+M+SG
julhos	julho+N+M+PL
julhozinho	julho+N+DIM+M+SG
julhozinhos	julho+N+DIM+M+PL
juliana	juliana+N+F+SG
julianas	juliana+N+F+PL
julianazinha	juliana+N+DIM+F+SG
julianazinhas	juliana+N+DIM+F+PL
julianinha	juliana+N+DIM+F+SG
julianinhas	juliana+N+DIM+F+PL
julianale	julianale+N+F+SG
julianales	julianale+N+F+PL
julianalezinha	julianale+N+DIM+F+SG
julianalezinhas	julianale+N+DIM+F+PL
julianalinha	julianale+N+DIM+F+SG
julianalinhas	julianale+N+DIM+F+PL
jumbeba	jumbeba+N+F+SG
jumbebas	jumbeba+N+F+PL
jumbebazinha	jumbeba+N+DIM+F+SG
jumbebazinhas	jumbeba+N+DIM+F+PL
jumbebinha	jumbeba+N+DIM+F+SG
jumbebinhas	jumbeba+N+DIM+F+PL
jumbinho	jumbo+N+DIM+M+SG
jumbinhos	jumbo+N+DIM+M+PL
jumbo	jumbo+N+M+SG
jumbos	jumbo+N+M+PL
jumbozinho	jumbo+N+DIM+M+SG
jumbozinhos	jumbo+N+DIM+M+PL
jumentada	jumentada+N+F+SG
jumentadas	jumentada+N+F+PL
jumentadazinha	jumentada+N+DIM+F+SG
jumentadazinhas	jumentada+N+DIM+F+PL
jumentadinha	jumentada+N+DIM+F+SG
jumentadinhas	jumentada+N+DIM+F+PL
jumentalidade	jumentalidade+N+F+SG
jumentalidades	jumentalidade+N+F+PL
jumentalidadezinha	jumentalidade+N+DIM+F+SG
jumentalidadezinhas	jumentalidade+N+DIM+F+PL
jumentalidadinha	jumentalidade+N+DIM+F+SG
jumentalidadinhas	jumentalidade+N+DIM+F+PL
jumentica	jumentico+N+F+SG
jumenticas	jumentico+N+F+PL
jumenticazinha	jumentico+N+DIM+F+SG
jumenticazinhas	jumentico+N+DIM+F+PL
jumentico	jumentico+N+M+SG
jumenticos	jumentico+N+M+PL
jumenticozinho	jumentico+N+DIM+M+SG
jumenticozinhos	jumentico+N+DIM+M+PL
jumentiquinha	jumentico+N+DIM+F+SG
jumentiquinhas	jumentico+N+DIM+F+PL
jumentiquinho	jumentico+N+DIM+M+SG
jumentiquinhos	jumentico+N+DIM+M+PL
jumenta	jumento+N+F+SG
jumentas	jumento+N+F+PL
jumentazinha	jumento+N+DIM+F+SG
jumentazinhas	jumento+N+DIM+F+PL
jumentinha	jumento+N+DIM+F+SG
jumentinhas	jumento+N+DIM+F+PL
jumentinho	jumento+N+DIM+M+SG
jumentinhos	jumento+N+DIM+M+PL
jumento	jumento+N+M+SG
jumentos	jumento+N+M+PL
jumentozinho	jumento+N+DIM+M+SG
jumentozinhos	jumento+N+DIM+M+PL
juncaginaceazinha	juncaginácea+N+DIM+F+SG
juncaginaceazinhas	juncaginácea+N+DIM+F+PL
juncaginaceinha	juncaginácea+N+DIM+F+SG
juncaginaceinhas	juncaginácea+N+DIM+F+PL
juncaginácea	juncaginácea+N+F+SG
juncagináceas	juncaginácea+N+F+PL
juncais	juncal+N+M+PL
juncaizinhos	juncal+N+DIM+M+PL
juncal	juncal+N+M+SG
juncalzinho	juncal+N+DIM+M+SG
junceira	junceira+N+F+SG
junceiras	junceira+N+F+PL
junceirazinha	junceira+N+DIM+F+SG
junceirazinhas	junceira+N+DIM+F+PL
junceirinha	junceira+N+DIM+F+SG
junceirinhas	junceira+N+DIM+F+PL
juncinha	juncinha+N+F+SG
juncinhas	juncinha+N+F+PL
juncinhazinha	juncinha+N+DIM+F+SG
juncinhazinhas	juncinha+N+DIM+F+PL
juncinhinha	juncinha+N+DIM+F+SG
juncinhinhas	juncinha+N+DIM+F+PL
junco	junco+N+M+SG
juncos	junco+N+M+PL
juncozinho	junco+N+DIM+M+SG
juncozinhos	junco+N+DIM+M+PL
junquinho	junco+N+DIM+M+SG
junquinhos	junco+N+DIM+M+PL
juncosidade	juncosidade+N+F+SG
juncosidades	juncosidade+N+F+PL
juncosidadezinha	juncosidade+N+DIM+F+SG
juncosidadezinhas	juncosidade+N+DIM+F+PL
juncosidadinha	juncosidade+N+DIM+F+SG
juncosidadinhas	juncosidade+N+DIM+F+PL
juncaceazinha	juncácea+N+DIM+F+SG
juncaceazinhas	juncácea+N+DIM+F+PL
juncaceinha	juncácea+N+DIM+F+SG
juncaceinhas	juncácea+N+DIM+F+PL
juncácea	juncácea+N+F+SG
juncáceas	juncácea+N+F+PL
jundiazinho	jundiá+N+DIM+M+SG
jundiazinhos	jundiá+N+DIM+M+PL
jundiá	jundiá+N+M+SG
jundiás	jundiá+N+M+PL
jungermanniale	jungermanniale+N+F+SG
jungermanniales	jungermanniale+N+F+PL
jungermannialezinha	jungermanniale+N+DIM+F+SG
jungermannialezinhas	jungermanniale+N+DIM+F+PL
jungermannialinha	jungermanniale+N+DIM+F+SG
jungermannialinhas	jungermanniale+N+DIM+F+PL
jungo	jungo+N+M+SG
jungos	jungo+N+M+PL
jungozinho	jungo+N+DIM+M+SG
jungozinhos	jungo+N+DIM+M+PL
junguinho	jungo+N+DIM+M+SG
junguinhos	jungo+N+DIM+M+PL
Junhinho	junho+N+DIM+M+SG
Junhinhos	junho+N+DIM+M+PL
Junho	junho+N+M+SG
Junhos	junho+N+M+PL
Junhozinho	junho+N+DIM+M+SG
Junhozinhos	junho+N+DIM+M+PL
junhinho	junho+N+DIM+M+SG
junhinhos	junho+N+DIM+M+PL
junho	junho+N+M+SG
junhos	junho+N+M+PL
junhozinho	junho+N+DIM+M+SG
junhozinhos	junho+N+DIM+M+PL
junior	junior+N+SG
juniores	junior+N+PL
juniorezinhas	junior+N+DIM+F+PL
juniorezinhos	junior+N+DIM+M+PL
juniorzinha	junior+N+DIM+F+SG
juniorzinhas	junior+N+DIM+F+PL
juniorzinho	junior+N+DIM+M+SG
juniorzinhos	junior+N+DIM+M+PL
juniperaceazinha	juniperácea+N+DIM+F+SG
juniperaceazinhas	juniperácea+N+DIM+F+PL
juniperaceinha	juniperácea+N+DIM+F+SG
juniperaceinhas	juniperácea+N+DIM+F+PL
juniperácea	juniperácea+N+F+SG
juniperáceas	juniperácea+N+F+PL
junqueira	junqueira+N+F+SG
junqueiras	junqueira+N+F+PL
junqueirazinha	junqueira+N+DIM+F+SG
junqueirazinhas	junqueira+N+DIM+F+PL
junqueirinha	junqueira+N+DIM+F+SG
junqueirinhas	junqueira+N+DIM+F+PL
junquilhinho	junquilho+N+DIM+M+SG
junquilhinhos	junquilho+N+DIM+M+PL
junquilho	junquilho+N+M+SG
junquilhos	junquilho+N+M+PL
junquilhozinho	junquilho+N+DIM+M+SG
junquilhozinhos	junquilho+N+DIM+M+PL
junta	junta+N+F+SG
juntas	junta+N+F+PL
juntazinha	junta+N+DIM+F+SG
juntazinhas	junta+N+DIM+F+PL
juntinha	junta+N+DIM+F+SG
juntinhas	junta+N+DIM+F+PL
juntabilidade	juntabilidade+N+F+SG
juntabilidades	juntabilidade+N+F+PL
juntabilidadezinha	juntabilidade+N+DIM+F+SG
juntabilidadezinhas	juntabilidade+N+DIM+F+PL
juntabilidadinha	juntabilidade+N+DIM+F+SG
juntabilidadinhas	juntabilidade+N+DIM+F+PL
juntada	juntada+N+F+SG
juntadas	juntada+N+F+PL
juntadazinha	juntada+N+DIM+F+SG
juntadazinhas	juntada+N+DIM+F+PL
juntadinha	juntada+N+DIM+F+SG
juntadinhas	juntada+N+DIM+F+PL
junteira	junteira+N+F+SG
junteiras	junteira+N+F+PL
junteirazinha	junteira+N+DIM+F+SG
junteirazinhas	junteira+N+DIM+F+PL
junteirinha	junteira+N+DIM+F+SG
junteirinhas	junteira+N+DIM+F+PL
juntoira	juntoira+N+F+SG
juntoiras	juntoira+N+F+PL
juntoirazinha	juntoira+N+DIM+F+SG
juntoirazinhas	juntoira+N+DIM+F+PL
juntoirinha	juntoira+N+DIM+F+SG
juntoirinhas	juntoira+N+DIM+F+PL
juntoura	juntoura+N+F+SG
juntouras	juntoura+N+F+PL
juntourazinha	juntoura+N+DIM+F+SG
juntourazinhas	juntoura+N+DIM+F+PL
juntourinha	juntoura+N+DIM+F+SG
juntourinhas	juntoura+N+DIM+F+PL
juntura	juntura+N+F+SG
junturas	juntura+N+F+PL
junturazinha	juntura+N+DIM+F+SG
junturazinhas	juntura+N+DIM+F+PL
junturinha	juntura+N+DIM+F+SG
junturinhas	juntura+N+DIM+F+PL
junçosidade	junçosidade+N+F+SG
junçosidades	junçosidade+N+F+PL
junçosidadezinha	junçosidade+N+DIM+F+SG
junçosidadezinhas	junçosidade+N+DIM+F+PL
junçosidadinha	junçosidade+N+DIM+F+SG
junçosidadinhas	junçosidade+N+DIM+F+PL
junção	junção+N+F+SG
junçãozinha	junção+N+DIM+F+SG
junções	junção+N+F+PL
junçõezinhas	junção+N+DIM+F+PL
juniperazinha	junípero+N+DIM+F+SG
juniperazinhas	junípero+N+DIM+F+PL
juniperinha	junípero+N+DIM+F+SG
juniperinhas	junípero+N+DIM+F+PL
juniperinho	junípero+N+DIM+M+SG
juniperinhos	junípero+N+DIM+M+PL
juniperozinho	junípero+N+DIM+M+SG
juniperozinhos	junípero+N+DIM+M+PL
junípera	junípero+N+F+SG
juníperas	junípero+N+F+PL
junípero	junípero+N+M+SG
juníperos	junípero+N+M+PL
jupiede	jupiede+N+M+SG
jupiedes	jupiede+N+M+PL
jupiedezinho	jupiede+N+DIM+M+SG
jupiedezinhos	jupiede+N+DIM+M+PL
jupiedinho	jupiede+N+DIM+M+SG
jupiedinhos	jupiede+N+DIM+M+PL
juquirionaninho	juquirionano+N+DIM+M+SG
juquirionaninhos	juquirionano+N+DIM+M+PL
juquirionano	juquirionano+N+M+SG
juquirionanos	juquirionano+N+M+PL
juquirionanozinho	juquirionano+N+DIM+M+SG
juquirionanozinhos	juquirionano+N+DIM+M+PL
juquiazinho	juquiá+N+DIM+M+SG
juquiazinhos	juquiá+N+DIM+M+PL
juquiá	juquiá+N+M+SG
juquiás	juquiá+N+M+PL
jura	jura+N+F+SG
juras	jura+N+F+PL
jurazinha	jura+N+DIM+F+SG
jurazinhas	jura+N+DIM+F+PL
jurinha	jura+N+DIM+F+SG
jurinhas	jura+N+DIM+F+PL
jurada	jurado+N+F+SG
juradas	jurado+N+F+PL
juradazinha	jurado+N+DIM+F+SG
juradazinhas	jurado+N+DIM+F+PL
juradinha	jurado+N+DIM+F+SG
juradinhas	jurado+N+DIM+F+PL
juradinho	jurado+N+DIM+M+SG
juradinhos	jurado+N+DIM+M+PL
jurado	jurado+N+M+SG
jurados	jurado+N+M+PL
juradozinho	jurado+N+DIM+M+SG
juradozinhos	jurado+N+DIM+M+PL
jurador	jurador+N+M+SG
juradora	jurador+N+F+SG
juradoras	jurador+N+F+PL
juradorazinha	jurador+N+DIM+F+SG
juradorazinhas	jurador+N+DIM+F+PL
juradores	jurador+N+M+PL
juradorezinhos	jurador+N+DIM+M+PL
juradorinha	jurador+N+DIM+F+SG
juradorinhas	jurador+N+DIM+F+PL
juradorzinho	jurador+N+DIM+M+SG
juradorzinhos	jurador+N+DIM+M+PL
juraica	juraico+N+F+SG
juraicas	juraico+N+F+PL
juraicazinha	juraico+N+DIM+F+SG
juraicazinhas	juraico+N+DIM+F+PL
juraico	juraico+N+M+SG
juraicos	juraico+N+M+PL
juraicozinho	juraico+N+DIM+M+SG
juraicozinhos	juraico+N+DIM+M+PL
juraiquinha	juraico+N+DIM+F+SG
juraiquinhas	juraico+N+DIM+F+PL
juraiquinho	juraico+N+DIM+M+SG
juraiquinhos	juraico+N+DIM+M+PL
juramentinho	juramento+N+DIM+M+SG
juramentinhos	juramento+N+DIM+M+PL
juramento	juramento+N+M+SG
juramentos	juramento+N+M+PL
juramentozinho	juramento+N+DIM+M+SG
juramentozinhos	juramento+N+DIM+M+PL
jurassicidade	jurassicidade+N+F+SG
jurassicidades	jurassicidade+N+F+PL
jurassicidadezinha	jurassicidade+N+DIM+F+SG
jurassicidadezinhas	jurassicidade+N+DIM+F+PL
jurassicidadinha	jurassicidade+N+DIM+F+SG
jurassicidadinhas	jurassicidade+N+DIM+F+PL
jurema	jurema+N+SG
juremas	jurema+N+PL
juremazinha	jurema+N+DIM+F+SG
juremazinhas	jurema+N+DIM+F+PL
juremazinho	jurema+N+DIM+M+SG
juremazinhos	jurema+N+DIM+M+PL
jureminha	jurema+N+DIM+SG
jureminhas	jurema+N+DIM+PL
jurepeba	jurepeba+N+F+SG
jurepebas	jurepeba+N+F+PL
jurepebazinha	jurepeba+N+DIM+F+SG
jurepebazinhas	jurepeba+N+DIM+F+PL
jurepebinha	jurepeba+N+DIM+F+SG
jurepebinhas	jurepeba+N+DIM+F+PL
juridicidade	juridicidade+N+F+SG
juridicidades	juridicidade+N+F+PL
juridicidadezinha	juridicidade+N+DIM+F+SG
juridicidadezinhas	juridicidade+N+DIM+F+PL
juridicidadinha	juridicidade+N+DIM+F+SG
juridicidadinhas	juridicidade+N+DIM+F+PL
jurisconsulente	jurisconsulente+N+SG
jurisconsulentes	jurisconsulente+N+PL
jurisconsulentezinha	jurisconsulente+N+DIM+F+SG
jurisconsulentezinhas	jurisconsulente+N+DIM+F+PL
jurisconsulentezinho	jurisconsulente+N+DIM+M+SG
jurisconsulentezinhos	jurisconsulente+N+DIM+M+PL
jurisconsulentinha	jurisconsulente+N+DIM+F+SG
jurisconsulentinhas	jurisconsulente+N+DIM+F+PL
jurisconsulentinho	jurisconsulente+N+DIM+M+SG
jurisconsulentinhos	jurisconsulente+N+DIM+M+PL
jurisconsulta	jurisconsulto+N+F+SG
jurisconsultas	jurisconsulto+N+F+PL
jurisconsultazinha	jurisconsulto+N+DIM+F+SG
jurisconsultazinhas	jurisconsulto+N+DIM+F+PL
jurisconsultinha	jurisconsulto+N+DIM+F+SG
jurisconsultinhas	jurisconsulto+N+DIM+F+PL
jurisconsultinho	jurisconsulto+N+DIM+M+SG
jurisconsultinhos	jurisconsulto+N+DIM+M+PL
jurisconsulto	jurisconsulto+N+M+SG
jurisconsultos	jurisconsulto+N+M+PL
jurisconsultozinho	jurisconsulto+N+DIM+M+SG
jurisconsultozinhos	jurisconsulto+N+DIM+M+PL
jurisdicionalidade	jurisdicionalidade+N+F+SG
jurisdicionalidades	jurisdicionalidade+N+F+PL
jurisdicionalidadezinha	jurisdicionalidade+N+DIM+F+SG
jurisdicionalidadezinhas	jurisdicionalidade+N+DIM+F+PL
jurisdicionalidadinha	jurisdicionalidade+N+DIM+F+SG
jurisdicionalidadinhas	jurisdicionalidade+N+DIM+F+PL
jurisdicionalização	jurisdicionalização+N+F+SG
jurisdicionalizaçãozinha	jurisdicionalização+N+DIM+F+SG
jurisdicionalizações	jurisdicionalização+N+F+PL
jurisdicionalizaçõezinhas	jurisdicionalização+N+DIM+F+PL
jurisdição	jurisdição+N+F+SG
jurisdiçãozinha	jurisdição+N+DIM+F+SG
jurisdições	jurisdição+N+F+PL
jurisdiçõezinhas	jurisdição+N+DIM+F+PL
jurisperita	jurisperito+N+F+SG
jurisperitas	jurisperito+N+F+PL
jurisperitazinha	jurisperito+N+DIM+F+SG
jurisperitazinhas	jurisperito+N+DIM+F+PL
jurisperitinha	jurisperito+N+DIM+F+SG
jurisperitinhas	jurisperito+N+DIM+F+PL
jurisperitinho	jurisperito+N+DIM+M+SG
jurisperitinhos	jurisperito+N+DIM+M+PL
jurisperito	jurisperito+N+M+SG
jurisperitos	jurisperito+N+M+PL
jurisperitozinho	jurisperito+N+DIM+M+SG
jurisperitozinhos	jurisperito+N+DIM+M+PL
jurispericiazinha	jurisperícia+N+DIM+F+SG
jurispericiazinhas	jurisperícia+N+DIM+F+PL
jurispericinha	jurisperícia+N+DIM+F+SG
jurispericinhas	jurisperícia+N+DIM+F+PL
jurisperícia	jurisperícia+N+F+SG
jurisperícias	jurisperícia+N+F+PL
jurisprudencialidade	jurisprudencialidade+N+F+SG
jurisprudencialidades	jurisprudencialidade+N+F+PL
jurisprudencialidadezinha	jurisprudencialidade+N+DIM+F+SG
jurisprudencialidadezinhas	jurisprudencialidade+N+DIM+F+PL
jurisprudencialidadinha	jurisprudencialidade+N+DIM+F+SG
jurisprudencialidadinhas	jurisprudencialidade+N+DIM+F+PL
jurisprudente	jurisprudente+N+SG
jurisprudentes	jurisprudente+N+PL
jurisprudentezinha	jurisprudente+N+DIM+F+SG
jurisprudentezinhas	jurisprudente+N+DIM+F+PL
jurisprudentezinho	jurisprudente+N+DIM+M+SG
jurisprudentezinhos	jurisprudente+N+DIM+M+PL
jurisprudentinha	jurisprudente+N+DIM+F+SG
jurisprudentinhas	jurisprudente+N+DIM+F+PL
jurisprudentinho	jurisprudente+N+DIM+M+SG
jurisprudentinhos	jurisprudente+N+DIM+M+PL
jurisprudenciazinha	jurisprudência+N+DIM+F+SG
jurisprudenciazinhas	jurisprudência+N+DIM+F+PL
jurisprudencinha	jurisprudência+N+DIM+F+SG
jurisprudencinhas	jurisprudência+N+DIM+F+PL
jurisprudência	jurisprudência+N+F+SG
jurisprudências	jurisprudência+N+F+PL
jurista	jurista+N+SG
juristas	jurista+N+PL
juristazinha	jurista+N+DIM+F+SG
juristazinhas	jurista+N+DIM+F+PL
juristazinho	jurista+N+DIM+M+SG
juristazinhos	jurista+N+DIM+M+PL
juristinha	jurista+N+DIM+SG
juristinhas	jurista+N+DIM+PL
juriti	juriti+N+SG
juritis	juriti+N+PL
juritizinha	juriti+N+DIM+F+SG
juritizinhas	juriti+N+DIM+F+PL
juritizinho	juriti+N+DIM+M+SG
juritizinhos	juriti+N+DIM+M+PL
juritipiranga	juritipiranga+N+F+SG
juritipirangas	juritipiranga+N+F+PL
juritipirangazinha	juritipiranga+N+DIM+F+SG
juritipirangazinhas	juritipiranga+N+DIM+F+PL
juritipiranguinha	juritipiranga+N+DIM+F+SG
juritipiranguinhas	juritipiranga+N+DIM+F+PL
jurinho	juro+N+DIM+M+SG
jurinhos	juro+N+DIM+M+PL
juro	juro+N+M+SG
juros	juro+N+M+PL
jurozinho	juro+N+DIM+M+SG
jurozinhos	juro+N+DIM+M+PL
juru	juru+N+M+SG
jurus	juru+N+M+PL
juruzinho	juru+N+DIM+M+SG
juruzinhos	juru+N+DIM+M+PL
jurubeba	jurubeba+N+F+SG
jurubebas	jurubeba+N+F+PL
jurubebazinha	jurubeba+N+DIM+F+SG
jurubebazinhas	jurubeba+N+DIM+F+PL
jurubebinha	jurubeba+N+DIM+F+SG
jurubebinhas	jurubeba+N+DIM+F+PL
jurubebais	jurubebal+N+M+PL
jurubebaizinhos	jurubebal+N+DIM+M+PL
jurubebal	jurubebal+N+M+SG
jurubebalzinho	jurubebal+N+DIM+M+SG
jurueba	jurueba+N+F+SG
juruebas	jurueba+N+F+PL
juruebazinha	jurueba+N+DIM+F+SG
juruebazinhas	jurueba+N+DIM+F+PL
juruebinha	jurueba+N+DIM+F+SG
juruebinhas	jurueba+N+DIM+F+PL
jurujuba	jurujuba+N+F+SG
jurujubas	jurujuba+N+F+PL
jurujubazinha	jurujuba+N+DIM+F+SG
jurujubazinhas	jurujuba+N+DIM+F+PL
jurujubinha	jurujuba+N+DIM+F+SG
jurujubinhas	jurujuba+N+DIM+F+PL
jurupari	jurupari+N+M+SG
juruparis	jurupari+N+M+PL
juruparizinho	jurupari+N+DIM+M+SG
juruparizinhos	jurupari+N+DIM+M+PL
jurupariboia	jurupariboia+N+F+SG
jurupariboias	jurupariboia+N+F+PL
jurupariboiazinha	jurupariboia+N+DIM+F+SG
jurupariboiazinhas	jurupariboia+N+DIM+F+PL
jurupariboinha	jurupariboia+N+DIM+F+SG
jurupariboinhas	jurupariboia+N+DIM+F+PL
jurupixuna	jurupixuna+N+M+SG
jurupixunas	jurupixuna+N+M+PL
jurupixunazinho	jurupixuna+N+DIM+M+SG
jurupixunazinhos	jurupixuna+N+DIM+M+PL
jurupixuninha	jurupixuna+N+DIM+M+SG
jurupixuninhas	jurupixuna+N+DIM+M+PL
jurupoca	jurupoca+N+F+SG
jurupocas	jurupoca+N+F+PL
jurupocazinha	jurupoca+N+DIM+F+SG
jurupocazinhas	jurupoca+N+DIM+F+PL
jurupoquinha	jurupoca+N+DIM+F+SG
jurupoquinhas	jurupoca+N+DIM+F+PL
juruti	juruti+N+F+SG
jurutis	juruti+N+F+PL
jurutizinha	juruti+N+DIM+F+SG
jurutizinhas	juruti+N+DIM+F+PL
juruva	juruva+N+F+SG
juruvas	juruva+N+F+PL
juruvazinha	juruva+N+DIM+F+SG
juruvazinhas	juruva+N+DIM+F+PL
juruvinha	juruva+N+DIM+F+SG
juruvinhas	juruva+N+DIM+F+PL
jurassicazinha	jurássico+N+DIM+F+SG
jurassicazinhas	jurássico+N+DIM+F+PL
jurassicozinho	jurássico+N+DIM+M+SG
jurassicozinhos	jurássico+N+DIM+M+PL
jurassiquinha	jurássico+N+DIM+F+SG
jurassiquinhas	jurássico+N+DIM+F+PL
jurassiquinho	jurássico+N+DIM+M+SG
jurassiquinhos	jurássico+N+DIM+M+PL
jurássica	jurássico+N+F+SG
jurássicas	jurássico+N+F+PL
jurássico	jurássico+N+M+SG
jurássicos	jurássico+N+M+PL
jus	jus+N+M+SG
juses	jus+N+M+PL
jusezinhos	jus+N+DIM+M+PL
jusinho	jus+N+DIM+M+SG
jusinhos	jus+N+DIM+M+PL
jusante	jusante+N+F+SG
jusantes	jusante+N+F+PL
jusantezinha	jusante+N+DIM+F+SG
jusantezinhas	jusante+N+DIM+F+PL
jusantinha	jusante+N+DIM+F+SG
jusantinhas	jusante+N+DIM+F+PL
jussividade	jussividade+N+F+SG
jussividades	jussividade+N+F+PL
jussividadezinha	jussividade+N+DIM+F+SG
jussividadezinhas	jussividade+N+DIM+F+PL
jussividadinha	jussividade+N+DIM+F+SG
jussividadinhas	jussividade+N+DIM+F+PL
justa	justa+N+F+SG
justas	justa+N+F+PL
justazinha	justa+N+DIM+F+SG
justazinhas	justa+N+DIM+F+PL
justinha	justa+N+DIM+F+SG
justinhas	justa+N+DIM+F+PL
justabilidade	justabilidade+N+F+SG
justabilidades	justabilidade+N+F+PL
justabilidadezinha	justabilidade+N+DIM+F+SG
justabilidadezinhas	justabilidade+N+DIM+F+PL
justabilidadinha	justabilidade+N+DIM+F+SG
justabilidadinhas	justabilidade+N+DIM+F+PL
justador	justador+N+M+SG
justadora	justador+N+F+SG
justadoras	justador+N+F+PL
justadorazinha	justador+N+DIM+F+SG
justadorazinhas	justador+N+DIM+F+PL
justadores	justador+N+M+PL
justadorezinhos	justador+N+DIM+M+PL
justadorinha	justador+N+DIM+F+SG
justadorinhas	justador+N+DIM+F+PL
justadorzinho	justador+N+DIM+M+SG
justadorzinhos	justador+N+DIM+M+PL
justafluvialidade	justafluvialidade+N+F+SG
justafluvialidades	justafluvialidade+N+F+PL
justafluvialidadezinha	justafluvialidade+N+DIM+F+SG
justafluvialidadezinhas	justafluvialidade+N+DIM+F+PL
justafluvialidadinha	justafluvialidade+N+DIM+F+SG
justafluvialidadinhas	justafluvialidade+N+DIM+F+PL
justalienaridade	justalienaridade+N+F+SG
justalienaridades	justalienaridade+N+F+PL
justalienaridadezinha	justalienaridade+N+DIM+F+SG
justalienaridadezinhas	justalienaridade+N+DIM+F+PL
justalienaridadinha	justalienaridade+N+DIM+F+SG
justalienaridadinhas	justalienaridade+N+DIM+F+PL
justaposição	justaposição+N+F+SG
justaposiçãozinha	justaposição+N+DIM+F+SG
justaposições	justaposição+N+F+PL
justaposiçõezinhas	justaposição+N+DIM+F+PL
justavertebralidade	justavertebralidade+N+F+SG
justavertebralidades	justavertebralidade+N+F+PL
justavertebralidadezinha	justavertebralidade+N+DIM+F+SG
justavertebralidadezinhas	justavertebralidade+N+DIM+F+PL
justavertebralidadinha	justavertebralidade+N+DIM+F+SG
justavertebralidadinhas	justavertebralidade+N+DIM+F+PL
juste-milieu	juste-milieu+N+M+SG
juste-milieuzinho	juste-milieu+N+DIM+M+SG
justeza	justeza+N+F+SG
justezas	justeza+N+F+PL
justezazinha	justeza+N+DIM+F+SG
justezazinhas	justeza+N+DIM+F+PL
justezinha	justeza+N+DIM+F+SG
justezinhas	justeza+N+DIM+F+PL
justiceira	justiceiro+N+F+SG
justiceiras	justiceiro+N+F+PL
justiceirazinha	justiceiro+N+DIM+F+SG
justiceirazinhas	justiceiro+N+DIM+F+PL
justiceirinha	justiceiro+N+DIM+F+SG
justiceirinhas	justiceiro+N+DIM+F+PL
justiceirinho	justiceiro+N+DIM+M+SG
justiceirinhos	justiceiro+N+DIM+M+PL
justiceiro	justiceiro+N+M+SG
justiceiros	justiceiro+N+M+PL
justiceirozinho	justiceiro+N+DIM+M+SG
justiceirozinhos	justiceiro+N+DIM+M+PL
justicialista	justicialista+N+SG
justicialistas	justicialista+N+PL
justicialistazinha	justicialista+N+DIM+F+SG
justicialistazinhas	justicialista+N+DIM+F+PL
justicialistazinho	justicialista+N+DIM+M+SG
justicialistazinhos	justicialista+N+DIM+M+PL
justicialistinha	justicialista+N+DIM+SG
justicialistinhas	justicialista+N+DIM+PL
justificabilidade	justificabilidade+N+F+SG
justificabilidades	justificabilidade+N+F+PL
justificabilidadezinha	justificabilidade+N+DIM+F+SG
justificabilidadezinhas	justificabilidade+N+DIM+F+PL
justificabilidadinha	justificabilidade+N+DIM+F+SG
justificabilidadinhas	justificabilidade+N+DIM+F+PL
justificada	justificado+N+F+SG
justificadas	justificado+N+F+PL
justificadazinha	justificado+N+DIM+F+SG
justificadazinhas	justificado+N+DIM+F+PL
justificadinha	justificado+N+DIM+F+SG
justificadinhas	justificado+N+DIM+F+PL
justificadinho	justificado+N+DIM+M+SG
justificadinhos	justificado+N+DIM+M+PL
justificado	justificado+N+M+SG
justificados	justificado+N+M+PL
justificadozinho	justificado+N+DIM+M+SG
justificadozinhos	justificado+N+DIM+M+PL
justificador	justificador+N+M+SG
justificadora	justificador+N+F+SG
justificadoras	justificador+N+F+PL
justificadorazinha	justificador+N+DIM+F+SG
justificadorazinhas	justificador+N+DIM+F+PL
justificadores	justificador+N+M+PL
justificadorezinhos	justificador+N+DIM+M+PL
justificadorinha	justificador+N+DIM+F+SG
justificadorinhas	justificador+N+DIM+F+PL
justificadorzinho	justificador+N+DIM+M+SG
justificadorzinhos	justificador+N+DIM+M+PL
justificante	justificante+N+SG
justificantes	justificante+N+PL
justificantezinha	justificante+N+DIM+F+SG
justificantezinhas	justificante+N+DIM+F+PL
justificantezinho	justificante+N+DIM+M+SG
justificantezinhos	justificante+N+DIM+M+PL
justificantinha	justificante+N+DIM+F+SG
justificantinhas	justificante+N+DIM+F+PL
justificantinho	justificante+N+DIM+M+SG
justificantinhos	justificante+N+DIM+M+PL
justificativa	justificativa+N+F+SG
justificativas	justificativa+N+F+PL
justificativazinha	justificativa+N+DIM+F+SG
justificativazinhas	justificativa+N+DIM+F+PL
justificativinha	justificativa+N+DIM+F+SG
justificativinhas	justificativa+N+DIM+F+PL
justificatividade	justificatividade+N+F+SG
justificatividades	justificatividade+N+F+PL
justificatividadezinha	justificatividade+N+DIM+F+SG
justificatividadezinhas	justificatividade+N+DIM+F+PL
justificatividadinha	justificatividade+N+DIM+F+SG
justificatividadinhas	justificatividade+N+DIM+F+PL
justificativa	justificativo+N+F+SG
justificativas	justificativo+N+F+PL
justificativazinha	justificativo+N+DIM+F+SG
justificativazinhas	justificativo+N+DIM+F+PL
justificativinha	justificativo+N+DIM+F+SG
justificativinhas	justificativo+N+DIM+F+PL
justificativinho	justificativo+N+DIM+M+SG
justificativinhos	justificativo+N+DIM+M+PL
justificativo	justificativo+N+M+SG
justificativos	justificativo+N+M+PL
justificativozinho	justificativo+N+DIM+M+SG
justificativozinhos	justificativo+N+DIM+M+PL
justificação	justificação+N+F+SG
justificaçãozinha	justificação+N+DIM+F+SG
justificações	justificação+N+F+PL
justificaçõezinhas	justificação+N+DIM+F+PL
justilhinho	justilho+N+DIM+M+SG
justilhinhos	justilho+N+DIM+M+PL
justilho	justilho+N+M+SG
justilhos	justilho+N+M+PL
justilhozinho	justilho+N+DIM+M+SG
justilhozinhos	justilho+N+DIM+M+PL
justizmord	justizmord+N+M+SG
justizmordzinho	justizmord+N+DIM+M+SG
justicinha	justiça+N+DIM+F+SG
justicinhas	justiça+N+DIM+F+PL
justiça	justiça+N+F+SG
justiças	justiça+N+F+PL
justiçazinha	justiça+N+DIM+F+SG
justiçazinhas	justiça+N+DIM+F+PL
justiça-espectaculinho	justiça-espectáculo+N+DIM+F+SG
justiça-espectaculinhos	justiça-espectáculo+N+DIM+F+PL
justiça-espectaculozinha	justiça-espectáculo+N+DIM+F+SG
justiça-espectáculo	justiça-espectáculo+N+F+SG
justiçabilidade	justiçabilidade+N+F+SG
justiçabilidades	justiçabilidade+N+F+PL
justiçabilidadezinha	justiçabilidade+N+DIM+F+SG
justiçabilidadezinhas	justiçabilidade+N+DIM+F+PL
justiçabilidadinha	justiçabilidade+N+DIM+F+SG
justiçabilidadinhas	justiçabilidade+N+DIM+F+PL
justiçada	justiçado+N+F+SG
justiçadas	justiçado+N+F+PL
justiçadazinha	justiçado+N+DIM+F+SG
justiçadazinhas	justiçado+N+DIM+F+PL
justiçadinha	justiçado+N+DIM+F+SG
justiçadinhas	justiçado+N+DIM+F+PL
justiçadinho	justiçado+N+DIM+M+SG
justiçadinhos	justiçado+N+DIM+M+PL
justiçado	justiçado+N+M+SG
justiçados	justiçado+N+M+PL
justiçadozinho	justiçado+N+DIM+M+SG
justiçadozinhos	justiçado+N+DIM+M+PL
justiçosidade	justiçosidade+N+F+SG
justiçosidades	justiçosidade+N+F+PL
justiçosidadezinha	justiçosidade+N+DIM+F+SG
justiçosidadezinhas	justiçosidade+N+DIM+F+PL
justiçosidadinha	justiçosidade+N+DIM+F+SG
justiçosidadinhas	justiçosidade+N+DIM+F+PL
justa	justo+N+F+SG
justas	justo+N+F+PL
justazinha	justo+N+DIM+F+SG
justazinhas	justo+N+DIM+F+PL
justinha	justo+N+DIM+F+SG
justinhas	justo+N+DIM+F+PL
justinho	justo+N+DIM+M+SG
justinhos	justo+N+DIM+M+PL
justo	justo+N+M+SG
justos	justo+N+M+PL
justozinho	justo+N+DIM+M+SG
justozinhos	justo+N+DIM+M+PL
justura	justura+N+F+SG
justuras	justura+N+F+PL
justurazinha	justura+N+DIM+F+SG
justurazinhas	justura+N+DIM+F+PL
justurinha	justura+N+DIM+F+SG
justurinhas	justura+N+DIM+F+PL
juta	juta+N+F+SG
jutas	juta+N+F+PL
jutazinha	juta+N+DIM+F+SG
jutazinhas	juta+N+DIM+F+PL
jutinha	juta+N+DIM+F+SG
jutinhas	juta+N+DIM+F+PL
jutaipeba	jutaipeba+N+F+SG
jutaipebas	jutaipeba+N+F+PL
jutaipebazinha	jutaipeba+N+DIM+F+SG
jutaipebazinhas	jutaipeba+N+DIM+F+PL
jutaipebinha	jutaipeba+N+DIM+F+SG
jutaipebinhas	jutaipeba+N+DIM+F+PL
jutaizinho	jutaí+N+DIM+M+SG
jutaizinhos	jutaí+N+DIM+M+PL
jutaí	jutaí+N+M+SG
jutaís	jutaí+N+M+PL
jutaubazinha	jutaúba+N+DIM+F+SG
jutaubazinhas	jutaúba+N+DIM+F+PL
jutaubinha	jutaúba+N+DIM+F+SG
jutaubinhas	jutaúba+N+DIM+F+PL
jutaúba	jutaúba+N+F+SG
jutaúbas	jutaúba+N+F+PL
jutlandesa	jutlandês+N+F+SG
jutlandesas	jutlandês+N+F+PL
jutlandesazinha	jutlandês+N+DIM+F+SG
jutlandesazinhas	jutlandês+N+DIM+F+PL
jutlandeses	jutlandês+N+M+PL
jutlandesezinhos	jutlandês+N+DIM+M+PL
jutlandesinha	jutlandês+N+DIM+F+SG
jutlandesinhas	jutlandês+N+DIM+F+PL
jutlandesinho	jutlandês+N+DIM+M+SG
jutlandesinhos	jutlandês+N+DIM+M+PL
jutlandês	jutlandês+N+M+SG
juta	juto+N+F+SG
jutas	juto+N+F+PL
jutazinha	juto+N+DIM+F+SG
jutazinhas	juto+N+DIM+F+PL
jutinha	juto+N+DIM+F+SG
jutinhas	juto+N+DIM+F+PL
jutinho	juto+N+DIM+M+SG
jutinhos	juto+N+DIM+M+PL
juto	juto+N+M+SG
jutos	juto+N+M+PL
jutozinho	juto+N+DIM+M+SG
jutozinhos	juto+N+DIM+M+PL
juvenais	juvenais+N+M+PL
juvenaisinhas	juvenais+N+DIM+F+PL
juvenaisinhos	juvenais+N+DIM+M+PL
juvenca	juvenca+N+F+SG
juvencas	juvenca+N+F+PL
juvencazinha	juvenca+N+DIM+F+SG
juvencazinhas	juvenca+N+DIM+F+PL
juvenquinha	juvenca+N+DIM+F+SG
juvenquinhas	juvenca+N+DIM+F+PL
juvenca	juvenco+N+F+SG
juvencas	juvenco+N+F+PL
juvencazinha	juvenco+N+DIM+F+SG
juvencazinhas	juvenco+N+DIM+F+PL
juvenco	juvenco+N+M+SG
juvencos	juvenco+N+M+PL
juvencozinho	juvenco+N+DIM+M+SG
juvencozinhos	juvenco+N+DIM+M+PL
juvenquinha	juvenco+N+DIM+F+SG
juvenquinhas	juvenco+N+DIM+F+PL
juvenquinho	juvenco+N+DIM+M+SG
juvenquinhos	juvenco+N+DIM+M+PL
juvenescimentinho	juvenescimento+N+DIM+M+SG
juvenescimentinhos	juvenescimento+N+DIM+M+PL
juvenescimento	juvenescimento+N+M+SG
juvenescimentos	juvenescimento+N+M+PL
juvenescimentozinho	juvenescimento+N+DIM+M+SG
juvenescimentozinhos	juvenescimento+N+DIM+M+PL
juvenil	juvenil+N+SG
juvenilzinha	juvenil+N+DIM+F+SG
juvenilzinho	juvenil+N+DIM+M+SG
juvenis	juvenil+N+PL
juvenizinhas	juvenil+N+DIM+F+PL
juvenizinhos	juvenil+N+DIM+M+PL
juvenilidade	juvenilidade+N+F+SG
juvenilidades	juvenilidade+N+F+PL
juvenilidadezinha	juvenilidade+N+DIM+F+SG
juvenilidadezinhas	juvenilidade+N+DIM+F+PL
juvenilidadinha	juvenilidade+N+DIM+F+SG
juvenilidadinhas	juvenilidade+N+DIM+F+PL
juventa	juventa+N+F+SG
juventas	juventa+N+F+PL
juventazinha	juventa+N+DIM+F+SG
juventazinhas	juventa+N+DIM+F+PL
juventinha	juventa+N+DIM+F+SG
juventinhas	juventa+N+DIM+F+PL
juventude	juventude+N+F+SG
juventudes	juventude+N+F+PL
juventudezinha	juventude+N+DIM+F+SG
juventudezinhas	juventude+N+DIM+F+PL
juventudinha	juventude+N+DIM+F+SG
juventudinhas	juventude+N+DIM+F+PL
juventus	juventus+N+M+SG
juventusinho	juventus+N+DIM+M+SG
juveniliazinha	juvenília+N+DIM+F+SG
juveniliazinhas	juvenília+N+DIM+F+PL
juvenilinha	juvenília+N+DIM+F+SG
juvenilinhas	juvenília+N+DIM+F+PL
juvenília	juvenília+N+F+SG
juvenílias	juvenília+N+F+PL
juazinho	juá+N+DIM+M+SG
juazinhos	juá+N+DIM+M+PL
juá	juá+N+M+SG
juás	juá+N+M+PL
juçapezinho	juçapé+N+DIM+M+SG
juçapezinhos	juçapé+N+DIM+M+PL
juçapé	juçapé+N+M+SG
juçapés	juçapé+N+M+PL
juçara	juçara+N+F+SG
juçaras	juçara+N+F+PL
juçarazinha	juçara+N+DIM+F+SG
juçarazinhas	juçara+N+DIM+F+PL
juçarinha	juçara+N+DIM+F+SG
juçarinhas	juçara+N+DIM+F+PL
juçareira	juçareira+N+F+SG
juçareiras	juçareira+N+F+PL
juçareirazinha	juçareira+N+DIM+F+SG
juçareirazinhas	juçareira+N+DIM+F+PL
juçareirinha	juçareira+N+DIM+F+SG
juçareirinhas	juçareira+N+DIM+F+PL
juizazinha	juízo+N+DIM+F+SG
juizazinhas	juízo+N+DIM+F+PL
juizinha	juízo+N+DIM+F+SG
juizinhas	juízo+N+DIM+F+PL
juizinho	juízo+N+DIM+M+SG
juizinhos	juízo+N+DIM+M+PL
juizito	juízo+N+DIM+M+SG
juizitos	juízo+N+DIM+M+PL
juizozinho	juízo+N+DIM+M+SG
juizozinhos	juízo+N+DIM+M+PL
juíza	juízo+N+F+SG
juízas	juízo+N+F+PL
juízo	juízo+N+M+SG
juízos	juízo+N+M+PL
juozinho	juó+N+DIM+M+SG
juozinhos	juó+N+DIM+M+PL
juó	juó+N+M+SG
juós	juó+N+M+PL
jaceazinha	jácea+N+DIM+F+SG
jaceazinhas	jácea+N+DIM+F+PL
jaceinha	jácea+N+DIM+F+SG
jaceinhas	jácea+N+DIM+F+PL
jácea	jácea+N+F+SG
jáceas	jácea+N+F+PL
jaculinho	jáculo+N+DIM+M+SG
jaculinhos	jáculo+N+DIM+M+PL
jaculozinho	jáculo+N+DIM+M+SG
jaculozinhos	jáculo+N+DIM+M+PL
jáculo	jáculo+N+M+SG
jáculos	jáculo+N+M+PL
jagarazinha	jágara+N+DIM+F+SG
jagarazinhas	jágara+N+DIM+F+PL
jagarinha	jágara+N+DIM+F+SG
jagarinhas	jágara+N+DIM+F+PL
jágara	jágara+N+F+SG
jágaras	jágara+N+F+PL
jardiazinha	járdia+N+DIM+F+SG
jardiazinhas	járdia+N+DIM+F+PL
jardinha	járdia+N+DIM+F+SG
jardinhas	járdia+N+DIM+F+PL
járdia	járdia+N+F+SG
járdias	járdia+N+F+PL
jangalezinhos	jângal+N+DIM+M+PL
jangalzinho	jângal+N+DIM+M+SG
jângal	jângal+N+M+SG
jângales	jângal+N+M+PL
jerseizinho	jérsei+N+DIM+M+SG
jerseizinhos	jérsei+N+DIM+M+PL
jérsei	jérsei+N+M+SG
jérseis	jérsei+N+M+PL
joiazinha	jóia+N+DIM+F+SG
joiazinhas	jóia+N+DIM+F+PL
joinha	jóia+N+DIM+F+SG
joinhas	jóia+N+DIM+F+PL
jóia	jóia+N+F+SG
jóias	jóia+N+F+PL
joinazinha	jóina+N+DIM+F+SG
joinazinhas	jóina+N+DIM+F+PL
joininha	jóina+N+DIM+F+SG
joininhas	jóina+N+DIM+F+PL
jóina	jóina+N+F+SG
jóinas	jóina+N+F+PL
joniazinha	jónia+N+DIM+F+SG
joniazinhas	jónia+N+DIM+F+PL
joninha	jónia+N+DIM+F+SG
joninhas	jónia+N+DIM+F+PL
jónia	jónia+N+F+SG
jónias	jónia+N+F+PL
jónico-aticozinho	jónico-ático+N+DIM+M+SG
jónico-atiquinho	jónico-ático+N+DIM+M+SG
jónico-atiquinhos	jónico-ático+N+DIM+M+PL
jónico-ático	jónico-ático+N+M+SG
jónicos-aticozinhos	jónico-ático+N+DIM+M+PL
jónicos-áticos	jónico-ático+N+M+PL
joniazinha	jónio+N+DIM+F+SG
joniazinhas	jónio+N+DIM+F+PL
joninha	jónio+N+DIM+F+SG
joninhas	jónio+N+DIM+F+PL
joninho	jónio+N+DIM+M+SG
joninhos	jónio+N+DIM+M+PL
joniozinho	jónio+N+DIM+M+SG
joniozinhos	jónio+N+DIM+M+PL
jónia	jónio+N+F+SG
jónias	jónio+N+F+PL
jónio	jónio+N+M+SG
jónios	jónio+N+M+PL
joqueizinho	jóquei+N+DIM+M+SG
joqueizinhos	jóquei+N+DIM+M+PL
jóquei	jóquei+N+M+SG
jóqueis	jóquei+N+M+PL
jóquei-clube	jóquei-clube+N+M+SG
jóquei-clubezinho	jóquei-clube+N+DIM+M+SG
jóquei-clubinho	jóquei-clube+N+DIM+M+SG
jóquei-clubinhos	jóquei-clube+N+DIM+M+PL
jóqueis-clubes	jóquei-clube+N+M+PL
jóqueis-clubezinhos	jóquei-clube+N+DIM+M+PL
jorneazinha	jórnea+N+DIM+F+SG
jorneazinhas	jórnea+N+DIM+F+PL
jorneinha	jórnea+N+DIM+F+SG
jorneinhas	jórnea+N+DIM+F+PL
jórnea	jórnea+N+F+SG
jórneas	jórnea+N+F+PL
jonicazinha	jônico+N+DIM+F+SG
jonicazinhas	jônico+N+DIM+F+PL
jonicozinho	jônico+N+DIM+M+SG
jonicozinhos	jônico+N+DIM+M+PL
joniquinha	jônico+N+DIM+F+SG
joniquinhas	jônico+N+DIM+F+PL
joniquinho	jônico+N+DIM+M+SG
joniquinhos	jônico+N+DIM+M+PL
jônica	jônico+N+F+SG
jônicas	jônico+N+F+PL
jônico	jônico+N+M+SG
jônicos	jônico+N+M+PL
jônico-aticozinho	jônico-ático+N+DIM+M+SG
jônico-aticozinhos	jônico-ático+N+DIM+M+PL
jônico-atiquinho	jônico-ático+N+DIM+M+SG
jônico-atiquinhos	jônico-ático+N+DIM+M+PL
jônico-ático	jônico-ático+N+M+SG
jônico-áticos	jônico-ático+N+M+PL
joninho	jônio+N+DIM+M+SG
joninhos	jônio+N+DIM+M+PL
joniozinho	jônio+N+DIM+M+SG
joniozinhos	jônio+N+DIM+M+PL
jônio	jônio+N+M+SG
jônios	jônio+N+M+PL
jubilinho	júbilo+N+DIM+M+SG
jubilinhos	júbilo+N+DIM+M+PL
jubilozinho	júbilo+N+DIM+M+SG
jubilozinhos	júbilo+N+DIM+M+PL
júbilo	júbilo+N+M+SG
júbilos	júbilo+N+M+PL
juniores	júnior+N+M+PL
juniorezinhas	júnior+N+DIM+F+PL
juniorezinhos	júnior+N+DIM+M+PL
juniorzinha	júnior+N+DIM+F+SG
juniorzinhas	júnior+N+DIM+F+PL
juniorzinho	júnior+N+DIM+M+SG
juniorzinhos	júnior+N+DIM+M+PL
júnior	júnior+N+SG
júniores	júnior+N+PL
jupiterezinhos	júpiter+N+DIM+M+PL
jupiterzinho	júpiter+N+DIM+M+SG
jupiterzinhos	júpiter+N+DIM+M+PL
júpiter	júpiter+N+M+SG
júpiteres	júpiter+N+M+PL
jurizinho	júri+N+DIM+M+SG
jurizinhos	júri+N+DIM+M+PL
júri	júri+N+M+SG
júris	júri+N+M+PL
juviazinha	júvia+N+DIM+F+SG
juviazinhas	júvia+N+DIM+F+PL
juvinha	júvia+N+DIM+F+SG
juvinhas	júvia+N+DIM+F+PL
júvia	júvia+N+F+SG
júvias	júvia+N+F+PL
