y	y+N+M+SG
yy	y+N+M+PL
yamaskita	yamaskita+N+SG
yamaskitas	yamaskita+N+PL
yamaskitazinha	yamaskita+N+DIM+F+SG
yamaskitazinhas	yamaskita+N+DIM+F+PL
yamaskitazinho	yamaskita+N+DIM+M+SG
yamaskitazinhos	yamaskita+N+DIM+M+PL
yamaskitinha	yamaskita+N+DIM+SG
yamaskitinhas	yamaskita+N+DIM+PL
yamaskiticidade	yamaskiticidade+N+F+SG
yamaskiticidades	yamaskiticidade+N+F+PL
yamaskiticidadezinha	yamaskiticidade+N+DIM+F+SG
yamaskiticidadezinhas	yamaskiticidade+N+DIM+F+PL
yamaskiticidadinha	yamaskiticidade+N+DIM+F+SG
yamaskiticidadinhas	yamaskiticidade+N+DIM+F+PL
yamaskitinho	yamaskito+N+DIM+M+SG
yamaskitinhos	yamaskito+N+DIM+M+PL
yamaskito	yamaskito+N+M+SG
yamaskitos	yamaskito+N+M+PL
yamaskitozinho	yamaskito+N+DIM+M+SG
yamaskitozinhos	yamaskito+N+DIM+M+PL
yang	yang+N+M+SG
yangzinho	yang+N+DIM+M+SG
yankee	yankee+N+SG
yankees	yankee+N+PL
yankeezinha	yankee+N+DIM+F+SG
yankeezinhas	yankee+N+DIM+F+PL
yankeezinho	yankee+N+DIM+M+SG
yankeezinhos	yankee+N+DIM+M+PL
yankeinha	yankee+N+DIM+F+SG
yankeinhas	yankee+N+DIM+F+PL
yankeinho	yankee+N+DIM+M+SG
yankeinhos	yankee+N+DIM+M+PL
yearling	yearling+N+M+SG
yearlingzinho	yearling+N+DIM+M+SG
yeatmanita	yeatmanita+N+F+SG
yeatmanitas	yeatmanita+N+F+PL
yeatmanitazinha	yeatmanita+N+DIM+F+SG
yeatmanitazinhas	yeatmanita+N+DIM+F+PL
yeatmanitinha	yeatmanita+N+DIM+F+SG
yeatmanitinhas	yeatmanita+N+DIM+F+PL
yedlinita	yedlinita+N+F+SG
yedlinitas	yedlinita+N+F+PL
yedlinitazinha	yedlinita+N+DIM+F+SG
yedlinitazinhas	yedlinita+N+DIM+F+PL
yedlinitinha	yedlinita+N+DIM+F+SG
yedlinitinhas	yedlinita+N+DIM+F+PL
yenita	yenita+N+F+SG
yenitas	yenita+N+F+PL
yenitazinha	yenita+N+DIM+F+SG
yenitazinhas	yenita+N+DIM+F+PL
yenitinha	yenita+N+DIM+F+SG
yenitinhas	yenita+N+DIM+F+PL
yersinose	yersinose+N+F+SG
yersinoses	yersinose+N+F+PL
yersinosezinha	yersinose+N+DIM+F+SG
yersinosezinhas	yersinose+N+DIM+F+PL
yersinosinha	yersinose+N+DIM+F+SG
yersinosinhas	yersinose+N+DIM+F+PL
yersiniasezinha	yersiníase+N+DIM+F+SG
yersiniasezinhas	yersiníase+N+DIM+F+PL
yersiniasinha	yersiníase+N+DIM+F+SG
yersiniasinhas	yersiníase+N+DIM+F+PL
yersiníase	yersiníase+N+F+SG
yersiníases	yersiníase+N+F+PL
yin	yin+N+M+SG
yinzinho	yin+N+DIM+M+SG
yin-yang	yin-yang+N+M+SG
yin-yangzinho	yin-yang+N+DIM+M+SG
yoderita	yoderita+N+F+SG
yoderitas	yoderita+N+F+PL
yoderitazinha	yoderita+N+DIM+F+SG
yoderitazinhas	yoderita+N+DIM+F+PL
yoderitinha	yoderita+N+DIM+F+SG
yoderitinhas	yoderita+N+DIM+F+PL
yofortierita	yofortierita+N+F+SG
yofortieritas	yofortierita+N+F+PL
yofortieritazinha	yofortierita+N+DIM+F+SG
yofortieritazinhas	yofortierita+N+DIM+F+PL
yofortieritinha	yofortierita+N+DIM+F+SG
yofortieritinhas	yofortierita+N+DIM+F+PL
yogurte	yogurte+N+M+SG
yogurtes	yogurte+N+M+PL
yogurtezinho	yogurte+N+DIM+M+SG
yogurtezinhos	yogurte+N+DIM+M+PL
yogurtinho	yogurte+N+DIM+M+SG
yogurtinhos	yogurte+N+DIM+M+PL
yokosukaitazinha	yokosukaíta+N+DIM+F+SG
yokosukaitazinhas	yokosukaíta+N+DIM+F+PL
yokosukaitinha	yokosukaíta+N+DIM+F+SG
yokosukaitinhas	yokosukaíta+N+DIM+F+PL
yokosukaíta	yokosukaíta+N+F+SG
yokosukaítas	yokosukaíta+N+F+PL
ytterbiticidade	ytterbiticidade+N+F+SG
ytterbiticidades	ytterbiticidade+N+F+PL
ytterbiticidadezinha	ytterbiticidade+N+DIM+F+SG
ytterbiticidadezinhas	ytterbiticidade+N+DIM+F+PL
ytterbiticidadinha	ytterbiticidade+N+DIM+F+SG
ytterbiticidadinhas	ytterbiticidade+N+DIM+F+PL
yttroceriticidade	yttroceriticidade+N+F+SG
yttroceriticidades	yttroceriticidade+N+F+PL
yttroceriticidadezinha	yttroceriticidade+N+DIM+F+SG
yttroceriticidadezinhas	yttroceriticidade+N+DIM+F+PL
yttroceriticidadinha	yttroceriticidade+N+DIM+F+SG
yttroceriticidadinhas	yttroceriticidade+N+DIM+F+PL
yttrocrasiticidade	yttrocrasiticidade+N+F+SG
yttrocrasiticidades	yttrocrasiticidade+N+F+PL
yttrocrasiticidadezinha	yttrocrasiticidade+N+DIM+F+SG
yttrocrasiticidadezinhas	yttrocrasiticidade+N+DIM+F+PL
yttrocrasiticidadinha	yttrocrasiticidade+N+DIM+F+SG
yttrocrasiticidadinhas	yttrocrasiticidade+N+DIM+F+PL
yttrofluoriticidade	yttrofluoriticidade+N+F+SG
yttrofluoriticidades	yttrofluoriticidade+N+F+PL
yttrofluoriticidadezinha	yttrofluoriticidade+N+DIM+F+SG
yttrofluoriticidadezinhas	yttrofluoriticidade+N+DIM+F+PL
yttrofluoriticidadinha	yttrofluoriticidade+N+DIM+F+SG
yttrofluoriticidadinhas	yttrofluoriticidade+N+DIM+F+PL
yugawaralita	yugawaralita+N+F+SG
yugawaralitas	yugawaralita+N+F+PL
yugawaralitazinha	yugawaralita+N+DIM+F+SG
yugawaralitazinhas	yugawaralita+N+DIM+F+PL
yugawaralitinha	yugawaralita+N+DIM+F+SG
yugawaralitinhas	yugawaralita+N+DIM+F+PL
yuksporita	yuksporita+N+F+SG
yuksporitas	yuksporita+N+F+PL
yuksporitazinha	yuksporita+N+DIM+F+SG
yuksporitazinhas	yuksporita+N+DIM+F+PL
yuksporitinha	yuksporita+N+DIM+F+SG
yuksporitinhas	yuksporita+N+DIM+F+PL
