zurzidela	zurzidela+N+F+SG
zurzidelas	zurzidela+N+F+PL
zurzidor	zurzidor+N+M+SG
zurzidora	zurzidor+N+F+SG
zurzidoras	zurzidor+N+F+PL
zurzidores	zurzidor+N+M+PL
zuído	zuído+N+M+SG
zuídos	zuído+N+M+PL
zz	z+N+M+PL
zácoro	zácoro+N+M+SG
zácoros	zácoro+N+M+PL
zápete	zápete+N+M+SG
zápetes	zápete+N+M+PL
zâmia	zâmia+N+F+SG
zâmias	zâmia+N+F+PL
zângano	zângano+N+M+SG
zânganos	zângano+N+M+PL
zângão	zângão+N+M+SG
zângãos	zângão+N+M+PL
zângões	zângão+N+M+PL
zântio	zântio+N+M+SG
zântios	zântio+N+M+PL
zânzere	zânzere+N+M+SG
zânzeres	zânzere+N+M+PL
zé	zé+N+M+SG
zé-dos-anzóis	zé-dos-anzóis+N+M+SG
zé-maria	zé-maria+N+M+SG
zé-ninguém	zé-ninguém+N+M+SG
zé-pereira	zé-pereira+N+M+SG
zé-pereiras	zé-pereira+N+M+PL
zé-povinho	zé-povinho+N+M+SG
zé-povinhos	zé-povinho+N+M+PL
zé-povo	zé-povo+N+M+SG
zé-povos	zé-povo+N+M+PL
zé-pregos	zé-pregos+N+M+PL
zé-pregos	zé-pregos+N+M+SG
zécora	zécora+N+F+SG
zécoras	zécora+N+F+PL
zéfiro	zéfiro+N+M+SG
zéfiros	zéfiro+N+M+PL
zéida	zéida+N+F+SG
zéidas	zéida+N+F+PL
zénite	zénite+N+M+SG
zénites	zénite+N+M+PL
zés	zé+N+M+PL
zés-dos-anzóis	zé-dos-anzóis+N+M+PL
zés-ninguém	zé-ninguém+N+M+PL
zés-ninguéns	zé-ninguém+N+M+PL
zê	zê+N+M+SG
zênite	zênite+N+M+SG
zênites	zênite+N+M+PL
zês	zê+N+M+PL
zígnia	zígnia+N+F+SG
zígnias	zígnia+N+F+PL
zímase	zímase+N+F+SG
zímases	zímase+N+F+PL
zíngara	zíngaro+N+F+SG
zíngaras	zíngaro+N+F+PL
zíngaro	zíngaro+N+M+SG
zíngaros	zíngaro+N+M+PL
zínia	zínia+N+F+SG
zínias	zínia+N+F+PL
zíper	zíper+N+M+SG
zíperes	zíper+N+M+PL
zízifo	zízifo+N+M+SG
zízifos	zízifo+N+M+PL
zóide	zóide+N+M+SG
zóides	zóide+N+M+PL
zónula	zónula+N+F+SG
zónulas	zónula+N+F+PL
zóster	zóster+N+M+SG
zósteres	zóster+N+M+PL
zônula	zônula+N+F+SG
zônulas	zônula+N+F+PL
zôo	zôo+N+M+SG
zôos	zôo+N+M+PL
ábaco	ábaco+N+M+SG
ábacos	ábaco+N+M+PL
ábrego	ábrego+N+M+SG
ábregos	ábrego+N+M+PL
ábside	ábside+N+F+SG
ábsides	ábside+N+F+PL
ácaro	ácaro+N+M+SG
ácaros	ácaro+N+M+PL
ácero	ácero+N+M+SG
áceros	ácero+N+M+PL
ácida	ácido+N+F+SG
ácidas	ácido+N+F+PL
ácido	ácido+N+M+SG
ácidos	ácido+N+M+PL
ácie	ácie+N+F+SG
ácino	ácino+N+M+SG
ácinos	ácino+N+M+PL
áclide	áclide+N+F+SG
áclides	áclide+N+F+PL
ácnua	ácnua+N+F+SG
ácnuas	ácnua+N+F+PL
ácoro	ácoro+N+M+SG
ácoros	ácoro+N+M+PL
ácrata	ácrata+N+F+SG
ácrata	ácrata+N+M+SG
ácratas	ácrata+N+F+PL
ácratas	ácrata+N+M+PL
ádipe	ádipe+N+F+SG
ádipes	ádipe+N+F+PL
ádipo	ádipo+N+M+SG
ádipos	ádipo+N+M+PL
ádito	ádito+N+M+SG
áditos	ádito+N+M+PL
ádvena	ádvena+N+F+SG
ádvena	ádvena+N+M+SG
ádvenas	ádvena+N+F+PL
ádvenas	ádvena+N+M+PL
áfido	áfido+N+M+SG
áfidos	áfido+N+M+PL
áfrica	áfrica+N+F+SG
áfrica	áfrico+N+F+SG
áfricas	áfrica+N+F+PL
áfricas	áfrico+N+F+PL
áfrico	áfrico+N+M+SG
áfricos	áfrico+N+M+PL
ágapa	ágapa+N+F+SG
ágapas	ágapa+N+F+PL
ágape	ágape+N+F+SG
ágape	ágape+N+M+SG
ágapes	ágape+N+F+PL
ágapes	ágape+N+M+PL
ágar	ágar+N+M+SG
ágares	ágar+N+M+PL
ágata	ágata+N+F+SG
ágatas	ágata+N+F+PL
ágate	ágate+N+M+SG
ágates	ágate+N+M+PL
ágio	ágio+N+M+SG
ágios	ágio+N+M+PL
ágnato	ágnato+N+M+SG
ágnatos	ágnato+N+M+PL
ágora	ágora+N+F+SG
ágoras	ágora+N+F+PL
água	água+N+F+SG
águabresa	águabresa+N+F+SG
águabresas	águabresa+N+F+PL
águas	água+N+F+PL
águia	águia+N+F+SG
águia	águia+N+M+SG
águias	águia+N+F+PL
águias	águia+N+M+PL
águila	águila+N+F+SG
águilas	águila+N+F+PL
álamo	álamo+N+M+SG
álamos	álamo+N+M+PL
álbum	álbum+N+F+SG
álbum	álbum+N+M+SG
álbuns	álbum+N+F+PL
álbuns	álbum+N+M+PL
álcali	álcali+N+M+SG
álcalis	álcali+N+M+PL
álcea	álcea+N+F+SG
álceas	álcea+N+F+PL
álcida	álcida+N+F+SG
álcidas	álcida+N+F+PL
álcoois	álcool+N+M+PL
álcool	álcool+N+M+SG
álea	álea+N+F+SG
áleas	álea+N+F+PL
álgebra	álgebra+N+F+SG
álgebras	álgebra+N+F+PL
álibi	álibi+N+M+SG
álibis	álibi+N+M+PL
álica	álica+N+F+SG
álicas	álica+N+F+PL
álios	álios+N+M+PL
álios	álios+N+M+SG
áltica	áltica+N+F+SG
álticas	áltica+N+F+PL
álula	álula+N+F+SG
álulas	álula+N+F+PL
álveo	álveo+N+M+SG
álveos	álveo+N+M+PL
álvidro	álvidro+N+M+SG
álvidros	álvidro+N+M+PL
ápice	ápice+N+M+SG
ápices	ápice+N+M+PL
ápoca	ápoca+N+F+SG
ápocas	ápoca+N+F+PL
ápoda	ápodo+N+F+SG
ápodas	ápodo+N+F+PL
ápode	ápode+N+F+SG
ápode	ápode+N+M+SG
ápodes	ápode+N+F+PL
ápodes	ápode+N+M+PL
ápodo	ápodo+N+M+SG
ápodos	ápodo+N+M+PL
áporo	áporo+N+M+SG
áporos	áporo+N+M+PL
ápside	ápside+N+F+SG
ápsides	ápside+N+F+PL
áptera	áptero+N+F+SG
ápteras	áptero+N+F+PL
áptero	áptero+N+M+SG
ápteros	áptero+N+M+PL
áptico	áptico+N+M+SG
ápticos	áptico+N+M+PL
árabe	árabe+N+F+SG
árabe	árabe+N+M+SG
árabes	árabe+N+F+PL
árabes	árabe+N+M+PL
áraque	áraque+N+M+SG
áraques	áraque+N+M+PL
árbitra	árbitro+N+F+SG
árbitras	árbitro+N+F+PL
árbitro	árbitro+N+M+SG
árbitros	árbitro+N+M+PL
árcade	árcade+N+F+SG
árcade	árcade+N+M+SG
árcades	árcade+N+F+PL
árcades	árcade+N+M+PL
árctico	árctico+N+M+SG
árcticos	árctico+N+M+PL
área	área+N+F+SG
áreas	área+N+F+PL
árgon	árgon+N+M+SG
ária	ária+N+F+SG
ária	ária+N+M+SG
árias	ária+N+F+PL
árias	ária+N+M+PL
ársis	ársis+N+F+SG
árula	árula+N+F+SG
árulas	árula+N+F+PL
árvore	árvore+N+F+SG
árvores	árvore+N+F+PL
ás	ás+N+M+SG
ásaro	ásaro+N+M+SG
ásaros	ásaro+N+M+PL
áscele	áscele+N+F+SG
áscele	áscele+N+M+SG
ásceles	áscele+N+F+PL
ásceles	áscele+N+M+PL
áscelo	áscelo+N+M+SG
áscelos	áscelo+N+M+PL
áscio	áscio+N+M+SG
áscios	áscio+N+M+PL
áscoa	áscoa+N+F+SG
áscoas	áscoa+N+F+PL
áscon	áscon+N+M+SG
áscones	áscon+N+M+PL
áscons	áscon+N+M+PL
áscua	áscua+N+F+SG
áscuas	áscua+N+F+PL
áses	ás+N+M+PL
áspide	áspide+N+F+SG
áspide	áspide+N+M+SG
áspides	áspide+N+F+PL
áspides	áspide+N+M+PL
ástato	ástato+N+M+SG
ástatos	ástato+N+M+PL
áster	áster+N+M+SG
ásteres	áster+N+M+PL
ásture	ásture+N+F+SG
ásture	ásture+N+M+SG
ástures	ásture+N+F+PL
ástures	ásture+N+M+PL
ática	ático+N+F+SG
áticas	ático+N+F+PL
ático	ático+N+M+SG
áticos	ático+N+M+PL
átimo	átimo+N+M+SG
átimos	átimo+N+M+PL
átomo	átomo+N+M+SG
átomos	átomo+N+M+PL
átrio	átrio+N+M+SG
átrios	átrio+N+M+PL
átropo	átropo+N+M+SG
átropos	átropo+N+M+PL
áudio	áudio+N+M+SG
áudios	áudio+N+M+PL
áuguratriz	áugure+N+F+SG
áuguratrizes	áugure+N+F+PL
áugure	áugure+N+M+SG
áugures	áugure+N+M+PL
áulica	áulico+N+F+SG
áulicas	áulico+N+F+PL
áulico	áulico+N+M+SG
áulicos	áulico+N+M+PL
áurea	áureo+N+F+SG
áureas	áureo+N+F+PL
áureo	áureo+N+M+SG
áureos	áureo+N+M+PL
ávila	ávila+N+F+SG
ávilas	ávila+N+F+PL
áxis	áxis+N+M+PL
áxis	áxis+N+M+SG
âmago	âmago+N+M+SG
âmagos	âmago+N+M+PL
âmbar	âmbar+N+M+SG
âmbares	âmbar+N+M+PL
âmbito	âmbito+N+M+SG
âmbitos	âmbito+N+M+PL
âmbula	âmbula+N+F+SG
âmbulas	âmbula+N+F+PL
âmnio	âmnio+N+M+SG
âmnios	âmnio+N+M+PL
âncora	âncora+N+F+SG
âncoras	âncora+N+F+PL
ândito	ândito+N+M+SG
ânditos	ândito+N+M+PL
ânfora	ânfora+N+F+SG
ânforas	ânfora+N+F+PL
ângelus	ângelus+N+M+PL
ângelus	ângelus+N+M+SG
ângulo	ângulo+N+M+SG
ângulos	ângulo+N+M+PL
ânimo	ânimo+N+M+SG
ânimos	ânimo+N+M+PL
ânion	ânion+N+M+SG
ânions	ânion+N+M+PL
ânodo	ânodo+N+M+SG
ânodos	ânodo+N+M+PL
ânsia	ânsia+N+F+SG
ânsias	ânsia+N+F+PL
ânulo	ânulo+N+M+SG
ânulos	ânulo+N+M+PL
ânus	ânus+N+M+PL
ânus	ânus+N+M+SG
ébano	ébano+N+M+SG
ébanos	ébano+N+M+PL
ébeno	ébeno+N+M+SG
ébenos	ébeno+N+M+PL
ébola	ébola+N+M+SG
ébolas	ébola+N+M+PL
ébria	ébrio+N+F+SG
ébrias	ébrio+N+F+PL
ébrio	ébrio+N+M+SG
ébrios	ébrio+N+M+PL
ébulo	ébulo+N+M+SG
ébulos	ébulo+N+M+PL
écarté	écarté+N+M+SG
écfora	écfora+N+F+SG
écforas	écfora+N+F+PL
éclair	éclair+N+M+SG
écloga	écloga+N+F+SG
éclogas	écloga+N+F+PL
écran	écran+N+M+SG
écrans	écran+N+M+PL
éctase	éctase+N+F+SG
éctases	éctase+N+F+PL
éculo	éculo+N+M+SG
éculos	éculo+N+M+PL
éden	éden+N+M+SG
édens	éden+N+M+PL
édipo	édipo+N+M+SG
édipos	édipo+N+M+PL
édito	édito+N+M+SG
éditos	édito+N+M+PL
édredon	édredon+N+M+SG
édredons	édredon+N+M+PL
éforo	éforo+N+M+SG
éforos	éforo+N+M+PL
égide	égide+N+F+SG
égides	égide+N+F+PL
égloga	égloga+N+F+SG
églogas	égloga+N+F+PL
égrio	égrio+N+M+SG
égrios	égrio+N+M+PL
égua	égua+N+F+SG
éguas	égua+N+F+PL
élan	élan+N+M+SG
élans	élan+N+M+PL
élate	élate+N+M+SG
élates	élate+N+M+PL
élitro	élitro+N+M+SG
élitros	élitro+N+M+PL
émula	émulo+N+F+SG
émulas	émulo+N+F+PL
émulo	émulo+N+M+SG
émulos	émulo+N+M+PL
énula	énula+N+F+SG
énula-campana	énula-campana+N+F+SG
énulas	énula+N+F+PL
énulas-campana	énula-campana+N+F+PL
énulas-campanas	énula-campana+N+F+PL
énupla	énupla+N+F+SG
énuplas	énupla+N+F+PL
éolo	éolo+N+M+SG
éolos	éolo+N+M+PL
épica	épica+N+F+SG
épica	épico+N+F+SG
épicas	épica+N+F+PL
épicas	épico+N+F+PL
épico	épico+N+M+SG
épicos	épico+N+M+PL
época	época+N+F+SG
épocas	época+N+F+PL
épsilo	épsilo+N+M+SG
épsilon	épsilon+N+M+SG
épsilones	épsilon+N+M+PL
épsilons	épsilon+N+M+PL
épsilos	épsilo+N+M+PL
épsilão	épsilão+N+M+SG
épsilões	épsilão+N+M+PL
épura	épura+N+F+SG
épuras	épura+N+F+PL
équida	équida+N+M+SG
équidas	équida+N+M+PL
équite	équite+N+M+SG
équites	équite+N+M+PL
éqüite	éqüite+N+M+SG
éqüites	éqüite+N+M+PL
érbio	érbio+N+M+SG
érbios	érbio+N+M+PL
ésipo	ésipo+N+M+SG
ésipos	ésipo+N+M+PL
éster	éster+N+M+SG
ésteres	éster+N+M+PL
ésula	ésula+N+F+SG
ésulas	ésula+N+F+PL
étamine	étamine+N+F+SG
étamines	étamine+N+F+PL
éter	éter+N+M+SG
éteres	éter+N+M+PL
ética	ética+N+F+SG
ética	ética+N+M+SG
éticas	ética+N+F+PL
éticas	ética+N+M+PL
étimo	étimo+N+M+SG
étimos	étimo+N+M+PL
éxciton	éxciton+N+M+SG
éxcitons	éxciton+N+M+PL
êider	êider+N+M+SG
êideres	êider+N+M+PL
êmbolo	êmbolo+N+M+SG
êmbolos	êmbolo+N+M+PL
ênclise	ênclise+N+F+SG
ênclises	ênclise+N+F+PL
êndua	êndua+N+F+SG
ênduas	êndua+N+F+PL
ênfase	ênfase+N+F+SG
ênfases	ênfase+N+F+PL
êntero	êntero+N+M+SG
ênteros	êntero+N+M+PL
ênula	ênula+N+F+SG
ênula-campana	ênula-campana+N+F+SG
ênulas	ênula+N+F+PL
ênulas-campana	ênula-campana+N+F+PL
ênulas-campanas	ênula-campana+N+F+PL
êrvedo	êrvedo+N+M+SG
êrvedos	êrvedo+N+M+PL
êrvodo	êrvodo+N+M+SG
êrvodos	êrvodo+N+M+PL
êuclase	êuclase+N+F+SG
êuclases	êuclase+N+F+PL
êufona	êufono+N+F+SG
êufonas	êufono+N+F+PL
êufono	êufono+N+M+SG
êufonos	êufono+N+M+PL
êugrafo	êugrafo+N+M+SG
êugrafos	êugrafo+N+M+PL
êuscara	êuscaro+N+F+SG
êuscaras	êuscaro+N+F+PL
êuscaro	êuscaro+N+M+SG
êuscaros	êuscaro+N+M+PL
êxcetra	êxcetra+N+F+SG
êxcetras	êxcetra+N+F+PL
êxedra	êxedra+N+F+SG
êxedras	êxedra+N+F+PL
êxito	êxito+N+M+SG
êxitos	êxito+N+M+PL
êxodo	êxodo+N+M+SG
êxodos	êxodo+N+M+PL
êxtase	êxtase+N+M+SG
êxtases	êxtase+N+M+PL
íbis	íbis+N+F+PL
íbis	íbis+N+F+SG
íbis	íbis+N+M+PL
íbis	íbis+N+M+SG
ícaro	ícaro+N+M+SG
ícaros	ícaro+N+M+PL
ícone	ícone+N+M+SG
ícones	ícone+N+M+PL
ídola	ídola+N+F+SG
ídolas	ídola+N+F+PL
ídolo	ídolo+N+M+SG
ídolos	ídolo+N+M+PL
íleo	íleo+N+M+SG
íleos	íleo+N+M+PL
ílio	ílio+N+M+SG
ílion	ílion+N+M+SG
ílions	ílion+N+M+PL
ílios	ílio+N+M+PL
íman	íman+N+M+SG
ímans	íman+N+M+PL
ímpar	ímpar+N+F+SG
ímpar	ímpar+N+M+SG
ímpares	ímpar+N+F+PL
ímpares	ímpar+N+M+PL
ímparidade	ímparidade+N+F+SG
ímparidades	ímparidade+N+F+PL
ímpeto	ímpeto+N+M+SG
ímpetos	ímpeto+N+M+PL
ímpia	ímpio+N+F+SG
ímpias	ímpio+N+F+PL
ímpio	ímpio+N+M+SG
ímpios	ímpio+N+M+PL
ímã	ímã+N+M+SG
ímãs	ímã+N+M+PL
íncola	íncola+N+F+SG
íncola	íncola+N+M+SG
íncolas	íncola+N+F+PL
íncolas	íncola+N+M+PL
íncubo	íncubo+N+M+SG
íncubos	íncubo+N+M+PL
índex	índex+N+M+SG
índia	índio+N+F+SG
índias	índio+N+F+PL
índice	índice+N+M+SG
índices	índex+N+M+PL
índices	índice+N+M+PL
índigo	índigo+N+M+SG
índigos	índigo+N+M+PL
índio	índio+N+M+SG
índios	índio+N+M+PL
índole	índole+N+F+SG
índoles	índole+N+F+PL
índua	índua+N+F+SG
índuas	índua+N+F+PL
íngua	íngua+N+F+SG
ínguas	íngua+N+F+PL
ínio	ínio+N+M+SG
ínios	ínio+N+M+PL
ínsua	ínsua+N+F+SG
ínsuas	ínsua+N+F+PL
ínsula	ínsula+N+F+SG
ínsulas	ínsula+N+F+PL
íntegra	íntegra+N+F+SG
íntegra	íntegro+N+F+SG
íntegras	íntegra+N+F+PL
íntegras	íntegro+N+F+PL
íntegro	íntegro+N+M+SG
íntegros	íntegro+N+M+PL
ínterim	ínterim+N+M+SG
ínterins	ínterim+N+M+PL
íntima	íntimo+N+F+SG
íntimas	íntimo+N+F+PL
íntimo	íntimo+N+M+SG
íntimos	íntimo+N+M+PL
íon	íon+N+M+SG
íons	íon+N+M+PL
ípsilo	ípsilo+N+M+SG
ípsilon	ípsilon+N+M+SG
ípsilons	ípsilon+N+M+PL
ípsilos	ípsilo+N+M+PL
íris	íris+N+F+PL
íris	íris+N+F+SG
íris	íris+N+M+PL
íris	íris+N+M+SG
ísquio	ísquio+N+M+SG
ísquion	ísquion+N+M+SG
ísquions	ísquion+N+M+PL
ísquios	ísquio+N+M+PL
ístmica	ístmico+N+F+SG
ístmicas	ístmico+N+F+PL
ístmico	ístmico+N+M+SG
ístmicos	ístmico+N+M+PL
ístmicos	ístmicos+N+M+PL
ítala	ítalo+N+F+SG
ítalas	ítalo+N+F+PL
ítalo	ítalo+N+M+SG
ítalos	ítalo+N+M+PL
ítrio	ítrio+N+M+SG
ítrios	ítrio+N+M+PL
ó	ó+N+M+SG
óbelo	óbelo+N+M+SG
óbelos	óbelo+N+M+PL
óbice	óbice+N+M+SG
óbices	óbice+N+M+PL
óbito	óbito+N+M+SG
óbitos	óbito+N+M+PL
óbolo	óbolo+N+M+SG
óbolos	óbolo+N+M+PL
ócciput	ócciput+N+M+SG
ócciputes	ócciput+N+M+PL
ócio	ócio+N+M+SG
ócios	ócio+N+M+PL
ócrea	ócrea+N+F+SG
ócreas	ócrea+N+F+PL
óctuplo	óctuplo+N+M+SG
óctuplos	óctuplo+N+M+PL
óculo	óculo+N+M+SG
óculos	óculo+N+M+PL
óculos	óculos+N+M+PL
óculos	óculos+N+M+SG
ódio	ódio+N+M+SG
ódios	ódio+N+M+PL
ófrio	ófrio+N+M+SG
ófrios	ófrio+N+M+PL
ólace	ólace+N+M+SG
ólaces	ólace+N+M+PL
óleo	óleo+N+M+SG
óleos	óleo+N+M+PL
ómega	ómega+N+M+SG
ómegas	ómega+N+M+PL
ómicro	ómicro+N+M+SG
ómicron	ómicron+N+M+SG
ómicrons	ómicron+N+M+PL
ómicros	ómicro+N+M+PL
ónagra	ónagra+N+F+SG
ónagras	ónagra+N+F+PL
ónagro	ónagro+N+M+SG
ónagros	ónagro+N+M+PL
ónibus	ónibus+N+M+PL
ónibus	ónibus+N+M+SG
ónix	ónix+N+M+PL
ónix	ónix+N+M+SG
ónus	ónus+N+M+PL
ónus	ónus+N+M+SG
ópalo	ópalo+N+M+SG
ópalos	ópalo+N+M+PL
ópera	ópera+N+F+SG
óperas	ópera+N+F+PL
ópido	ópido+N+M+SG
ópidos	ópido+N+M+PL
ópio	ópio+N+M+SG
ópios	ópio+N+M+PL
óptica	óptica+N+F+SG
óptica	óptico+N+F+SG
ópticas	óptica+N+F+PL
ópticas	óptico+N+F+PL
óptico	óptico+N+M+SG
ópticos	óptico+N+M+PL
óptimo	óptimo+N+M+SG
óptimos	óptimo+N+M+PL
órbita	órbita+N+F+SG
órbitas	órbita+N+F+PL
órfã	órfão+N+F+SG
órfão	órfão+N+M+SG
órfãos	órfão+N+M+PL
órfãs	órfão+N+F+PL
órgão	órgão+N+M+SG
órgãos	órgão+N+M+PL
órobo	órobo+N+M+SG
órobos	órobo+N+M+PL
ós	ó+N+M+PL
óscar	óscar+N+M+SG
óscares	óscar+N+M+PL
ósculo	ósculo+N+M+SG
ósculos	ósculo+N+M+PL
ósmio	ósmio+N+M+SG
ósmios	ósmio+N+M+PL
ótica	ótica+N+F+SG
óticas	ótica+N+F+PL
óvalo	óvalo+N+M+SG
óvalos	óvalo+N+M+PL
óvano	óvano+N+M+SG
óvanos	óvano+N+M+PL
óvni	óvni+N+M+SG
óvnis	óvni+N+M+PL
óvulo	ovo+N+DIM+M+SG
óvulo	óvulo+N+M+SG
óvulos	ovo+N+DIM+M+PL
óvulos	óvulo+N+M+PL
óxido	óxido+N+M+SG
óxidos	óxido+N+M+PL
ômega	ômega+N+M+SG
ômegas	ômega+N+M+PL
ômicron	ômicron+N+M+SG
ômicrones	ômicron+N+M+PL
ônagra	ônagra+N+F+SG
ônagras	ônagra+N+F+PL
ônagro	ônagro+N+M+SG
ônagros	ônagro+N+M+PL
ôndula	ôndula+N+F+SG
ôndulas	ôndula+N+F+PL
ônibus	ônibus+N+M+PL
ônibus	ônibus+N+M+SG
ônix	ônix+N+M+PL
ônix	ônix+N+M+SG
ôntica	ôntico+N+F+SG
ônticas	ôntico+N+F+PL
ôntico	ôntico+N+M+SG
ônticos	ôntico+N+M+PL
ônus	ônus+N+M+PL
ônus	ônus+N+M+SG
úbere	úbere+N+F+SG
úbere	úbere+N+M+SG
úberes	úbere+N+F+PL
úberes	úbere+N+M+PL
úbero	úbero+N+M+SG
úberos	úbero+N+M+PL
úlcera	úlcera+N+F+SG
úlceras	úlcera+N+F+PL
última	última+N+F+SG
últimas	última+N+F+PL
último	último+N+M+SG
últimos	último+N+M+PL
úmbria	úmbrio+N+F+SG
úmbrias	úmbrio+N+F+PL
úmbrio	úmbrio+N+M+SG
úmbrios	úmbrio+N+M+PL
úmero	úmero+N+M+SG
úmeros	úmero+N+M+PL
úngue	úngue+N+M+SG
úngues	úngue+N+M+PL
únguis	únguis+N+M+PL
únguis	únguis+N+M+SG
úngula	úngula+N+F+SG
úngulas	úngula+N+F+PL
úngüe	úngüe+N+M+SG
úngües	úngüe+N+M+PL
única	único+N+F+SG
únicas	único+N+F+PL
único	único+N+M+SG
únicos	único+N+M+PL
úrnula	úrnula+N+F+SG
úrnulas	úrnula+N+F+PL
úsnea	úsnea+N+F+SG
úsneas	úsnea+N+F+PL
ústia	ústia+N+F+SG
ústias	ústia+N+F+PL
úteis	útil+N+F+PL
úteis	útil+N+M+PL
útero	útero+N+M+SG
úteros	útero+N+M+PL
útil	útil+N+F+SG
útil	útil+N+M+SG
úvula	úvula+N+F+SG
úvulas	úvula+N+F+PL
