w	w+N+M+SG
ww	w+N+M+PL
wad	wad+N+M+SG
wades	wad+N+M+PL
wadezinhos	wad+N+DIM+M+PL
wadzinho	wad+N+DIM+M+SG
wagnerisminho	wagnerismo+N+DIM+M+SG
wagnerisminhos	wagnerismo+N+DIM+M+PL
wagnerismo	wagnerismo+N+M+SG
wagnerismos	wagnerismo+N+M+PL
wagnerismozinho	wagnerismo+N+DIM+M+SG
wagnerismozinhos	wagnerismo+N+DIM+M+PL
wagneristicidade	wagneristicidade+N+F+SG
wagneristicidades	wagneristicidade+N+F+PL
wagneristicidadezinha	wagneristicidade+N+DIM+F+SG
wagneristicidadezinhas	wagneristicidade+N+DIM+F+PL
wagneristicidadinha	wagneristicidade+N+DIM+F+SG
wagneristicidadinhas	wagneristicidade+N+DIM+F+PL
wagnerita	wagnerita+N+F+SG
wagneritas	wagnerita+N+F+PL
wagneritazinha	wagnerita+N+DIM+F+SG
wagneritazinhas	wagnerita+N+DIM+F+PL
wagneritinha	wagnerita+N+DIM+F+SG
wagneritinhas	wagnerita+N+DIM+F+PL
wagnerite	wagnerite+N+F+SG
wagnerites	wagnerite+N+F+PL
wagneritezinha	wagnerite+N+DIM+F+SG
wagneritezinhas	wagnerite+N+DIM+F+PL
wagneritinha	wagnerite+N+DIM+F+SG
wagneritinhas	wagnerite+N+DIM+F+PL
wahlembergiazinha	wahlembérgia+N+DIM+F+SG
wahlembergiazinhas	wahlembérgia+N+DIM+F+PL
wahlemberginha	wahlembérgia+N+DIM+F+SG
wahlemberginhas	wahlembérgia+N+DIM+F+PL
wahlembérgia	wahlembérgia+N+F+SG
wahlembérgias	wahlembérgia+N+F+PL
walchia	walchia+N+F+SG
walchias	walchia+N+F+PL
walchiazinha	walchia+N+DIM+F+SG
walchiazinhas	walchia+N+DIM+F+PL
walchinha	walchia+N+DIM+F+SG
walchinhas	walchia+N+DIM+F+PL
walkerita	walkerita+N+F+SG
walkeritas	walkerita+N+F+PL
walkeritazinha	walkerita+N+DIM+F+SG
walkeritazinhas	walkerita+N+DIM+F+PL
walkeritinha	walkerita+N+DIM+F+SG
walkeritinhas	walkerita+N+DIM+F+PL
walkie-over	walkie-over+N+M+SG
walkie-overzinho	walkie-over+N+DIM+M+SG
walkie-talkie	walkie-talkie+N+M+SG
walkie-talkies	walkie-talkie+N+M+PL
walkie-talkiezinho	walkie-talkie+N+DIM+M+SG
walkie-talkiezinhos	walkie-talkie+N+DIM+M+PL
walkie-talkinho	walkie-talkie+N+DIM+M+SG
walkie-talkinhos	walkie-talkie+N+DIM+M+PL
wallisita	wallisita+N+F+SG
wallisitas	wallisita+N+F+PL
wallisitazinha	wallisita+N+DIM+F+SG
wallisitazinhas	wallisita+N+DIM+F+PL
wallisitinha	wallisita+N+DIM+F+SG
wallisitinhas	wallisita+N+DIM+F+PL
walpurgita	walpurgita+N+F+SG
walpurgitas	walpurgita+N+F+PL
walpurgitazinha	walpurgita+N+DIM+F+SG
walpurgitazinhas	walpurgita+N+DIM+F+PL
walpurgitinha	walpurgita+N+DIM+F+SG
walpurgitinhas	walpurgita+N+DIM+F+PL
warm-up	warm-up+N+M+SG
warm-ups	warm-up+N+M+PL
warm-upzinho	warm-up+N+DIM+M+SG
warm-upzinhos	warm-up+N+DIM+M+PL
warrant	warrant+N+M+SG
warrantzinho	warrant+N+DIM+M+SG
warrantagem	warrantagem+N+F+SG
warrantagens	warrantagem+N+F+PL
warrantagenzinha	warrantagem+N+DIM+F+SG
warrantagenzinhas	warrantagem+N+DIM+F+PL
washingtonite	washingtonite+N+F+SG
washingtonites	washingtonite+N+F+PL
washingtonitezinha	washingtonite+N+DIM+F+SG
washingtonitezinhas	washingtonite+N+DIM+F+PL
washingtonitinha	washingtonite+N+DIM+F+SG
washingtonitinhas	washingtonite+N+DIM+F+PL
washingtoniazinha	washingtónia+N+DIM+F+SG
washingtoniazinhas	washingtónia+N+DIM+F+PL
washingtoninha	washingtónia+N+DIM+F+SG
washingtoninhas	washingtónia+N+DIM+F+PL
washingtónia	washingtónia+N+F+SG
washingtónias	washingtónia+N+F+PL
washingtoniazinha	washingtônia+N+DIM+F+SG
washingtoniazinhas	washingtônia+N+DIM+F+PL
washingtoninha	washingtônia+N+DIM+F+SG
washingtoninhas	washingtônia+N+DIM+F+PL
washingtônia	washingtônia+N+F+SG
washingtônias	washingtônia+N+F+PL
watsoniazinha	watsónia+N+DIM+F+SG
watsoniazinhas	watsónia+N+DIM+F+PL
watsoninha	watsónia+N+DIM+F+SG
watsoninhas	watsónia+N+DIM+F+PL
watsónia	watsónia+N+F+SG
watsónias	watsónia+N+F+PL
watsoniazinha	watsônia+N+DIM+F+SG
watsoniazinhas	watsônia+N+DIM+F+PL
watsoninha	watsônia+N+DIM+F+SG
watsoninhas	watsônia+N+DIM+F+PL
watsônia	watsônia+N+F+SG
watsônias	watsônia+N+F+PL
watt	watt+N+M+SG
watts	watt+N+M+PL
wattzinho	watt+N+DIM+M+SG
wattzinhos	watt+N+DIM+M+PL
watt-hora	watt-hora+N+M+SG
watt-horazinho	watt-hora+N+DIM+M+SG
watt-horinha	watt-hora+N+DIM+M+SG
watt-horinhas	watt-hora+N+DIM+M+PL
watts-horas	watt-hora+N+M+PL
watts-horazinhos	watt-hora+N+DIM+M+PL
watt-horimetrinho	watt-horímetro+N+DIM+M+SG
watt-horimetrinhos	watt-horímetro+N+DIM+M+PL
watt-horimetrozinho	watt-horímetro+N+DIM+M+SG
watt-horímetro	watt-horímetro+N+M+SG
watts-horimetrozinhos	watt-horímetro+N+DIM+M+PL
watts-horímetros	watt-horímetro+N+M+PL
watt-segundinho	watt-segundo+N+DIM+M+SG
watt-segundinhos	watt-segundo+N+DIM+M+PL
watt-segundo	watt-segundo+N+M+SG
watt-segundozinho	watt-segundo+N+DIM+M+SG
watts-segundos	watt-segundo+N+M+PL
watts-segundozinhos	watt-segundo+N+DIM+M+PL
wattimetrinho	wattímetro+N+DIM+M+SG
wattimetrinhos	wattímetro+N+DIM+M+PL
wattimetrozinho	wattímetro+N+DIM+M+SG
wattimetrozinhos	wattímetro+N+DIM+M+PL
wattímetro	wattímetro+N+M+SG
wattímetros	wattímetro+N+M+PL
wealdianinho	wealdiano+N+DIM+M+SG
wealdianinhos	wealdiano+N+DIM+M+PL
wealdiano	wealdiano+N+M+SG
wealdianos	wealdiano+N+M+PL
wealdianozinho	wealdiano+N+DIM+M+SG
wealdianozinhos	wealdiano+N+DIM+M+PL
weber	weber+N+M+SG
weberes	weber+N+M+PL
weberezinhos	weber+N+DIM+M+PL
webers	weber+N+M+PL
weberzinho	weber+N+DIM+M+SG
weberzinhos	weber+N+DIM+M+PL
weblogger	weblogger+N+M+SG
webloggers	weblogger+N+M+PL
webloggerzinho	weblogger+N+DIM+M+SG
webloggerzinhos	weblogger+N+DIM+M+PL
webmail	webmail+N+M+SG
webmails	webmail+N+M+PL
webmailzinho	webmail+N+DIM+M+SG
webmailzinhos	webmail+N+DIM+M+PL
webmaster	webmaster+N+M+SG
webmasters	webmaster+N+M+PL
webmasterzinho	webmaster+N+DIM+M+SG
webmasterzinhos	webmaster+N+DIM+M+PL
week-end	week-end+N+M+SG
week-endzinho	week-end+N+DIM+M+SG
weekend	weekend+N+M+SG
weekendzinho	weekend+N+DIM+M+SG
weeksita	weeksita+N+F+SG
weeksitas	weeksita+N+F+PL
weeksitazinha	weeksita+N+DIM+F+SG
weeksitazinhas	weeksita+N+DIM+F+PL
weeksitinha	weeksita+N+DIM+F+SG
weeksitinhas	weeksita+N+DIM+F+PL
wegenerisminho	wegenerismo+N+DIM+M+SG
wegenerisminhos	wegenerismo+N+DIM+M+PL
wegenerismo	wegenerismo+N+M+SG
wegenerismos	wegenerismo+N+M+PL
wegenerismozinho	wegenerismo+N+DIM+M+SG
wegenerismozinhos	wegenerismo+N+DIM+M+PL
wegeneristicidade	wegeneristicidade+N+F+SG
wegeneristicidades	wegeneristicidade+N+F+PL
wegeneristicidadezinha	wegeneristicidade+N+DIM+F+SG
wegeneristicidadezinhas	wegeneristicidade+N+DIM+F+PL
wegeneristicidadinha	wegeneristicidade+N+DIM+F+SG
wegeneristicidadinhas	wegeneristicidade+N+DIM+F+PL
weinmaniazinha	weinmânia+N+DIM+F+SG
weinmaniazinhas	weinmânia+N+DIM+F+PL
weinmaninha	weinmânia+N+DIM+F+SG
weinmaninhas	weinmânia+N+DIM+F+PL
weinmânia	weinmânia+N+F+SG
weinmânias	weinmânia+N+F+PL
weisbachita	weisbachita+N+F+SG
weisbachitas	weisbachita+N+F+PL
weisbachitazinha	weisbachita+N+DIM+F+SG
weisbachitazinhas	weisbachita+N+DIM+F+PL
weisbachitinha	weisbachita+N+DIM+F+SG
weisbachitinhas	weisbachita+N+DIM+F+PL
wellhausianisminho	wellhausianismo+N+DIM+M+SG
wellhausianisminhos	wellhausianismo+N+DIM+M+PL
wellhausianismo	wellhausianismo+N+M+SG
wellhausianismos	wellhausianismo+N+M+PL
wellhausianismozinho	wellhausianismo+N+DIM+M+SG
wellhausianismozinhos	wellhausianismo+N+DIM+M+PL
wellhausianisticidade	wellhausianisticidade+N+F+SG
wellhausianisticidades	wellhausianisticidade+N+F+PL
wellhausianisticidadezinha	wellhausianisticidade+N+DIM+F+SG
wellhausianisticidadezinhas	wellhausianisticidade+N+DIM+F+PL
wellhausianisticidadinha	wellhausianisticidade+N+DIM+F+SG
wellhausianisticidadinhas	wellhausianisticidade+N+DIM+F+PL
wellingtoniáceas	wellingtoniáceas+N+F+PL
wellingtoniazinha	wellingtónia+N+DIM+F+SG
wellingtoniazinhas	wellingtónia+N+DIM+F+PL
wellingtoninha	wellingtónia+N+DIM+F+SG
wellingtoninhas	wellingtónia+N+DIM+F+PL
wellingtónia	wellingtónia+N+F+SG
wellingtónias	wellingtónia+N+F+PL
wellingtoniazinha	wellingtônia+N+DIM+F+SG
wellingtoniazinhas	wellingtônia+N+DIM+F+PL
wellingtoninha	wellingtônia+N+DIM+F+SG
wellingtoninhas	wellingtônia+N+DIM+F+PL
wellingtônia	wellingtônia+N+F+SG
wellingtônias	wellingtônia+N+F+PL
wellsita	wellsita+N+F+SG
wellsitas	wellsita+N+F+PL
wellsitazinha	wellsita+N+DIM+F+SG
wellsitazinhas	wellsita+N+DIM+F+PL
wellsitinha	wellsita+N+DIM+F+SG
wellsitinhas	wellsita+N+DIM+F+PL
welwitschiáceas	welwitschiáceas+N+F+PL
welwitschiaceazinha	welwitschiáceo+N+DIM+F+SG
welwitschiaceazinhas	welwitschiáceo+N+DIM+F+PL
welwitschiaceinha	welwitschiáceo+N+DIM+F+SG
welwitschiaceinhas	welwitschiáceo+N+DIM+F+PL
welwitschiaceinho	welwitschiáceo+N+DIM+M+SG
welwitschiaceinhos	welwitschiáceo+N+DIM+M+PL
welwitschiaceozinho	welwitschiáceo+N+DIM+M+SG
welwitschiaceozinhos	welwitschiáceo+N+DIM+M+PL
welwitschiácea	welwitschiáceo+N+F+SG
welwitschiáceas	welwitschiáceo+N+F+PL
welwitschiáceo	welwitschiáceo+N+M+SG
welwitschiáceos	welwitschiáceo+N+M+PL
wenkita	wenkita+N+F+SG
wenkitas	wenkita+N+F+PL
wenkitazinha	wenkita+N+DIM+F+SG
wenkitazinhas	wenkita+N+DIM+F+PL
wenkitinha	wenkita+N+DIM+F+SG
wenkitinhas	wenkita+N+DIM+F+PL
wenlockianinho	wenlockiano+N+DIM+M+SG
wenlockianinhos	wenlockiano+N+DIM+M+PL
wenlockiano	wenlockiano+N+M+SG
wenlockianos	wenlockiano+N+M+PL
wenlockianozinho	wenlockiano+N+DIM+M+SG
wenlockianozinhos	wenlockiano+N+DIM+M+PL
werfenianinho	werfeniano+N+DIM+M+SG
werfenianinhos	werfeniano+N+DIM+M+PL
werfeniano	werfeniano+N+M+SG
werfenianos	werfeniano+N+M+PL
werfenianozinho	werfeniano+N+DIM+M+SG
werfenianozinhos	werfeniano+N+DIM+M+PL
werneriticidade	werneriticidade+N+F+SG
werneriticidades	werneriticidade+N+F+PL
werneriticidadezinha	werneriticidade+N+DIM+F+SG
werneriticidadezinhas	werneriticidade+N+DIM+F+PL
werneriticidadinha	werneriticidade+N+DIM+F+SG
werneriticidadinhas	werneriticidade+N+DIM+F+PL
wesleyanisminho	wesleyanismo+N+DIM+M+SG
wesleyanisminhos	wesleyanismo+N+DIM+M+PL
wesleyanismo	wesleyanismo+N+M+SG
wesleyanismos	wesleyanismo+N+M+PL
wesleyanismozinho	wesleyanismo+N+DIM+M+SG
wesleyanismozinhos	wesleyanismo+N+DIM+M+PL
wesleyanisticidade	wesleyanisticidade+N+F+SG
wesleyanisticidades	wesleyanisticidade+N+F+PL
wesleyanisticidadezinha	wesleyanisticidade+N+DIM+F+SG
wesleyanisticidadezinhas	wesleyanisticidade+N+DIM+F+PL
wesleyanisticidadinha	wesleyanisticidade+N+DIM+F+SG
wesleyanisticidadinhas	wesleyanisticidade+N+DIM+F+PL
western	western+N+M+SG
westerns	western+N+M+PL
westernzinho	western+N+DIM+M+SG
westernzinhos	western+N+DIM+M+PL
whig	whig+N+M+SG
whigzinho	whig+N+DIM+M+SG
whiskies	whisky+N+M+PL
whiskiezinhos	whisky+N+DIM+M+PL
whisky	whisky+N+M+SG
whiskys	whisky+N+M+PL
whiskyzinho	whisky+N+DIM+M+SG
whiskyzinhos	whisky+N+DIM+M+PL
whist	whist+N+M+SG
whists	whist+N+M+PL
whistzinho	whist+N+DIM+M+SG
whistzinhos	whist+N+DIM+M+PL
whiteriticidade	whiteriticidade+N+F+SG
whiteriticidades	whiteriticidade+N+F+PL
whiteriticidadezinha	whiteriticidade+N+DIM+F+SG
whiteriticidadezinhas	whiteriticidade+N+DIM+F+PL
whiteriticidadinha	whiteriticidade+N+DIM+F+SG
whiteriticidadinhas	whiteriticidade+N+DIM+F+PL
wiclefisminho	wiclefismo+N+DIM+M+SG
wiclefisminhos	wiclefismo+N+DIM+M+PL
wiclefismo	wiclefismo+N+M+SG
wiclefismos	wiclefismo+N+M+PL
wiclefismozinho	wiclefismo+N+DIM+M+SG
wiclefismozinhos	wiclefismo+N+DIM+M+PL
wiclefista	wiclefista+N+SG
wiclefistas	wiclefista+N+PL
wiclefistazinha	wiclefista+N+DIM+F+SG
wiclefistazinhas	wiclefista+N+DIM+F+PL
wiclefistazinho	wiclefista+N+DIM+M+SG
wiclefistazinhos	wiclefista+N+DIM+M+PL
wiclefistinha	wiclefista+N+DIM+SG
wiclefistinhas	wiclefista+N+DIM+PL
widdringtoniazinha	widdringtónia+N+DIM+F+SG
widdringtoniazinhas	widdringtónia+N+DIM+F+PL
widdringtoninha	widdringtónia+N+DIM+F+SG
widdringtoninhas	widdringtónia+N+DIM+F+PL
widdringtónia	widdringtónia+N+F+SG
widdringtónias	widdringtónia+N+F+PL
widdringtoniazinha	widdringtônia+N+DIM+F+SG
widdringtoniazinhas	widdringtônia+N+DIM+F+PL
widdringtoninha	widdringtônia+N+DIM+F+SG
widdringtoninhas	widdringtônia+N+DIM+F+PL
widdringtônia	widdringtônia+N+F+SG
widdringtônias	widdringtônia+N+F+PL
wiechnewiticidade	wiechnewiticidade+N+F+SG
wiechnewiticidades	wiechnewiticidade+N+F+PL
wiechnewiticidadezinha	wiechnewiticidade+N+DIM+F+SG
wiechnewiticidadezinhas	wiechnewiticidade+N+DIM+F+PL
wiechnewiticidadinha	wiechnewiticidade+N+DIM+F+SG
wiechnewiticidadinhas	wiechnewiticidade+N+DIM+F+PL
wild-card	wild-card+N+M+SG
wild-cards	wild-card+N+M+PL
wild-cardzinho	wild-card+N+DIM+M+SG
wild-cardzinhos	wild-card+N+DIM+M+PL
wilkinsoniazinha	wilkinsónia+N+DIM+F+SG
wilkinsoniazinhas	wilkinsónia+N+DIM+F+PL
wilkinsoninha	wilkinsónia+N+DIM+F+SG
wilkinsoninhas	wilkinsónia+N+DIM+F+PL
wilkinsónia	wilkinsónia+N+F+SG
wilkinsónias	wilkinsónia+N+F+PL
wilkinsoniazinha	wilkinsônia+N+DIM+F+SG
wilkinsoniazinhas	wilkinsônia+N+DIM+F+PL
wilkinsoninha	wilkinsônia+N+DIM+F+SG
wilkinsoninhas	wilkinsônia+N+DIM+F+PL
wilkinsônia	wilkinsônia+N+F+SG
wilkinsônias	wilkinsônia+N+F+PL
wilsoniazinha	wilsónia+N+DIM+F+SG
wilsoniazinhas	wilsónia+N+DIM+F+PL
wilsoninha	wilsónia+N+DIM+F+SG
wilsoninhas	wilsónia+N+DIM+F+PL
wilsónia	wilsónia+N+F+SG
wilsónias	wilsónia+N+F+PL
wilsoniazinha	wilsônia+N+DIM+F+SG
wilsoniazinhas	wilsônia+N+DIM+F+PL
wilsoninha	wilsônia+N+DIM+F+SG
wilsoninhas	wilsônia+N+DIM+F+PL
wilsônia	wilsônia+N+F+SG
wilsônias	wilsônia+N+F+PL
winchester	winchester+N+M+SG
winchesteres	winchester+N+M+PL
winchesterezinhos	winchester+N+DIM+M+PL
winchesterzinho	winchester+N+DIM+M+SG
winchesterzinhos	winchester+N+DIM+M+PL
windsurfe	windsurfe+N+M+SG
windsurfes	windsurfe+N+M+PL
windsurfezinho	windsurfe+N+DIM+M+SG
windsurfezinhos	windsurfe+N+DIM+M+PL
windsurfinho	windsurfe+N+DIM+M+SG
windsurfinhos	windsurfe+N+DIM+M+PL
windsurfista	windsurfista+N+SG
windsurfistas	windsurfista+N+PL
windsurfistazinha	windsurfista+N+DIM+F+SG
windsurfistazinhas	windsurfista+N+DIM+F+PL
windsurfistazinho	windsurfista+N+DIM+M+SG
windsurfistazinhos	windsurfista+N+DIM+M+PL
windsurfistinha	windsurfista+N+DIM+SG
windsurfistinhas	windsurfista+N+DIM+PL
winteranáceas	winteranáceas+N+F+PL
witherita	witherita+N+F+SG
witheritas	witherita+N+F+PL
witheritazinha	witherita+N+DIM+F+SG
witheritazinhas	witherita+N+DIM+F+PL
witheritinha	witherita+N+DIM+F+SG
witheritinhas	witherita+N+DIM+F+PL
wollastonita	wollastonita+N+F+SG
wollastonitas	wollastonita+N+F+PL
wollastonitazinha	wollastonita+N+DIM+F+SG
wollastonitazinhas	wollastonita+N+DIM+F+PL
wollastonitinha	wollastonita+N+DIM+F+SG
wollastonitinhas	wollastonita+N+DIM+F+PL
workflow	workflow+N+M+SG
workflows	workflow+N+M+PL
workflowzinho	workflow+N+DIM+M+SG
workflowzinhos	workflow+N+DIM+M+PL
workplace	workplace+N+M+SG
workplaces	workplace+N+M+PL
workplacezinho	workplace+N+DIM+M+SG
workplacezinhos	workplace+N+DIM+M+PL
workplacinho	workplace+N+DIM+M+SG
workplacinhos	workplace+N+DIM+M+PL
worksheet	worksheet+N+M+SG
worksheets	worksheet+N+M+PL
worksheetzinho	worksheet+N+DIM+M+SG
worksheetzinhos	worksheet+N+DIM+M+PL
workshop	workshop+N+SG
workshops	workshop+N+PL
workshopzinha	workshop+N+DIM+F+SG
workshopzinhas	workshop+N+DIM+F+PL
workshopzinho	workshop+N+DIM+M+SG
workshopzinhos	workshop+N+DIM+M+PL
world	world+N+M+SG
worlds	world+N+M+PL
worldzinho	world+N+DIM+M+SG
worldzinhos	world+N+DIM+M+PL
writ	writ+N+M+SG
writzinho	writ+N+DIM+M+SG
wulfenita	wulfenita+N+F+SG
wulfenitas	wulfenita+N+F+PL
wulfenitazinha	wulfenita+N+DIM+F+SG
wulfenitazinhas	wulfenita+N+DIM+F+PL
wulfenitinha	wulfenita+N+DIM+F+SG
wulfenitinhas	wulfenita+N+DIM+F+PL
wulfeniazinha	wulfénia+N+DIM+F+SG
wulfeniazinhas	wulfénia+N+DIM+F+PL
wulfeninha	wulfénia+N+DIM+F+SG
wulfeninhas	wulfénia+N+DIM+F+PL
wulfénia	wulfénia+N+F+SG
wulfénias	wulfénia+N+F+PL
wulfeniazinha	wulfênia+N+DIM+F+SG
wulfeniazinhas	wulfênia+N+DIM+F+PL
wulfeninha	wulfênia+N+DIM+F+SG
wulfeninhas	wulfênia+N+DIM+F+PL
wulfênia	wulfênia+N+F+SG
wulfênias	wulfênia+N+F+PL
wurtzita	wurtzita+N+F+SG
wurtzitas	wurtzita+N+F+PL
wurtzitazinha	wurtzita+N+DIM+F+SG
wurtzitazinhas	wurtzita+N+DIM+F+PL
wurtzitinha	wurtzita+N+DIM+F+SG
wurtzitinhas	wurtzita+N+DIM+F+PL
wurtzite	wurtzite+N+F+SG
wurtzites	wurtzite+N+F+PL
wurtzitezinha	wurtzite+N+DIM+F+SG
wurtzitezinhas	wurtzite+N+DIM+F+PL
wurtzitinha	wurtzite+N+DIM+F+SG
wurtzitinhas	wurtzite+N+DIM+F+PL
